"Match_Id","Innings","Team","Over","Runs Scored","Extras","Overall"
335987,1,1,1,0,3,3
335998,1,1,1,8,0,8
336002,1,1,1,6,0,6
336015,1,1,1,2,0,2
336019,1,1,1,6,0,6
336022,1,1,1,2,1,3
336026,1,1,1,5,0,5
336030,1,1,1,3,2,5
336032,1,1,1,4,3,7
392189,1,1,1,1,0,1
392204,1,1,1,2,1,3
392212,1,1,1,4,1,5
392216,1,1,1,2,1,3
392224,1,1,1,6,1,7
392226,1,1,1,5,0,5
392233,1,1,1,4,1,5
419111,1,1,1,0,1,1
419127,1,1,1,5,5,10
419132,1,1,1,14,5,19
419140,1,1,1,10,0,10
419144,1,1,1,8,1,9
419149,1,1,1,7,0,7
419153,1,1,1,6,1,7
419158,1,1,1,3,0,3
501208,1,1,1,8,0,8
501227,1,1,1,12,7,19
501235,1,1,1,4,0,4
501244,1,1,1,9,2,11
501260,1,1,1,8,0,8
501272,1,1,1,1,0,1
501274,1,1,1,1,2,3
548312,1,1,1,9,0,9
548320,1,1,1,4,0,4
548349,1,1,1,11,0,11
548358,1,1,1,6,1,7
548373,1,1,1,6,0,6
548375,1,1,1,6,0,6
548380,1,1,1,8,0,8
548383,1,1,1,4,1,5
598013,1,1,1,2,1,3
598018,1,1,1,3,0,3
598027,1,1,1,10,1,11
598034,1,1,1,25,1,26
598045,1,1,1,5,0,5
598058,1,1,1,2,2,4
598074,1,1,1,5,0,5
729284,1,1,1,0,1,1
729294,1,1,1,2,8,10
729304,1,1,1,6,0,6
734032,1,1,1,5,0,5
734048,1,1,1,2,0,2
829718,1,1,1,13,0,13
829766,1,1,1,3,2,5
829776,1,1,1,6,2,8
829786,1,1,1,6,0,6
980914,1,1,1,2,1,3
980952,1,1,1,4,0,4
980968,1,1,1,2,0,2
980980,1,1,1,5,0,5
981000,1,1,1,8,0,8
981006,1,1,1,3,0,3
981014,1,1,1,13,0,13
1082597,1,1,1,8,2,10
1082604,1,1,1,2,1,3
1082613,1,1,1,12,0,12
1082617,1,1,1,18,0,18
1082631,1,1,1,0,0,0
1082649,1,1,1,3,0,3
335991,2,1,1,6,0,6
336005,2,1,1,7,2,9
336008,2,1,1,5,5,10
336040,2,1,1,9,1,10
392191,2,1,1,2,1,3
392195,2,1,1,6,1,7
392202,2,1,1,3,0,3
392208,2,1,1,1,0,1
392236,2,1,1,10,0,10
392238,2,1,1,9,0,9
419114,2,1,1,3,0,3
419118,2,1,1,0,0,0
419123,2,1,1,5,0,5
419136,2,1,1,1,1,2
419163,2,1,1,10,2,12
419166,2,1,1,6,0,6
501203,2,1,1,10,0,10
501214,2,1,1,5,2,7
501219,2,1,1,0,2,2
501224,2,1,1,3,4,7
501239,2,1,1,5,0,5
501247,2,1,1,9,0,9
501250,2,1,1,6,2,8
501267,2,1,1,7,0,7
548317,2,1,1,3,1,4
548325,2,1,1,9,1,10
548328,2,1,1,2,0,2
548333,2,1,1,9,1,10
548340,2,1,1,5,0,5
548352,2,1,1,7,0,7
548362,2,1,1,10,0,10
548368,2,1,1,2,0,2
548386,2,1,1,3,0,3
598003,2,1,1,0,0,0
598010,2,1,1,12,2,14
598021,2,1,1,1,0,1
598036,2,1,1,9,0,9
598039,2,1,1,6,12,18
598048,2,1,1,7,1,8
598055,2,1,1,1,1,2
598062,2,1,1,0,0,0
598066,2,1,1,4,6,10
729312,2,1,1,6,1,7
729320,2,1,1,7,0,7
733976,2,1,1,2,1,3
733984,2,1,1,5,0,5
733990,2,1,1,2,0,2
734002,2,1,1,2,0,2
734014,2,1,1,6,1,7
734020,2,1,1,6,0,6
734028,2,1,1,11,1,12
734042,2,1,1,2,0,2
734054,2,1,1,10,0,10
829710,2,1,1,1,2,3
829728,2,1,1,6,0,6
829738,2,1,1,8,0,8
829744,2,1,1,6,0,6
829748,2,1,1,5,0,5
829770,2,1,1,5,0,5
829796,2,1,1,5,0,5
829810,2,1,1,7,0,7
829816,2,1,1,6,2,8
980908,2,1,1,4,0,4
980920,2,1,1,7,0,7
980930,2,1,1,8,4,12
980944,2,1,1,13,2,15
980956,2,1,1,5,0,5
980964,2,1,1,6,0,6
980994,2,1,1,8,1,9
981020,2,1,1,3,0,3
1082593,2,1,1,7,0,7
1082601,2,1,1,4,1,5
1082608,2,1,1,6,0,6
1082620,2,1,1,7,1,8
1082622,2,1,1,7,1,8
1082627,2,1,1,9,0,9
1082636,2,1,1,14,0,14
1082639,2,1,1,14,0,14
1082644,2,1,1,0,0,0
1082648,2,1,1,11,0,11
392195,3,1,1,14,1,15
729320,3,1,1,10,1,11
335997,1,2,1,1,0,1
336011,1,2,1,0,1,1
336017,1,2,1,6,0,6
336021,1,2,1,3,0,3
336031,1,2,1,1,0,1
336034,1,2,1,6,0,6
336039,1,2,1,2,0,2
392187,1,2,1,4,0,4
392196,1,2,1,6,0,6
392199,1,2,1,9,0,9
392209,1,2,1,2,0,2
392218,1,2,1,2,1,3
392241,1,2,1,4,0,4
419114,1,2,1,5,0,5
419128,1,2,1,2,0,2
419138,1,2,1,2,0,2
419150,1,2,1,2,2,4
501210,1,2,1,1,0,1
501237,1,2,1,3,0,3
501249,1,2,1,9,0,9
501273,1,2,1,6,1,7
501275,1,2,1,20,7,27
548315,1,2,1,4,0,4
548323,1,2,1,9,0,9
548341,1,2,1,5,0,5
548355,1,2,1,1,0,1
548367,1,2,1,3,0,3
548372,1,2,1,6,0,6
548377,1,2,1,11,0,11
598004,1,2,1,1,0,1
598009,1,2,1,3,5,8
598017,1,2,1,4,1,5
598032,1,2,1,3,0,3
598041,1,2,1,13,0,13
598047,1,2,1,7,1,8
598050,1,2,1,7,0,7
598059,1,2,1,1,0,1
598062,1,2,1,3,0,3
598069,1,2,1,3,0,3
598073,1,2,1,6,0,6
729310,1,2,1,1,0,1
729318,1,2,1,20,0,20
734004,1,2,1,4,0,4
734010,1,2,1,1,0,1
734026,1,2,1,4,1,5
734040,1,2,1,2,0,2
829724,1,2,1,9,2,11
829768,1,2,1,10,0,10
829790,1,2,1,1,0,1
829800,1,2,1,7,1,8
829824,1,2,1,5,0,5
829826,1,2,1,6,0,6
980912,1,2,1,5,0,5
980926,1,2,1,8,0,8
980932,1,2,1,4,0,4
980936,1,2,1,8,1,9
980942,1,2,1,2,0,2
980964,1,2,1,2,0,2
980982,1,2,1,9,0,9
980986,1,2,1,7,1,8
980992,1,2,1,0,1,1
981004,1,2,1,5,0,5
1082595,1,2,1,10,0,10
1082598,1,2,1,2,0,2
1082602,1,2,1,4,2,6
1082610,1,2,1,8,0,8
1082621,1,2,1,2,1,3
1082628,1,2,1,10,0,10
1082636,1,2,1,1,0,1
1082646,1,2,1,9,1,10
335987,2,2,1,3,1,4
335990,2,2,1,10,0,10
336001,2,2,1,4,2,6
336003,2,2,1,7,0,7
336007,2,2,1,10,0,10
336015,2,2,1,4,0,4
336028,2,2,1,1,0,1
392190,2,2,1,5,0,5
392193,2,2,1,10,0,10
392204,2,2,1,1,1,2
392213,2,2,1,8,1,9
392223,2,2,1,6,0,6
392226,2,2,1,1,1,2
392229,2,2,1,5,1,6
392237,2,2,1,2,0,2
392243,2,2,1,9,0,9
392244,2,2,1,0,1,1
419117,2,2,1,5,0,5
419120,2,2,1,12,0,12
419124,2,2,1,3,1,4
419133,2,2,1,6,2,8
419141,2,2,1,5,0,5
419145,2,2,1,11,0,11
419153,2,2,1,4,0,4
419156,2,2,1,6,0,6
419159,2,2,1,6,0,6
419162,2,2,1,4,0,4
419167,2,2,1,9,0,9
419169,2,2,1,6,0,6
501205,2,2,1,2,5,7
501213,2,2,1,2,0,2
501216,2,2,1,15,0,15
501227,2,2,1,8,0,8
501232,2,2,1,9,1,10
501252,2,2,1,8,1,9
501257,2,2,1,9,1,10
501260,2,2,1,16,0,16
501265,2,2,1,0,0,0
501271,2,2,1,6,0,6
501276,2,2,1,5,1,6
548320,2,2,1,6,0,6
548329,2,2,1,7,0,7
548332,2,2,1,3,0,3
548336,2,2,1,2,1,3
548349,2,2,1,2,0,2
548361,2,2,1,11,0,11
548365,2,2,1,4,0,4
548381,2,2,1,3,0,3
598013,2,2,1,4,0,4
598022,2,2,1,2,0,2
598028,2,2,1,4,0,4
598038,2,2,1,5,0,5
598053,2,2,1,12,0,12
729286,2,2,1,5,0,5
729292,2,2,1,7,0,7
729304,2,2,1,7,1,8
733982,2,2,1,4,1,5
733988,2,2,1,6,0,6
733996,2,2,1,4,0,4
734018,2,2,1,9,0,9
734032,2,2,1,1,0,1
829718,2,2,1,1,0,1
829742,2,2,1,1,3,4
829750,2,2,1,8,0,8
829754,2,2,1,3,1,4
829762,2,2,1,3,1,4
829776,2,2,1,2,2,4
829784,2,2,1,4,0,4
829808,2,2,1,10,0,10
829812,2,2,1,17,0,17
829818,2,2,1,2,0,2
980958,2,2,1,10,0,10
980974,2,2,1,4,0,4
981000,2,2,1,6,1,7
981016,2,2,1,5,0,5
981018,2,2,1,5,6,11
981024,2,2,1,4,1,5
1082591,2,2,1,11,0,11
1082607,2,2,1,7,0,7
1082617,2,2,1,1,2,3
1082624,2,2,1,4,0,4
1082633,2,2,1,7,0,7
598022,3,2,1,15,0,15
598009,4,2,1,15,0,15
335988,1,3,1,5,0,5
335994,1,3,1,6,1,7
336001,1,3,1,1,0,1
336006,1,3,1,4,0,4
336010,1,3,1,1,0,1
336012,1,3,1,4,0,4
336018,1,3,1,10,2,12
336023,1,3,1,1,0,1
336045,1,3,1,5,1,6
392190,1,3,1,8,1,9
392201,1,3,1,2,0,2
392207,1,3,1,4,0,4
392211,1,3,1,9,1,10
392214,1,3,1,10,0,10
392219,1,3,1,5,0,5
392229,1,3,1,4,0,4
392236,1,3,1,5,0,5
392239,1,3,1,6,0,6
392243,1,3,1,2,0,2
419118,1,3,1,1,0,1
419130,1,3,1,4,1,5
419142,1,3,1,8,0,8
419147,1,3,1,6,0,6
419152,1,3,1,6,0,6
419160,1,3,1,7,2,9
419168,1,3,1,5,1,6
419170,1,3,1,4,0,4
501203,1,3,1,5,0,5
501211,1,3,1,0,0,0
501216,1,3,1,2,0,2
501220,1,3,1,8,0,8
501231,1,3,1,2,0,2
501241,1,3,1,3,1,4
501250,1,3,1,1,0,1
501254,1,3,1,6,1,7
501258,1,3,1,6,0,6
501266,1,3,1,3,0,3
501271,1,3,1,4,1,5
501276,1,3,1,5,0,5
548311,1,3,1,4,1,5
548316,1,3,1,2,0,2
548321,1,3,1,4,0,4
548327,1,3,1,1,0,1
548335,1,3,1,6,0,6
548352,1,3,1,4,0,4
548357,1,3,1,6,0,6
548360,1,3,1,7,0,7
548376,1,3,1,4,0,4
548384,1,3,1,1,0,1
548385,1,3,1,12,0,12
548386,1,3,1,3,0,3
598025,1,3,1,5,0,5
598039,1,3,1,6,0,6
598043,1,3,1,5,1,6
598046,1,3,1,3,0,3
598056,1,3,1,0,0,0
598063,1,3,1,3,0,3
598067,1,3,1,4,1,5
598075,1,3,1,6,0,6
729288,1,3,1,4,5,9
729298,1,3,1,3,1,4
729302,1,3,1,5,0,5
733976,1,3,1,9,0,9
734018,1,3,1,7,0,7
734028,1,3,1,5,0,5
734034,1,3,1,12,0,12
829712,1,3,1,12,4,16
829716,1,3,1,4,0,4
829728,1,3,1,12,7,19
829740,1,3,1,9,0,9
829750,1,3,1,5,4,9
829758,1,3,1,4,0,4
829770,1,3,1,4,0,4
829784,1,3,1,0,0,0
829794,1,3,1,3,0,3
829802,1,3,1,5,0,5
829806,1,3,1,0,0,0
335998,2,3,1,4,1,5
336014,2,3,1,9,0,9
336030,2,3,1,3,2,5
336034,2,3,1,4,1,5
336038,2,3,1,5,1,6
336042,2,3,1,10,2,12
336044,2,3,1,7,0,7
392186,2,3,1,2,0,2
392194,2,3,1,11,0,11
392207,2,3,1,5,1,6
392222,2,3,1,9,0,9
392232,2,3,1,4,0,4
419115,2,3,1,4,0,4
419121,2,3,1,3,1,4
419126,2,3,1,5,1,6
419128,2,3,1,2,0,2
419134,2,3,1,4,0,4
419138,2,3,1,7,0,7
419158,2,3,1,3,5,8
419164,2,3,1,1,0,1
501226,2,3,1,4,1,5
501233,2,3,1,0,0,0
501245,2,3,1,5,0,5
501273,2,3,1,1,2,3
548323,2,3,1,2,0,2
548337,2,3,1,2,0,2
548348,2,3,1,2,0,2
548366,2,3,1,1,0,1
548369,2,3,1,2,0,2
548373,2,3,1,5,0,5
598007,2,3,1,5,0,5
598012,2,3,1,5,1,6
598017,2,3,1,2,1,3
598020,2,3,1,0,0,0
598027,2,3,1,6,1,7
598031,2,3,1,4,0,4
598035,2,3,1,4,0,4
598051,2,3,1,6,0,6
598073,2,3,1,8,0,8
598078,2,3,1,2,0,2
729308,2,3,1,0,0,0
729316,2,3,1,6,0,6
733986,2,3,1,7,0,7
733992,2,3,1,4,1,5
734000,2,3,1,12,0,12
734008,2,3,1,7,0,7
734040,2,3,1,5,0,5
734050,2,3,1,4,2,6
734052,2,3,1,9,0,9
829734,2,3,1,6,0,6
829778,2,3,1,13,0,13
829814,2,3,1,2,0,2
829822,2,3,1,2,0,2
829826,2,3,1,2,1,3
829828,2,3,1,5,0,5
419126,3,3,1,9,0,9
335992,1,4,1,1,0,1
335996,1,4,1,2,0,2
336008,1,4,1,5,0,5
336024,1,4,1,5,0,5
336033,1,4,1,3,0,3
336040,1,4,1,4,1,5
336044,1,4,1,7,0,7
392188,1,4,1,6,4,10
392191,1,4,1,1,0,1
392200,1,4,1,0,1,1
392205,1,4,1,5,0,5
392227,1,4,1,4,1,5
392234,1,4,1,7,2,9
419113,1,4,1,0,3,3
419117,1,4,1,1,0,1
419126,1,4,1,2,0,2
419137,1,4,1,5,0,5
419141,1,4,1,1,0,1
419148,1,4,1,11,2,13
419161,1,4,1,1,1,2
419164,1,4,1,14,1,15
501207,1,4,1,4,0,4
501225,1,4,1,11,2,13
501239,1,4,1,3,0,3
501253,1,4,1,5,0,5
501256,1,4,1,2,0,2
501262,1,4,1,5,0,5
501265,1,4,1,5,0,5
548328,1,4,1,7,0,7
548333,1,4,1,6,2,8
548336,1,4,1,3,0,3
548344,1,4,1,3,0,3
548348,1,4,1,6,3,9
548364,1,4,1,5,0,5
548374,1,4,1,4,2,6
548379,1,4,1,0,5,5
598012,1,4,1,5,0,5
598019,1,4,1,1,0,1
598021,1,4,1,0,1,1
598026,1,4,1,2,0,2
598033,1,4,1,9,0,9
598036,1,4,1,5,0,5
598057,1,4,1,1,0,1
598071,1,4,1,2,0,2
729300,1,4,1,2,0,2
729312,1,4,1,7,0,7
733978,1,4,1,5,0,5
733992,1,4,1,7,2,9
733996,1,4,1,8,2,10
734002,1,4,1,16,1,17
734030,1,4,1,10,1,11
734038,1,4,1,14,1,15
734052,1,4,1,10,0,10
734054,1,4,1,8,1,9
829722,1,4,1,10,0,10
829730,1,4,1,1,0,1
829738,1,4,1,2,0,2
829772,1,4,1,6,0,6
829796,1,4,1,2,0,2
829808,1,4,1,13,1,14
829814,1,4,1,5,0,5
980910,1,4,1,3,0,3
980918,1,4,1,2,0,2
980930,1,4,1,5,0,5
980940,1,4,1,8,0,8
980960,1,4,1,9,0,9
980976,1,4,1,1,0,1
980996,1,4,1,6,1,7
981010,1,4,1,8,0,8
1082601,1,4,1,10,0,10
1082612,1,4,1,8,0,8
1082616,1,4,1,11,0,11
1082633,1,4,1,2,0,2
1082637,1,4,1,2,0,2
1082639,1,4,1,8,0,8
1082641,1,4,1,13,0,13
1082645,1,4,1,4,0,4
335988,2,4,1,9,0,9
336000,2,4,1,1,1,2
336004,2,4,1,11,0,11
336011,2,4,1,2,4,6
336018,2,4,1,12,0,12
336021,2,4,1,10,2,12
336027,2,4,1,3,0,3
336036,2,4,1,14,0,14
392196,2,4,1,3,1,4
392209,2,4,1,3,0,3
392212,2,4,1,2,0,2
392215,2,4,1,1,1,2
392219,2,4,1,5,0,5
392221,2,4,1,7,1,8
392231,2,4,1,2,0,2
392239,2,4,1,3,0,3
419122,2,4,1,8,1,9
419129,2,4,1,7,0,7
419132,2,4,1,1,0,1
419144,2,4,1,8,0,8
419151,2,4,1,9,0,9
419154,2,4,1,7,0,7
501211,2,4,1,8,0,8
501217,2,4,1,9,0,9
501228,2,4,1,4,0,4
501242,2,4,1,1,0,1
501249,2,4,1,3,1,4
501259,2,4,1,5,2,7
501269,2,4,1,5,0,5
548314,2,4,1,11,1,12
548318,2,4,1,2,1,3
548324,2,4,1,7,0,7
548339,2,4,1,10,0,10
548355,2,4,1,8,3,11
548359,2,4,1,8,0,8
548371,2,4,1,2,1,3
548376,2,4,1,9,0,9
598008,2,4,1,14,0,14
598030,2,4,1,4,1,5
598042,2,4,1,6,1,7
598046,2,4,1,7,1,8
598050,2,4,1,5,2,7
598061,2,4,1,2,0,2
598064,2,4,1,7,0,7
598069,2,4,1,6,0,6
729288,2,4,1,3,0,3
729296,2,4,1,4,1,5
729318,2,4,1,2,0,2
734012,2,4,1,8,0,8
734024,2,4,1,4,2,6
734044,2,4,1,10,0,10
734048,2,4,1,4,1,5
829714,2,4,1,10,1,11
829746,2,4,1,2,0,2
829758,2,4,1,3,1,4
829764,2,4,1,4,0,4
829780,2,4,1,3,6,9
829790,2,4,1,3,8,11
829804,2,4,1,1,0,1
980924,2,4,1,3,0,3
980946,2,4,1,1,0,1
980968,2,4,1,1,1,2
980982,2,4,1,5,0,5
980990,2,4,1,1,0,1
981004,2,4,1,11,0,11
1082594,2,4,1,6,0,6
1082598,2,4,1,6,0,6
1082605,2,4,1,2,0,2
1082609,2,4,1,6,0,6
1082623,2,4,1,10,0,10
1082626,2,4,1,8,0,8
829746,3,4,1,13,2,15
419126,4,4,1,10,0,10
335989,1,5,1,6,1,7
336005,1,5,1,5,0,5
336013,1,5,1,5,0,5
336028,1,5,1,8,2,10
336038,1,5,1,7,5,12
336043,1,5,1,0,1,1
392195,1,5,1,3,1,4
392215,1,5,1,16,0,16
392222,1,5,1,5,0,5
392230,1,5,1,7,0,7
392238,1,5,1,22,0,22
419116,1,5,1,13,1,14
419120,1,5,1,7,0,7
419123,1,5,1,6,0,6
419129,1,5,1,8,0,8
419134,1,5,1,13,0,13
419146,1,5,1,6,0,6
419159,1,5,1,6,0,6
419163,1,5,1,6,0,6
501214,1,5,1,4,2,6
501219,1,5,1,4,0,4
501245,1,5,1,5,4,9
501257,1,5,1,3,1,4
501263,1,5,1,5,0,5
548314,1,5,1,3,2,5
548317,1,5,1,1,0,1
548325,1,5,1,4,0,4
548329,1,5,1,2,0,2
548337,1,5,1,5,0,5
548354,1,5,1,5,0,5
548359,1,5,1,2,1,3
548366,1,5,1,4,1,5
548370,1,5,1,6,2,8
548378,1,5,1,6,0,6
548382,1,5,1,6,1,7
598006,1,5,1,4,1,5
598010,1,5,1,0,1,1
598014,1,5,1,7,0,7
598024,1,5,1,2,1,3
598028,1,5,1,5,0,5
598031,1,5,1,5,0,5
598048,1,5,1,5,0,5
598077,1,5,1,4,0,4
729296,1,5,1,6,0,6
729320,1,5,1,7,0,7
733984,1,5,1,5,0,5
734008,1,5,1,2,0,2
734016,1,5,1,7,0,7
734046,1,5,1,5,0,5
829714,1,5,1,0,4,4
829746,1,5,1,5,1,6
829754,1,5,1,6,2,8
829782,1,5,1,2,3,5
829816,1,5,1,9,0,9
335992,2,5,1,5,1,6
335995,2,5,1,5,0,5
335997,2,5,1,9,0,9
336010,2,5,1,0,0,0
336016,2,5,1,10,0,10
336020,2,5,1,1,0,1
336024,2,5,1,5,0,5
336032,2,5,1,6,0,6
336041,2,5,1,1,0,1
336045,2,5,1,2,0,2
392187,2,5,1,1,1,2
392200,2,5,1,5,1,6
392203,2,5,1,4,2,6
392207,2,5,1,1,0,1
392210,2,5,1,2,1,3
392218,2,5,1,2,0,2
392225,2,5,1,5,0,5
392235,2,5,1,1,1,2
419112,2,5,1,1,0,1
419131,2,5,1,8,0,8
419139,2,5,1,1,0,1
419142,2,5,1,14,0,14
419148,2,5,1,8,1,9
419155,2,5,1,0,1,1
501204,2,5,1,11,0,11
501209,2,5,1,6,2,8
501225,2,5,1,7,0,7
501230,2,5,1,8,0,8
501236,2,5,1,3,0,3
501240,2,5,1,5,5,10
501254,2,5,1,8,0,8
501268,2,5,1,7,1,8
548322,2,5,1,7,0,7
548331,2,5,1,5,0,5
548341,2,5,1,5,3,8
548350,2,5,1,6,0,6
548363,2,5,1,4,0,4
598019,2,5,1,1,5,6
598037,2,5,1,1,0,1
598041,2,5,1,8,0,8
598052,2,5,1,8,1,9
598054,2,5,1,0,0,0
598057,2,5,1,4,0,4
598063,2,5,1,2,0,2
598068,2,5,1,4,1,5
598070,2,5,1,3,0,3
598076,2,5,1,8,0,8
729290,2,5,1,4,0,4
729302,2,5,1,9,1,10
729310,2,5,1,10,1,11
733980,2,5,1,5,0,5
733994,2,5,1,1,1,2
734004,2,5,1,6,0,6
734022,2,5,1,3,1,4
734038,2,5,1,5,0,5
829720,2,5,1,2,0,2
829726,2,5,1,1,0,1
829732,2,5,1,6,0,6
829740,2,5,1,1,0,1
829774,2,5,1,7,2,9
829792,2,5,1,8,0,8
829802,2,5,1,4,0,4
829824,2,5,1,11,0,11
392195,4,5,1,18,0,18
729320,4,5,1,11,0,11
829746,4,5,1,5,1,6
336000,1,6,1,8,0,8
336003,1,6,1,3,0,3
336014,1,6,1,6,1,7
336020,1,6,1,12,0,12
336025,1,6,1,7,0,7
336027,1,6,1,6,4,10
392194,1,6,1,2,0,2
392203,1,6,1,7,0,7
392228,1,6,1,4,1,5
392231,1,6,1,6,1,7
392235,1,6,1,2,2,4
392237,1,6,1,1,0,1
392242,1,6,1,0,0,0
419121,1,6,1,9,0,9
419133,1,6,1,13,0,13
419136,1,6,1,9,0,9
419139,1,6,1,11,0,11
419145,1,6,1,2,0,2
419154,1,6,1,4,0,4
501206,1,6,1,10,0,10
501209,1,6,1,5,0,5
501228,1,6,1,9,1,10
501232,1,6,1,5,1,6
501238,1,6,1,3,1,4
501243,1,6,1,9,0,9
501270,1,6,1,1,1,2
548347,1,6,1,1,0,1
548350,1,6,1,7,0,7
548362,1,6,1,0,0,0
548369,1,6,1,5,0,5
598003,1,6,1,8,1,9
598015,1,6,1,0,0,0
598022,1,6,1,0,1,1
598040,1,6,1,3,0,3
598049,1,6,1,4,0,4
598054,1,6,1,8,3,11
598064,1,6,1,5,1,6
729286,1,6,1,3,1,4
733980,1,6,1,9,0,9
733986,1,6,1,4,4,8
733990,1,6,1,8,0,8
733998,1,6,1,4,0,4
734024,1,6,1,6,0,6
734044,1,6,1,6,0,6
829720,1,6,1,7,1,8
829736,1,6,1,6,1,7
829744,1,6,1,1,2,3
829752,1,6,1,2,2,4
829762,1,6,1,1,1,2
829788,1,6,1,4,0,4
829818,1,6,1,2,1,3
980908,1,6,1,12,1,13
980938,1,6,1,10,0,10
980956,1,6,1,2,0,2
980970,1,6,1,2,0,2
981002,1,6,1,2,0,2
981016,1,6,1,9,1,10
1082599,1,6,1,0,2,2
1082605,1,6,1,8,0,8
1082608,1,6,1,10,0,10
1082622,1,6,1,5,0,5
1082626,1,6,1,1,0,1
1082642,1,6,1,3,0,3
335989,2,6,1,8,0,8
335993,2,6,1,4,0,4
336006,2,6,1,8,0,8
336009,2,6,1,2,0,2
336022,2,6,1,4,1,5
336031,2,6,1,6,4,10
336037,2,6,1,19,0,19
336043,2,6,1,5,3,8
392188,2,6,1,8,1,9
392199,2,6,1,9,0,9
392206,2,6,1,5,0,5
392211,2,6,1,5,0,5
392216,2,6,1,4,0,4
392220,2,6,1,5,3,8
392224,2,6,1,2,1,3
392240,2,6,1,8,0,8
419113,2,6,1,9,0,9
419116,2,6,1,11,1,12
419119,2,6,1,4,0,4
419125,2,6,1,9,0,9
419149,2,6,1,1,0,1
419157,2,6,1,7,1,8
419160,2,6,1,5,0,5
419165,2,6,1,5,0,5
501218,2,6,1,5,0,5
501221,2,6,1,1,0,1
501235,2,6,1,6,1,7
501248,2,6,1,5,0,5
501251,2,6,1,4,0,4
501258,2,6,1,4,0,4
501262,2,6,1,5,5,10
548312,2,6,1,5,0,5
548315,2,6,1,14,0,14
548321,2,6,1,12,0,12
548326,2,6,1,2,0,2
548330,2,6,1,8,0,8
548334,2,6,1,12,4,16
548338,2,6,1,5,0,5
548342,2,6,1,6,2,8
548354,2,6,1,1,0,1
548374,2,6,1,11,0,11
548377,2,6,1,10,1,11
548379,2,6,1,10,0,10
548383,2,6,1,8,3,11
548385,2,6,1,6,0,6
598006,2,6,1,3,2,5
598011,2,6,1,2,0,2
598025,2,6,1,8,1,9
598029,2,6,1,2,0,2
598033,2,6,1,1,0,1
598045,2,6,1,2,1,3
598059,2,6,1,7,0,7
598067,2,6,1,5,1,6
598072,2,6,1,6,6,12
729294,2,6,1,9,1,10
729298,2,6,1,6,0,6
729306,2,6,1,3,1,4
729314,2,6,1,6,0,6
734010,2,6,1,7,0,7
734016,2,6,1,6,0,6
734036,2,6,1,7,1,8
829712,2,6,1,4,0,4
829730,2,6,1,7,0,7
829766,2,6,1,4,0,4
829772,2,6,1,2,0,2
829782,2,6,1,6,0,6
829798,2,6,1,5,0,5
829806,2,6,1,5,0,5
980918,2,6,1,6,0,6
980926,2,6,1,5,6,11
980950,2,6,1,2,0,2
980966,2,6,1,10,0,10
980976,2,6,1,2,1,3
980988,2,6,1,5,0,5
980998,2,6,1,10,0,10
981008,2,6,1,2,6,8
1082595,2,6,1,8,1,9
1082611,2,6,1,1,1,2
1082614,2,6,1,9,0,9
1082630,2,6,1,3,0,3
1082632,2,6,1,9,2,11
1082635,2,6,1,4,0,4
1082640,2,6,1,7,0,7
1082646,2,6,1,2,0,2
598022,4,6,1,11,0,11
335990,1,7,1,8,0,8
335999,1,7,1,5,1,6
336009,1,7,1,4,1,5
336029,1,7,1,10,1,11
336037,1,7,1,5,0,5
336041,1,7,1,1,1,2
392186,1,7,1,3,0,3
392202,1,7,1,4,0,4
392208,1,7,1,7,2,9
392213,1,7,1,0,0,0
392220,1,7,1,0,1,1
392223,1,7,1,4,1,5
392232,1,7,1,1,0,1
392240,1,7,1,2,3,5
419112,1,7,1,13,0,13
419119,1,7,1,8,4,12
419124,1,7,1,5,0,5
419135,1,7,1,4,1,5
419143,1,7,1,9,3,12
419151,1,7,1,7,0,7
419155,1,7,1,10,1,11
419157,1,7,1,8,0,8
419162,1,7,1,4,0,4
419166,1,7,1,3,0,3
419167,1,7,1,2,0,2
501215,1,7,1,5,2,7
501226,1,7,1,0,0,0
501229,1,7,1,6,0,6
501236,1,7,1,7,0,7
501242,1,7,1,3,0,3
501246,1,7,1,5,0,5
501251,1,7,1,9,1,10
501268,1,7,1,2,0,2
548322,1,7,1,1,1,2
548330,1,7,1,0,2,2
548339,1,7,1,0,0,0
548356,1,7,1,4,0,4
548365,1,7,1,1,0,1
548368,1,7,1,1,0,1
598007,1,7,1,4,0,4
598011,1,7,1,0,0,0
598016,1,7,1,3,0,3
598029,1,7,1,2,0,2
598038,1,7,1,7,0,7
598042,1,7,1,2,0,2
598044,1,7,1,6,0,6
598051,1,7,1,4,0,4
598055,1,7,1,0,0,0
598068,1,7,1,2,0,2
598078,1,7,1,8,0,8
729292,1,7,1,8,0,8
729308,1,7,1,2,0,2
729314,1,7,1,5,2,7
733988,1,7,1,5,2,7
734000,1,7,1,3,1,4
734014,1,7,1,0,3,3
734022,1,7,1,4,0,4
734036,1,7,1,6,0,6
734050,1,7,1,6,0,6
829710,1,7,1,3,1,4
829726,1,7,1,6,0,6
829734,1,7,1,1,1,2
829742,1,7,1,2,0,2
829756,1,7,1,10,1,11
829774,1,7,1,5,0,5
829780,1,7,1,9,0,9
829810,1,7,1,6,0,6
829822,1,7,1,5,0,5
829828,1,7,1,1,0,1
980906,1,7,1,8,0,8
980922,1,7,1,3,0,3
980928,1,7,1,2,0,2
980946,1,7,1,2,0,2
980990,1,7,1,5,0,5
980998,1,7,1,11,0,11
981012,1,7,1,8,0,8
1082592,1,7,1,10,1,11
1082614,1,7,1,2,6,8
1082635,1,7,1,3,0,3
1082638,1,7,1,2,1,3
1082644,1,7,1,1,1,2
1082650,1,7,1,3,0,3
335994,2,7,1,7,2,9
335996,2,7,1,1,1,2
336002,2,7,1,4,2,6
336013,2,7,1,0,2,2
336017,2,7,1,9,0,9
336023,2,7,1,7,0,7
336026,2,7,1,5,1,6
336033,2,7,1,3,7,10
392197,2,7,1,2,1,3
392202,2,7,1,1,0,1
392205,2,7,1,2,1,3
392217,2,7,1,6,0,6
392227,2,7,1,4,1,5
392230,2,7,1,8,0,8
419119,2,7,1,9,0,9
419127,2,7,1,12,0,12
419130,2,7,1,5,1,6
419137,2,7,1,10,0,10
419147,2,7,1,7,0,7
419170,2,7,1,0,0,0
501206,2,7,1,1,0,1
501210,2,7,1,6,1,7
501223,2,7,1,6,0,6
501256,2,7,1,12,0,12
501261,2,7,1,1,4,5
501272,2,7,1,12,1,13
501274,2,7,1,14,0,14
501275,2,7,1,10,0,10
548311,2,7,1,1,0,1
548313,2,7,1,2,0,2
548319,2,7,1,2,0,2
548344,2,7,1,4,0,4
548347,2,7,1,10,0,10
548351,2,7,1,0,1,1
548360,2,7,1,0,0,0
548372,2,7,1,0,2,2
548375,2,7,1,4,1,5
548382,2,7,1,8,0,8
548384,2,7,1,6,0,6
598004,2,7,1,2,0,2
598024,2,7,1,2,2,4
598034,2,7,1,5,0,5
598060,2,7,1,4,0,4
598065,2,7,1,5,0,5
598071,2,7,1,2,0,2
598075,2,7,1,10,0,10
598077,2,7,1,6,0,6
729284,2,7,1,8,0,8
729322,2,7,1,6,0,6
733978,2,7,1,5,1,6
734006,2,7,1,2,0,2
734030,2,7,1,12,1,13
734046,2,7,1,12,0,12
829722,2,7,1,3,0,3
829752,2,7,1,6,1,7
829788,2,7,1,5,3,8
829794,2,7,1,2,1,3
829800,2,7,1,8,1,9
829820,2,7,1,5,0,5
980914,2,7,1,8,0,8
980932,2,7,1,6,0,6
980938,2,7,1,8,0,8
980952,2,7,1,8,0,8
980962,2,7,1,4,0,4
980978,2,7,1,5,0,5
980986,2,7,1,2,0,2
1082597,2,7,1,9,0,9
1082600,2,7,1,5,1,6
1082602,2,7,1,2,2,4
1082606,2,7,1,5,1,6
1082612,2,7,1,9,1,10
1082618,2,7,1,3,0,3
1082625,2,7,1,13,0,13
1082628,2,7,1,6,0,6
1082641,2,7,1,9,1,10
1082647,2,7,1,1,0,1
1082649,2,7,1,7,4,11
1082625,3,7,1,11,0,11
335991,1,8,1,8,1,9
335993,1,8,1,0,1,1
335995,1,8,1,12,0,12
336004,1,8,1,6,0,6
336007,1,8,1,2,6,8
336016,1,8,1,8,0,8
336036,1,8,1,5,0,5
336042,1,8,1,1,0,1
392193,1,8,1,12,0,12
392197,1,8,1,6,0,6
392206,1,8,1,8,0,8
392210,1,8,1,8,0,8
392217,1,8,1,5,2,7
392221,1,8,1,6,1,7
392225,1,8,1,7,1,8
392244,1,8,1,2,0,2
419115,1,8,1,6,2,8
419122,1,8,1,4,0,4
419125,1,8,1,2,2,4
419131,1,8,1,2,0,2
419156,1,8,1,1,0,1
419165,1,8,1,7,0,7
419169,1,8,1,4,0,4
501204,1,8,1,10,0,10
501213,1,8,1,2,1,3
501217,1,8,1,9,0,9
501221,1,8,1,13,0,13
501234,1,8,1,2,1,3
501248,1,8,1,8,2,10
501255,1,8,1,4,0,4
501261,1,8,1,1,0,1
501269,1,8,1,4,0,4
548319,1,8,1,2,0,2
548326,1,8,1,2,0,2
548331,1,8,1,9,0,9
548334,1,8,1,8,0,8
548340,1,8,1,6,0,6
548346,1,8,1,13,3,16
548351,1,8,1,2,1,3
548353,1,8,1,4,0,4
548361,1,8,1,10,1,11
548371,1,8,1,5,0,5
548381,1,8,1,6,0,6
335999,2,8,1,10,0,10
336012,2,8,1,3,0,3
336019,2,8,1,5,0,5
336025,2,8,1,9,1,10
336029,2,8,1,5,0,5
336039,2,8,1,5,2,7
392189,2,8,1,9,0,9
392201,2,8,1,11,0,11
392214,2,8,1,0,0,0
392228,2,8,1,18,0,18
392233,2,8,1,5,0,5
392234,2,8,1,5,0,5
392241,2,8,1,4,0,4
392242,2,8,1,20,1,21
419111,2,8,1,3,2,5
419135,2,8,1,8,2,10
419140,2,8,1,13,1,14
419143,2,8,1,9,0,9
419146,2,8,1,2,0,2
419150,2,8,1,5,0,5
419152,2,8,1,3,0,3
419161,2,8,1,9,0,9
419168,2,8,1,1,0,1
501208,2,8,1,1,0,1
501229,2,8,1,5,0,5
501241,2,8,1,4,2,6
501244,2,8,1,1,0,1
501264,2,8,1,4,0,4
548316,2,8,1,4,0,4
548357,2,8,1,4,0,4
548364,2,8,1,8,0,8
548378,2,8,1,11,0,11
501205,1,9,1,6,1,7
501212,1,9,1,9,0,9
501224,1,9,1,5,1,6
501230,1,9,1,5,4,9
501247,1,9,1,0,0,0
501252,1,9,1,7,0,7
501259,1,9,1,9,6,15
501215,2,9,1,5,0,5
501220,2,9,1,7,0,7
501234,2,9,1,0,0,0
501238,2,9,1,2,1,3
501243,2,9,1,5,8,13
501263,2,9,1,17,2,19
501266,2,9,1,3,0,3
501218,1,10,1,14,0,14
501223,1,10,1,3,0,3
501233,1,10,1,2,0,2
501240,1,10,1,6,0,6
501264,1,10,1,14,0,14
501267,1,10,1,9,0,9
548313,1,10,1,0,0,0
548318,1,10,1,10,0,10
548324,1,10,1,5,0,5
548332,1,10,1,4,1,5
548338,1,10,1,0,0,0
548342,1,10,1,1,0,1
548363,1,10,1,3,3,6
598008,1,10,1,1,0,1
598020,1,10,1,13,0,13
598030,1,10,1,8,1,9
598052,1,10,1,9,0,9
598060,1,10,1,1,0,1
598066,1,10,1,6,0,6
598072,1,10,1,11,0,11
501207,2,10,1,1,1,2
501212,2,10,1,10,0,10
501231,2,10,1,2,1,3
501237,2,10,1,4,1,5
501246,2,10,1,0,0,0
501253,2,10,1,0,0,0
501255,2,10,1,14,1,15
548327,2,10,1,5,1,6
548335,2,10,1,8,1,9
548346,2,10,1,3,0,3
548353,2,10,1,3,0,3
548356,2,10,1,5,1,6
548358,2,10,1,10,0,10
548367,2,10,1,4,0,4
548370,2,10,1,3,0,3
548380,2,10,1,7,2,9
598005,2,10,1,2,0,2
598014,2,10,1,5,1,6
598016,2,10,1,4,1,5
598023,2,10,1,7,0,7
598032,2,10,1,9,0,9
598040,2,10,1,0,0,0
598043,2,10,1,8,1,9
598047,2,10,1,4,0,4
598058,2,10,1,9,0,9
598005,1,11,1,3,1,4
598023,1,11,1,2,0,2
598035,1,11,1,6,0,6
598037,1,11,1,2,0,2
598053,1,11,1,7,0,7
598061,1,11,1,4,0,4
598065,1,11,1,18,1,19
598070,1,11,1,3,0,3
598076,1,11,1,2,0,2
729290,1,11,1,2,0,2
729306,1,11,1,5,1,6
729316,1,11,1,6,2,8
729322,1,11,1,8,2,10
733982,1,11,1,3,0,3
733994,1,11,1,9,0,9
734006,1,11,1,4,0,4
734012,1,11,1,6,0,6
734020,1,11,1,6,2,8
734042,1,11,1,8,1,9
829732,1,11,1,1,0,1
829748,1,11,1,2,1,3
829764,1,11,1,0,0,0
829778,1,11,1,10,0,10
829792,1,11,1,13,0,13
829798,1,11,1,8,0,8
829804,1,11,1,5,0,5
829812,1,11,1,5,1,6
829820,1,11,1,7,0,7
980920,1,11,1,6,3,9
980948,1,11,1,0,4,4
980958,1,11,1,6,0,6
980978,1,11,1,6,1,7
980984,1,11,1,2,0,2
980988,1,11,1,6,0,6
981008,1,11,1,1,0,1
981020,1,11,1,4,0,4
981024,1,11,1,7,0,7
1082591,1,11,1,4,3,7
1082600,1,11,1,2,0,2
1082609,1,11,1,2,1,3
1082611,1,11,1,9,1,10
1082615,1,11,1,7,0,7
1082623,1,11,1,2,1,3
1082627,1,11,1,6,0,6
1082630,1,11,1,4,0,4
1082648,1,11,1,7,0,7
598009,2,11,1,4,0,4
598015,2,11,1,1,1,2
598018,2,11,1,5,2,7
598026,2,11,1,0,0,0
598044,2,11,1,6,0,6
598049,2,11,1,6,0,6
598056,2,11,1,4,0,4
598074,2,11,1,3,0,3
729300,2,11,1,10,1,11
733998,2,11,1,5,5,10
734026,2,11,1,6,0,6
734034,2,11,1,10,0,10
829716,2,11,1,10,0,10
829724,2,11,1,16,0,16
829736,2,11,1,3,0,3
829756,2,11,1,9,0,9
829786,2,11,1,4,2,6
980912,2,11,1,7,5,12
980928,2,11,1,3,1,4
980934,2,11,1,10,0,10
980940,2,11,1,6,0,6
980972,2,11,1,7,0,7
980996,2,11,1,8,0,8
981014,2,11,1,4,0,4
981022,2,11,1,5,1,6
1082596,2,11,1,3,0,3
1082604,2,11,1,3,2,5
1082634,2,11,1,11,0,11
1082638,2,11,1,7,0,7
1082643,2,11,1,6,1,7
598009,3,11,1,19,1,20
980916,1,12,1,5,0,5
980924,1,12,1,4,0,4
980944,1,12,1,2,0,2
980954,1,12,1,5,0,5
980962,1,12,1,6,1,7
980974,1,12,1,9,0,9
980994,1,12,1,3,1,4
1082594,1,12,1,1,0,1
1082603,1,12,1,4,2,6
1082607,1,12,1,3,0,3
1082618,1,12,1,8,1,9
1082620,1,12,1,5,1,6
1082624,1,12,1,3,1,4
1082634,1,12,1,3,0,3
1082647,1,12,1,4,2,6
980906,2,12,1,8,0,8
980936,2,12,1,11,0,11
980948,2,12,1,0,0,0
980970,2,12,1,6,0,6
980984,2,12,1,0,1,1
981002,2,12,1,2,2,4
981010,2,12,1,6,0,6
1082592,2,12,1,7,1,8
1082599,2,12,1,9,1,10
1082615,2,12,1,1,0,1
1082629,2,12,1,8,0,8
1082631,2,12,1,7,0,7
1082642,2,12,1,9,1,10
1082645,2,12,1,3,0,3
1082650,2,12,1,6,0,6
980934,1,13,1,5,0,5
980950,1,13,1,18,0,18
980966,1,13,1,5,0,5
980972,1,13,1,0,0,0
981018,1,13,1,1,1,2
981022,1,13,1,6,1,7
1082593,1,13,1,8,0,8
1082596,1,13,1,3,0,3
1082606,1,13,1,2,1,3
1082625,1,13,1,6,1,7
1082629,1,13,1,10,1,11
1082632,1,13,1,10,0,10
1082640,1,13,1,7,0,7
1082643,1,13,1,11,0,11
980910,2,13,1,1,0,1
980916,2,13,1,6,1,7
980922,2,13,1,11,0,11
980942,2,13,1,2,1,3
980954,2,13,1,6,0,6
980960,2,13,1,10,1,11
980980,2,13,1,1,0,1
980992,2,13,1,7,0,7
981006,2,13,1,11,1,12
981012,2,13,1,0,0,0
1082603,2,13,1,16,0,16
1082610,2,13,1,1,0,1
1082613,2,13,1,9,0,9
1082616,2,13,1,6,0,6
1082621,2,13,1,8,0,8
1082637,2,13,1,7,0,7
1082625,4,13,1,2,4,6
335987,1,1,2,18,0,18
335998,1,1,2,15,1,16
336002,1,1,2,9,0,9
336015,1,1,2,6,1,7
336019,1,1,2,2,0,2
336022,1,1,2,7,1,8
336026,1,1,2,6,1,7
336030,1,1,2,5,0,5
336032,1,1,2,0,0,0
392189,1,1,2,1,0,1
392204,1,1,2,10,0,10
392212,1,1,2,2,0,2
392216,1,1,2,7,2,9
392224,1,1,2,1,1,2
392226,1,1,2,8,0,8
392233,1,1,2,5,0,5
419111,1,1,2,5,0,5
419127,1,1,2,1,0,1
419132,1,1,2,8,0,8
419140,1,1,2,4,1,5
419144,1,1,2,7,1,8
419149,1,1,2,14,1,15
419153,1,1,2,5,0,5
419158,1,1,2,8,0,8
501208,1,1,2,9,0,9
501227,1,1,2,14,0,14
501235,1,1,2,8,1,9
501244,1,1,2,5,0,5
501260,1,1,2,7,0,7
501272,1,1,2,6,2,8
501274,1,1,2,6,0,6
548312,1,1,2,5,1,6
548320,1,1,2,5,3,8
548349,1,1,2,2,0,2
548358,1,1,2,9,0,9
548373,1,1,2,6,1,7
548375,1,1,2,5,0,5
548380,1,1,2,5,0,5
548383,1,1,2,9,0,9
598013,1,1,2,10,0,10
598018,1,1,2,14,1,15
598027,1,1,2,9,0,9
598034,1,1,2,9,1,10
598045,1,1,2,10,0,10
598058,1,1,2,13,0,13
598074,1,1,2,5,0,5
729284,1,1,2,4,0,4
729294,1,1,2,1,0,1
729304,1,1,2,11,0,11
734032,1,1,2,9,1,10
734048,1,1,2,3,0,3
829718,1,1,2,6,0,6
829766,1,1,2,6,1,7
829776,1,1,2,12,0,12
829786,1,1,2,9,0,9
980914,1,1,2,3,0,3
980952,1,1,2,11,0,11
980968,1,1,2,10,0,10
980980,1,1,2,10,0,10
981000,1,1,2,6,0,6
981006,1,1,2,11,0,11
981014,1,1,2,9,0,9
1082597,1,1,2,9,0,9
1082604,1,1,2,6,0,6
1082613,1,1,2,17,0,17
1082617,1,1,2,6,1,7
1082631,1,1,2,4,4,8
1082649,1,1,2,2,0,2
335991,2,1,2,6,4,10
336005,2,1,2,11,2,13
336008,2,1,2,6,0,6
336040,2,1,2,5,0,5
392191,2,1,2,4,2,6
392195,2,1,2,0,1,1
392202,2,1,2,1,0,1
392208,2,1,2,3,0,3
392236,2,1,2,1,0,1
392238,2,1,2,1,0,1
419114,2,1,2,9,0,9
419118,2,1,2,10,0,10
419123,2,1,2,5,1,6
419136,2,1,2,12,1,13
419163,2,1,2,9,0,9
419166,2,1,2,6,0,6
501203,2,1,2,4,0,4
501214,2,1,2,4,1,5
501219,2,1,2,6,1,7
501224,2,1,2,7,0,7
501239,2,1,2,5,0,5
501247,2,1,2,5,1,6
501250,2,1,2,5,1,6
501267,2,1,2,9,1,10
548317,2,1,2,4,0,4
548325,2,1,2,3,0,3
548328,2,1,2,11,0,11
548333,2,1,2,8,0,8
548340,2,1,2,4,0,4
548352,2,1,2,6,1,7
548362,2,1,2,4,0,4
548368,2,1,2,2,0,2
548386,2,1,2,6,0,6
598003,2,1,2,5,0,5
598010,2,1,2,2,2,4
598021,2,1,2,4,1,5
598036,2,1,2,5,0,5
598039,2,1,2,6,0,6
598048,2,1,2,6,1,7
598055,2,1,2,10,0,10
598062,2,1,2,4,0,4
598066,2,1,2,3,6,9
729312,2,1,2,4,0,4
729320,2,1,2,5,0,5
733976,2,1,2,12,1,13
733984,2,1,2,8,0,8
733990,2,1,2,8,5,13
734002,2,1,2,6,2,8
734014,2,1,2,5,1,6
734020,2,1,2,2,0,2
734028,2,1,2,9,0,9
734042,2,1,2,5,0,5
734054,2,1,2,9,0,9
829710,2,1,2,2,0,2
829728,2,1,2,5,2,7
829738,2,1,2,7,1,8
829744,2,1,2,3,4,7
829748,2,1,2,9,2,11
829770,2,1,2,10,0,10
829796,2,1,2,10,0,10
829810,2,1,2,5,0,5
829816,2,1,2,6,0,6
980908,2,1,2,15,1,16
980920,2,1,2,5,1,6
980930,2,1,2,7,1,8
980944,2,1,2,6,0,6
980956,2,1,2,8,0,8
980964,2,1,2,3,2,5
980994,2,1,2,13,0,13
981020,2,1,2,12,0,12
1082593,2,1,2,13,0,13
1082601,2,1,2,8,2,10
1082608,2,1,2,13,0,13
1082620,2,1,2,9,1,10
1082622,2,1,2,6,4,10
1082627,2,1,2,3,0,3
1082636,2,1,2,6,0,6
1082639,2,1,2,11,0,11
1082644,2,1,2,9,2,11
1082648,2,1,2,8,2,10
335997,1,2,2,13,2,15
336011,1,2,2,5,1,6
336017,1,2,2,5,0,5
336021,1,2,2,0,1,1
336031,1,2,2,12,7,19
336034,1,2,2,1,0,1
336039,1,2,2,11,0,11
392187,1,2,2,4,1,5
392196,1,2,2,8,0,8
392199,1,2,2,1,0,1
392209,1,2,2,5,1,6
392218,1,2,2,7,0,7
392241,1,2,2,3,0,3
419114,1,2,2,6,0,6
419128,1,2,2,6,0,6
419138,1,2,2,9,0,9
419150,1,2,2,11,2,13
501210,1,2,2,1,2,3
501237,1,2,2,5,0,5
501249,1,2,2,0,3,3
501273,1,2,2,1,4,5
501275,1,2,2,8,1,9
548315,1,2,2,7,0,7
548323,1,2,2,5,1,6
548341,1,2,2,10,0,10
548355,1,2,2,7,0,7
548367,1,2,2,7,1,8
548372,1,2,2,1,0,1
548377,1,2,2,0,0,0
598004,1,2,2,1,0,1
598009,1,2,2,5,0,5
598017,1,2,2,1,0,1
598032,1,2,2,20,1,21
598041,1,2,2,8,1,9
598047,1,2,2,1,0,1
598050,1,2,2,5,0,5
598059,1,2,2,5,0,5
598062,1,2,2,2,0,2
598069,1,2,2,8,0,8
598073,1,2,2,8,3,11
729310,1,2,2,4,0,4
729318,1,2,2,5,0,5
734004,1,2,2,1,0,1
734010,1,2,2,8,0,8
734026,1,2,2,2,0,2
734040,1,2,2,4,0,4
829724,1,2,2,9,0,9
829768,1,2,2,5,4,9
829790,1,2,2,20,0,20
829800,1,2,2,6,0,6
829824,1,2,2,5,0,5
829826,1,2,2,5,0,5
980912,1,2,2,2,1,3
980926,1,2,2,5,0,5
980932,1,2,2,1,1,2
980936,1,2,2,2,0,2
980942,1,2,2,7,0,7
980964,1,2,2,9,0,9
980982,1,2,2,4,0,4
980986,1,2,2,3,0,3
980992,1,2,2,2,0,2
981004,1,2,2,6,0,6
1082595,1,2,2,8,1,9
1082598,1,2,2,5,0,5
1082602,1,2,2,1,0,1
1082610,1,2,2,5,0,5
1082621,1,2,2,7,0,7
1082628,1,2,2,6,0,6
1082636,1,2,2,11,0,11
1082646,1,2,2,7,0,7
335987,2,2,2,1,4,5
335990,2,2,2,1,0,1
336001,2,2,2,6,0,6
336003,2,2,2,10,0,10
336007,2,2,2,6,0,6
336015,2,2,2,5,0,5
336028,2,2,2,3,0,3
392190,2,2,2,9,0,9
392193,2,2,2,3,0,3
392204,2,2,2,6,2,8
392213,2,2,2,11,1,12
392223,2,2,2,7,2,9
392226,2,2,2,4,1,5
392229,2,2,2,10,1,11
392237,2,2,2,4,0,4
392243,2,2,2,8,0,8
392244,2,2,2,4,0,4
419117,2,2,2,4,1,5
419120,2,2,2,17,3,20
419124,2,2,2,2,0,2
419133,2,2,2,5,0,5
419141,2,2,2,4,1,5
419145,2,2,2,6,1,7
419153,2,2,2,3,0,3
419156,2,2,2,7,1,8
419159,2,2,2,1,0,1
419162,2,2,2,1,0,1
419167,2,2,2,10,0,10
419169,2,2,2,7,1,8
501205,2,2,2,4,0,4
501213,2,2,2,6,0,6
501216,2,2,2,2,1,3
501227,2,2,2,5,0,5
501232,2,2,2,16,0,16
501252,2,2,2,20,0,20
501257,2,2,2,10,0,10
501260,2,2,2,23,0,23
501265,2,2,2,1,4,5
501271,2,2,2,1,1,2
501276,2,2,2,9,0,9
548320,2,2,2,1,0,1
548329,2,2,2,4,0,4
548332,2,2,2,1,0,1
548336,2,2,2,5,0,5
548349,2,2,2,6,1,7
548361,2,2,2,7,0,7
548365,2,2,2,1,2,3
548381,2,2,2,24,0,24
598013,2,2,2,7,0,7
598022,2,2,2,7,1,8
598028,2,2,2,9,0,9
598038,2,2,2,5,0,5
598053,2,2,2,4,0,4
729286,2,2,2,5,0,5
729292,2,2,2,4,0,4
729304,2,2,2,2,0,2
733982,2,2,2,0,1,1
733988,2,2,2,9,0,9
733996,2,2,2,4,0,4
734018,2,2,2,1,0,1
734032,2,2,2,6,0,6
829718,2,2,2,4,0,4
829742,2,2,2,0,0,0
829750,2,2,2,3,1,4
829754,2,2,2,5,4,9
829762,2,2,2,14,0,14
829776,2,2,2,17,1,18
829784,2,2,2,6,0,6
829808,2,2,2,6,0,6
829812,2,2,2,24,0,24
829818,2,2,2,0,0,0
980958,2,2,2,12,0,12
980974,2,2,2,2,1,3
981000,2,2,2,8,0,8
981016,2,2,2,6,5,11
981018,2,2,2,5,1,6
981024,2,2,2,11,2,13
1082591,2,2,2,1,0,1
1082607,2,2,2,11,0,11
1082617,2,2,2,4,0,4
1082624,2,2,2,7,0,7
1082633,2,2,2,15,0,15
335988,1,3,2,14,1,15
335994,1,3,2,9,0,9
336001,1,3,2,10,0,10
336006,1,3,2,6,1,7
336010,1,3,2,4,5,9
336012,1,3,2,2,4,6
336018,1,3,2,7,1,8
336023,1,3,2,12,0,12
336045,1,3,2,6,0,6
392190,1,3,2,5,1,6
392201,1,3,2,15,1,16
392207,1,3,2,1,0,1
392211,1,3,2,6,0,6
392214,1,3,2,4,1,5
392219,1,3,2,7,1,8
392229,1,3,2,15,1,16
392236,1,3,2,10,2,12
392239,1,3,2,11,0,11
392243,1,3,2,13,0,13
419118,1,3,2,9,0,9
419130,1,3,2,16,1,17
419142,1,3,2,15,0,15
419147,1,3,2,6,0,6
419152,1,3,2,10,1,11
419160,1,3,2,4,0,4
419168,1,3,2,5,1,6
419170,1,3,2,2,0,2
501203,1,3,2,6,0,6
501211,1,3,2,2,0,2
501216,1,3,2,3,1,4
501220,1,3,2,1,0,1
501231,1,3,2,7,1,8
501241,1,3,2,2,0,2
501250,1,3,2,4,0,4
501254,1,3,2,7,1,8
501258,1,3,2,11,0,11
501266,1,3,2,2,0,2
501271,1,3,2,2,0,2
501276,1,3,2,11,0,11
548311,1,3,2,3,1,4
548316,1,3,2,6,1,7
548321,1,3,2,7,1,8
548327,1,3,2,7,0,7
548335,1,3,2,2,0,2
548352,1,3,2,1,0,1
548357,1,3,2,5,0,5
548360,1,3,2,8,0,8
548376,1,3,2,5,2,7
548384,1,3,2,2,1,3
548385,1,3,2,7,0,7
548386,1,3,2,3,0,3
598025,1,3,2,6,0,6
598039,1,3,2,5,0,5
598043,1,3,2,0,0,0
598046,1,3,2,7,0,7
598056,1,3,2,10,1,11
598063,1,3,2,3,1,4
598067,1,3,2,4,0,4
598075,1,3,2,12,0,12
729288,1,3,2,9,1,10
729298,1,3,2,10,0,10
729302,1,3,2,3,0,3
733976,1,3,2,5,0,5
734018,1,3,2,1,0,1
734028,1,3,2,0,0,0
734034,1,3,2,12,0,12
829712,1,3,2,8,2,10
829716,1,3,2,6,1,7
829728,1,3,2,4,0,4
829740,1,3,2,2,0,2
829750,1,3,2,7,0,7
829758,1,3,2,10,0,10
829770,1,3,2,6,1,7
829784,1,3,2,6,0,6
829794,1,3,2,0,5,5
829802,1,3,2,6,0,6
829806,1,3,2,1,0,1
335998,2,3,2,2,1,3
336014,2,3,2,15,0,15
336030,2,3,2,13,0,13
336034,2,3,2,2,0,2
336038,2,3,2,8,1,9
336042,2,3,2,6,0,6
336044,2,3,2,6,1,7
392186,2,3,2,14,0,14
392194,2,3,2,9,1,10
392207,2,3,2,0,0,0
392222,2,3,2,1,0,1
392232,2,3,2,13,0,13
419115,2,3,2,8,0,8
419121,2,3,2,17,0,17
419126,2,3,2,1,1,2
419128,2,3,2,6,2,8
419134,2,3,2,11,0,11
419138,2,3,2,6,1,7
419158,2,3,2,13,1,14
419164,2,3,2,7,0,7
501226,2,3,2,4,1,5
501233,2,3,2,2,0,2
501245,2,3,2,3,0,3
501273,2,3,2,9,0,9
548323,2,3,2,5,0,5
548337,2,3,2,12,0,12
548348,2,3,2,6,0,6
548366,2,3,2,9,0,9
548369,2,3,2,7,1,8
548373,2,3,2,10,1,11
598007,2,3,2,5,0,5
598012,2,3,2,3,0,3
598017,2,3,2,1,0,1
598020,2,3,2,7,0,7
598027,2,3,2,5,0,5
598031,2,3,2,11,0,11
598035,2,3,2,12,1,13
598051,2,3,2,3,0,3
598073,2,3,2,3,0,3
598078,2,3,2,1,2,3
729308,2,3,2,2,0,2
729316,2,3,2,5,1,6
733986,2,3,2,5,3,8
733992,2,3,2,3,0,3
734000,2,3,2,2,0,2
734008,2,3,2,12,1,13
734040,2,3,2,15,0,15
734050,2,3,2,10,0,10
734052,2,3,2,18,0,18
829734,2,3,2,11,1,12
829778,2,3,2,0,1,1
829814,2,3,2,8,0,8
829822,2,3,2,15,2,17
829826,2,3,2,7,0,7
829828,2,3,2,7,0,7
335992,1,4,2,5,0,5
335996,1,4,2,6,0,6
336008,1,4,2,11,0,11
336024,1,4,2,8,0,8
336033,1,4,2,5,0,5
336040,1,4,2,11,5,16
336044,1,4,2,4,0,4
392188,1,4,2,11,0,11
392191,1,4,2,8,0,8
392200,1,4,2,6,0,6
392205,1,4,2,1,0,1
392227,1,4,2,5,0,5
392234,1,4,2,2,1,3
419113,1,4,2,8,1,9
419117,1,4,2,8,1,9
419126,1,4,2,11,0,11
419137,1,4,2,5,4,9
419141,1,4,2,7,0,7
419148,1,4,2,10,0,10
419161,1,4,2,6,0,6
419164,1,4,2,5,1,6
501207,1,4,2,0,1,1
501225,1,4,2,11,3,14
501239,1,4,2,7,0,7
501253,1,4,2,13,0,13
501256,1,4,2,4,2,6
501262,1,4,2,0,1,1
501265,1,4,2,7,2,9
548328,1,4,2,7,0,7
548333,1,4,2,7,0,7
548336,1,4,2,7,0,7
548344,1,4,2,6,0,6
548348,1,4,2,11,0,11
548364,1,4,2,16,2,18
548374,1,4,2,13,0,13
548379,1,4,2,0,0,0
598012,1,4,2,10,1,11
598019,1,4,2,3,4,7
598021,1,4,2,6,0,6
598026,1,4,2,4,0,4
598033,1,4,2,6,2,8
598036,1,4,2,0,0,0
598057,1,4,2,5,0,5
598071,1,4,2,0,0,0
729300,1,4,2,1,0,1
729312,1,4,2,1,1,2
733978,1,4,2,5,3,8
733992,1,4,2,12,0,12
733996,1,4,2,6,0,6
734002,1,4,2,4,0,4
734030,1,4,2,12,0,12
734038,1,4,2,4,1,5
734052,1,4,2,1,0,1
734054,1,4,2,6,0,6
829722,1,4,2,5,0,5
829730,1,4,2,10,0,10
829738,1,4,2,3,1,4
829772,1,4,2,3,0,3
829796,1,4,2,8,0,8
829808,1,4,2,19,1,20
829814,1,4,2,9,0,9
980910,1,4,2,10,0,10
980918,1,4,2,10,0,10
980930,1,4,2,6,0,6
980940,1,4,2,6,0,6
980960,1,4,2,4,0,4
980976,1,4,2,10,0,10
980996,1,4,2,12,0,12
981010,1,4,2,2,0,2
1082601,1,4,2,9,2,11
1082612,1,4,2,7,0,7
1082616,1,4,2,5,0,5
1082633,1,4,2,9,0,9
1082637,1,4,2,1,0,1
1082639,1,4,2,3,0,3
1082641,1,4,2,15,1,16
1082645,1,4,2,7,0,7
335988,2,4,2,7,0,7
336000,2,4,2,9,0,9
336004,2,4,2,6,0,6
336011,2,4,2,4,3,7
336018,2,4,2,4,0,4
336021,2,4,2,1,0,1
336027,2,4,2,11,1,12
336036,2,4,2,9,0,9
392196,2,4,2,8,2,10
392209,2,4,2,1,0,1
392212,2,4,2,2,2,4
392215,2,4,2,1,0,1
392219,2,4,2,6,0,6
392221,2,4,2,12,0,12
392231,2,4,2,14,0,14
392239,2,4,2,2,1,3
419122,2,4,2,1,0,1
419129,2,4,2,3,1,4
419132,2,4,2,4,2,6
419144,2,4,2,11,0,11
419151,2,4,2,9,1,10
419154,2,4,2,4,0,4
501211,2,4,2,7,0,7
501217,2,4,2,6,1,7
501228,2,4,2,14,0,14
501242,2,4,2,2,0,2
501249,2,4,2,1,0,1
501259,2,4,2,6,0,6
501269,2,4,2,9,0,9
548314,2,4,2,3,0,3
548318,2,4,2,4,0,4
548324,2,4,2,6,0,6
548339,2,4,2,6,0,6
548355,2,4,2,6,0,6
548359,2,4,2,0,0,0
548371,2,4,2,3,1,4
548376,2,4,2,9,3,12
598008,2,4,2,6,1,7
598030,2,4,2,10,0,10
598042,2,4,2,5,0,5
598046,2,4,2,5,0,5
598050,2,4,2,11,1,12
598061,2,4,2,5,0,5
598064,2,4,2,14,0,14
598069,2,4,2,6,0,6
729288,2,4,2,11,0,11
729296,2,4,2,1,0,1
729318,2,4,2,8,2,10
734012,2,4,2,15,1,16
734024,2,4,2,9,2,11
734044,2,4,2,2,0,2
734048,2,4,2,2,1,3
829714,2,4,2,9,1,10
829746,2,4,2,1,0,1
829758,2,4,2,4,0,4
829764,2,4,2,4,1,5
829780,2,4,2,7,0,7
829790,2,4,2,8,0,8
829804,2,4,2,15,1,16
980924,2,4,2,11,2,13
980946,2,4,2,9,0,9
980968,2,4,2,4,1,5
980982,2,4,2,6,1,7
980990,2,4,2,5,0,5
981004,2,4,2,8,0,8
1082594,2,4,2,11,2,13
1082598,2,4,2,8,0,8
1082605,2,4,2,4,0,4
1082609,2,4,2,9,0,9
1082623,2,4,2,15,0,15
1082626,2,4,2,6,1,7
335989,1,5,2,10,0,10
336005,1,5,2,6,0,6
336013,1,5,2,7,0,7
336028,1,5,2,4,4,8
336038,1,5,2,3,0,3
336043,1,5,2,7,0,7
392195,1,5,2,4,0,4
392215,1,5,2,5,0,5
392222,1,5,2,3,0,3
392230,1,5,2,7,0,7
392238,1,5,2,4,0,4
419116,1,5,2,1,0,1
419120,1,5,2,7,0,7
419123,1,5,2,6,2,8
419129,1,5,2,8,1,9
419134,1,5,2,8,2,10
419146,1,5,2,10,0,10
419159,1,5,2,6,1,7
419163,1,5,2,2,0,2
501214,1,5,2,4,2,6
501219,1,5,2,9,0,9
501245,1,5,2,6,0,6
501257,1,5,2,10,0,10
501263,1,5,2,2,1,3
548314,1,5,2,11,0,11
548317,1,5,2,3,0,3
548325,1,5,2,7,0,7
548329,1,5,2,9,0,9
548337,1,5,2,7,1,8
548354,1,5,2,10,1,11
548359,1,5,2,5,0,5
548366,1,5,2,0,5,5
548370,1,5,2,5,0,5
548378,1,5,2,2,0,2
548382,1,5,2,1,1,2
598006,1,5,2,6,0,6
598010,1,5,2,5,0,5
598014,1,5,2,7,0,7
598024,1,5,2,8,0,8
598028,1,5,2,5,0,5
598031,1,5,2,5,0,5
598048,1,5,2,3,0,3
598077,1,5,2,7,0,7
729296,1,5,2,7,0,7
729320,1,5,2,4,2,6
733984,1,5,2,8,1,9
734008,1,5,2,6,0,6
734016,1,5,2,8,4,12
734046,1,5,2,0,0,0
829714,1,5,2,4,0,4
829746,1,5,2,8,0,8
829754,1,5,2,1,0,1
829782,1,5,2,7,0,7
829816,1,5,2,10,4,14
335992,2,5,2,5,2,7
335995,2,5,2,7,2,9
335997,2,5,2,9,0,9
336010,2,5,2,6,0,6
336016,2,5,2,1,0,1
336020,2,5,2,6,0,6
336024,2,5,2,3,0,3
336032,2,5,2,10,0,10
336041,2,5,2,8,0,8
336045,2,5,2,12,0,12
392187,2,5,2,2,2,4
392200,2,5,2,1,2,3
392203,2,5,2,5,1,6
392207,2,5,2,2,0,2
392210,2,5,2,0,0,0
392218,2,5,2,2,0,2
392225,2,5,2,3,0,3
392235,2,5,2,5,1,6
419112,2,5,2,7,0,7
419131,2,5,2,6,0,6
419139,2,5,2,9,0,9
419142,2,5,2,1,0,1
419148,2,5,2,9,0,9
419155,2,5,2,8,0,8
501204,2,5,2,8,0,8
501209,2,5,2,1,4,5
501225,2,5,2,5,0,5
501230,2,5,2,8,0,8
501236,2,5,2,4,0,4
501240,2,5,2,9,0,9
501254,2,5,2,8,2,10
501268,2,5,2,12,0,12
548322,2,5,2,2,0,2
548331,2,5,2,12,0,12
548341,2,5,2,10,0,10
548350,2,5,2,8,0,8
548363,2,5,2,1,0,1
598019,2,5,2,12,1,13
598037,2,5,2,6,0,6
598041,2,5,2,13,0,13
598052,2,5,2,2,0,2
598054,2,5,2,5,2,7
598057,2,5,2,2,0,2
598063,2,5,2,1,0,1
598068,2,5,2,5,1,6
598070,2,5,2,11,0,11
598076,2,5,2,5,0,5
729290,2,5,2,6,0,6
729302,2,5,2,0,0,0
729310,2,5,2,2,0,2
733980,2,5,2,9,0,9
733994,2,5,2,9,0,9
734004,2,5,2,4,0,4
734022,2,5,2,12,1,13
734038,2,5,2,11,0,11
829720,2,5,2,8,0,8
829726,2,5,2,10,1,11
829732,2,5,2,4,1,5
829740,2,5,2,7,0,7
829774,2,5,2,9,0,9
829792,2,5,2,4,0,4
829802,2,5,2,2,0,2
829824,2,5,2,3,0,3
336000,1,6,2,1,2,3
336003,1,6,2,14,0,14
336014,1,6,2,10,2,12
336020,1,6,2,3,0,3
336025,1,6,2,5,0,5
336027,1,6,2,4,0,4
392194,1,6,2,6,0,6
392203,1,6,2,8,0,8
392228,1,6,2,11,1,12
392231,1,6,2,6,0,6
392235,1,6,2,8,0,8
392237,1,6,2,1,0,1
392242,1,6,2,13,0,13
419121,1,6,2,10,0,10
419133,1,6,2,16,0,16
419136,1,6,2,11,1,12
419139,1,6,2,4,0,4
419145,1,6,2,9,0,9
419154,1,6,2,13,2,15
501206,1,6,2,6,1,7
501209,1,6,2,1,1,2
501228,1,6,2,4,0,4
501232,1,6,2,10,0,10
501238,1,6,2,0,0,0
501243,1,6,2,6,0,6
501270,1,6,2,0,1,1
548347,1,6,2,7,0,7
548350,1,6,2,6,0,6
548362,1,6,2,17,0,17
548369,1,6,2,7,0,7
598003,1,6,2,6,2,8
598015,1,6,2,12,0,12
598022,1,6,2,14,1,15
598040,1,6,2,5,0,5
598049,1,6,2,0,0,0
598054,1,6,2,10,0,10
598064,1,6,2,4,0,4
729286,1,6,2,3,0,3
733980,1,6,2,7,0,7
733986,1,6,2,0,0,0
733990,1,6,2,6,0,6
733998,1,6,2,5,1,6
734024,1,6,2,5,0,5
734044,1,6,2,6,0,6
829720,1,6,2,5,0,5
829736,1,6,2,8,0,8
829744,1,6,2,1,1,2
829752,1,6,2,5,2,7
829762,1,6,2,6,2,8
829788,1,6,2,2,1,3
829818,1,6,2,4,1,5
980908,1,6,2,10,0,10
980938,1,6,2,1,0,1
980956,1,6,2,10,1,11
980970,1,6,2,9,0,9
981002,1,6,2,2,0,2
981016,1,6,2,3,0,3
1082599,1,6,2,10,1,11
1082605,1,6,2,9,0,9
1082608,1,6,2,9,0,9
1082622,1,6,2,11,1,12
1082626,1,6,2,0,1,1
1082642,1,6,2,6,0,6
335989,2,6,2,12,1,13
335993,2,6,2,14,0,14
336006,2,6,2,16,1,17
336009,2,6,2,2,0,2
336022,2,6,2,11,0,11
336031,2,6,2,8,5,13
336037,2,6,2,10,0,10
336043,2,6,2,4,1,5
392188,2,6,2,18,1,19
392199,2,6,2,3,1,4
392206,2,6,2,11,0,11
392211,2,6,2,5,1,6
392216,2,6,2,7,0,7
392220,2,6,2,3,0,3
392224,2,6,2,9,0,9
392240,2,6,2,11,0,11
419113,2,6,2,1,0,1
419116,2,6,2,10,2,12
419119,2,6,2,9,0,9
419125,2,6,2,20,0,20
419149,2,6,2,9,1,10
419157,2,6,2,5,1,6
419160,2,6,2,2,0,2
419165,2,6,2,9,0,9
501218,2,6,2,7,0,7
501221,2,6,2,17,0,17
501235,2,6,2,7,0,7
501248,2,6,2,2,1,3
501251,2,6,2,0,0,0
501258,2,6,2,12,1,13
501262,2,6,2,4,1,5
548312,2,6,2,10,1,11
548315,2,6,2,10,0,10
548321,2,6,2,7,0,7
548326,2,6,2,5,0,5
548330,2,6,2,3,3,6
548334,2,6,2,6,1,7
548338,2,6,2,7,0,7
548342,2,6,2,7,0,7
548354,2,6,2,13,0,13
548374,2,6,2,9,1,10
548377,2,6,2,7,0,7
548379,2,6,2,4,0,4
548383,2,6,2,9,4,13
548385,2,6,2,11,0,11
598006,2,6,2,5,0,5
598011,2,6,2,8,0,8
598025,2,6,2,3,1,4
598029,2,6,2,7,1,8
598033,2,6,2,4,0,4
598045,2,6,2,9,0,9
598059,2,6,2,9,0,9
598067,2,6,2,6,0,6
598072,2,6,2,5,0,5
729294,2,6,2,6,2,8
729298,2,6,2,2,0,2
729306,2,6,2,7,1,8
729314,2,6,2,6,0,6
734010,2,6,2,3,0,3
734016,2,6,2,13,0,13
734036,2,6,2,14,0,14
829712,2,6,2,9,0,9
829730,2,6,2,8,0,8
829766,2,6,2,7,0,7
829772,2,6,2,18,1,19
829782,2,6,2,8,0,8
829798,2,6,2,8,0,8
829806,2,6,2,9,0,9
980918,2,6,2,3,0,3
980926,2,6,2,13,0,13
980950,2,6,2,0,0,0
980966,2,6,2,14,0,14
980976,2,6,2,7,0,7
980988,2,6,2,8,0,8
980998,2,6,2,3,0,3
981008,2,6,2,2,0,2
1082595,2,6,2,4,0,4
1082611,2,6,2,13,0,13
1082614,2,6,2,5,0,5
1082630,2,6,2,13,0,13
1082632,2,6,2,3,1,4
1082635,2,6,2,1,1,2
1082640,2,6,2,8,0,8
1082646,2,6,2,7,4,11
335990,1,7,2,1,4,5
335999,1,7,2,8,0,8
336009,1,7,2,9,0,9
336029,1,7,2,19,0,19
336037,1,7,2,10,1,11
336041,1,7,2,3,1,4
392186,1,7,2,6,1,7
392202,1,7,2,11,1,12
392208,1,7,2,6,0,6
392213,1,7,2,9,3,12
392220,1,7,2,5,3,8
392223,1,7,2,2,1,3
392232,1,7,2,6,0,6
392240,1,7,2,8,0,8
419112,1,7,2,11,2,13
419119,1,7,2,10,0,10
419124,1,7,2,4,2,6
419135,1,7,2,9,0,9
419143,1,7,2,6,0,6
419151,1,7,2,1,0,1
419155,1,7,2,1,0,1
419157,1,7,2,8,0,8
419162,1,7,2,9,0,9
419166,1,7,2,4,0,4
419167,1,7,2,8,1,9
501215,1,7,2,6,6,12
501226,1,7,2,4,5,9
501229,1,7,2,9,0,9
501236,1,7,2,3,1,4
501242,1,7,2,8,2,10
501246,1,7,2,9,0,9
501251,1,7,2,5,0,5
501268,1,7,2,4,1,5
548322,1,7,2,3,0,3
548330,1,7,2,1,0,1
548339,1,7,2,3,0,3
548356,1,7,2,0,0,0
548365,1,7,2,0,1,1
548368,1,7,2,12,0,12
598007,1,7,2,7,0,7
598011,1,7,2,6,0,6
598016,1,7,2,8,0,8
598029,1,7,2,4,0,4
598038,1,7,2,3,2,5
598042,1,7,2,8,0,8
598044,1,7,2,4,0,4
598051,1,7,2,0,1,1
598055,1,7,2,10,1,11
598068,1,7,2,8,0,8
598078,1,7,2,1,2,3
729292,1,7,2,2,0,2
729308,1,7,2,9,0,9
729314,1,7,2,6,1,7
733988,1,7,2,12,0,12
734000,1,7,2,4,0,4
734014,1,7,2,9,0,9
734022,1,7,2,4,0,4
734036,1,7,2,7,0,7
734050,1,7,2,6,1,7
829710,1,7,2,5,0,5
829726,1,7,2,11,0,11
829734,1,7,2,0,0,0
829742,1,7,2,5,6,11
829756,1,7,2,5,3,8
829774,1,7,2,11,2,13
829780,1,7,2,6,1,7
829810,1,7,2,4,0,4
829822,1,7,2,4,2,6
829828,1,7,2,16,0,16
980906,1,7,2,0,4,4
980922,1,7,2,6,0,6
980928,1,7,2,8,0,8
980946,1,7,2,9,0,9
980990,1,7,2,1,1,2
980998,1,7,2,3,0,3
981012,1,7,2,11,0,11
1082592,1,7,2,8,0,8
1082614,1,7,2,11,1,12
1082635,1,7,2,5,2,7
1082638,1,7,2,1,0,1
1082644,1,7,2,8,2,10
1082650,1,7,2,4,0,4
335994,2,7,2,0,4,4
335996,2,7,2,11,1,12
336002,2,7,2,10,0,10
336013,2,7,2,3,1,4
336017,2,7,2,0,1,1
336023,2,7,2,10,2,12
336026,2,7,2,13,2,15
336033,2,7,2,21,3,24
392197,2,7,2,1,0,1
392202,2,7,2,1,2,3
392205,2,7,2,1,1,2
392217,2,7,2,1,0,1
392227,2,7,2,0,0,0
392230,2,7,2,1,0,1
419119,2,7,2,2,1,3
419127,2,7,2,12,0,12
419130,2,7,2,8,5,13
419137,2,7,2,0,1,1
419147,2,7,2,9,0,9
419170,2,7,2,3,0,3
501206,2,7,2,4,1,5
501210,2,7,2,4,0,4
501223,2,7,2,1,4,5
501256,2,7,2,7,0,7
501261,2,7,2,4,0,4
501272,2,7,2,1,0,1
501274,2,7,2,7,0,7
501275,2,7,2,10,0,10
548311,2,7,2,9,1,10
548313,2,7,2,1,2,3
548319,2,7,2,6,0,6
548344,2,7,2,8,0,8
548347,2,7,2,8,0,8
548351,2,7,2,5,1,6
548360,2,7,2,8,0,8
548372,2,7,2,4,1,5
548375,2,7,2,1,1,2
548382,2,7,2,4,0,4
548384,2,7,2,12,2,14
598004,2,7,2,2,0,2
598024,2,7,2,2,0,2
598034,2,7,2,1,0,1
598060,2,7,2,1,3,4
598065,2,7,2,7,1,8
598071,2,7,2,11,0,11
598075,2,7,2,2,0,2
598077,2,7,2,11,1,12
729284,2,7,2,1,0,1
729322,2,7,2,1,1,2
733978,2,7,2,11,0,11
734006,2,7,2,1,0,1
734030,2,7,2,2,5,7
734046,2,7,2,7,0,7
829722,2,7,2,7,0,7
829752,2,7,2,4,0,4
829788,2,7,2,0,0,0
829794,2,7,2,7,0,7
829800,2,7,2,2,0,2
829820,2,7,2,2,1,3
980914,2,7,2,9,1,10
980932,2,7,2,2,0,2
980938,2,7,2,5,0,5
980952,2,7,2,7,1,8
980962,2,7,2,4,0,4
980978,2,7,2,4,0,4
980986,2,7,2,2,0,2
1082597,2,7,2,2,4,6
1082600,2,7,2,15,0,15
1082602,2,7,2,3,0,3
1082606,2,7,2,7,1,8
1082612,2,7,2,9,2,11
1082618,2,7,2,11,0,11
1082625,2,7,2,11,0,11
1082628,2,7,2,9,0,9
1082641,2,7,2,13,0,13
1082647,2,7,2,8,0,8
1082649,2,7,2,2,1,3
335991,1,8,2,2,3,5
335993,1,8,2,8,0,8
335995,1,8,2,10,0,10
336004,1,8,2,10,0,10
336007,1,8,2,8,1,9
336016,1,8,2,3,2,5
336036,1,8,2,7,1,8
336042,1,8,2,5,1,6
392193,1,8,2,15,0,15
392197,1,8,2,9,0,9
392206,1,8,2,10,1,11
392210,1,8,2,10,0,10
392217,1,8,2,0,1,1
392221,1,8,2,9,0,9
392225,1,8,2,3,0,3
392244,1,8,2,8,3,11
419115,1,8,2,18,1,19
419122,1,8,2,23,1,24
419125,1,8,2,14,0,14
419131,1,8,2,14,2,16
419156,1,8,2,7,2,9
419165,1,8,2,8,0,8
419169,1,8,2,3,1,4
501204,1,8,2,10,0,10
501213,1,8,2,9,2,11
501217,1,8,2,4,0,4
501221,1,8,2,1,0,1
501234,1,8,2,1,0,1
501248,1,8,2,4,0,4
501255,1,8,2,8,0,8
501261,1,8,2,1,0,1
501269,1,8,2,5,6,11
548319,1,8,2,5,0,5
548326,1,8,2,7,0,7
548331,1,8,2,6,1,7
548334,1,8,2,8,0,8
548340,1,8,2,2,0,2
548346,1,8,2,3,1,4
548351,1,8,2,9,0,9
548353,1,8,2,0,0,0
548361,1,8,2,10,1,11
548371,1,8,2,13,2,15
548381,1,8,2,4,0,4
335999,2,8,2,10,0,10
336012,2,8,2,1,0,1
336019,2,8,2,6,0,6
336025,2,8,2,10,1,11
336029,2,8,2,6,1,7
336039,2,8,2,4,0,4
392189,2,8,2,5,0,5
392201,2,8,2,19,1,20
392214,2,8,2,0,1,1
392228,2,8,2,11,1,12
392233,2,8,2,15,0,15
392234,2,8,2,18,0,18
392241,2,8,2,8,0,8
392242,2,8,2,2,1,3
419111,2,8,2,10,1,11
419135,2,8,2,6,4,10
419140,2,8,2,8,1,9
419143,2,8,2,4,0,4
419146,2,8,2,16,4,20
419150,2,8,2,6,0,6
419152,2,8,2,5,1,6
419161,2,8,2,8,0,8
419168,2,8,2,0,1,1
501208,2,8,2,6,1,7
501229,2,8,2,10,0,10
501241,2,8,2,12,0,12
501244,2,8,2,9,0,9
501264,2,8,2,7,1,8
548316,2,8,2,11,1,12
548357,2,8,2,5,0,5
548364,2,8,2,2,0,2
548378,2,8,2,6,0,6
501205,1,9,2,16,0,16
501212,1,9,2,1,0,1
501224,1,9,2,4,1,5
501230,1,9,2,1,1,2
501247,1,9,2,6,1,7
501252,1,9,2,5,0,5
501259,1,9,2,5,1,6
501215,2,9,2,1,2,3
501220,2,9,2,2,1,3
501234,2,9,2,0,2,2
501238,2,9,2,7,0,7
501243,2,9,2,13,0,13
501263,2,9,2,18,1,19
501266,2,9,2,5,2,7
501218,1,10,2,5,0,5
501223,1,10,2,5,2,7
501233,1,10,2,6,0,6
501240,1,10,2,10,0,10
501264,1,10,2,4,0,4
501267,1,10,2,1,0,1
548313,1,10,2,2,0,2
548318,1,10,2,5,0,5
548324,1,10,2,3,0,3
548332,1,10,2,13,0,13
548338,1,10,2,3,0,3
548342,1,10,2,1,0,1
548363,1,10,2,1,0,1
598008,1,10,2,1,0,1
598020,1,10,2,6,0,6
598030,1,10,2,11,0,11
598052,1,10,2,6,1,7
598060,1,10,2,11,0,11
598066,1,10,2,10,0,10
598072,1,10,2,5,0,5
501207,2,10,2,4,0,4
501212,2,10,2,7,3,10
501231,2,10,2,8,1,9
501237,2,10,2,6,2,8
501246,2,10,2,6,0,6
501253,2,10,2,8,2,10
501255,2,10,2,9,0,9
548327,2,10,2,10,0,10
548335,2,10,2,6,0,6
548346,2,10,2,8,0,8
548353,2,10,2,8,0,8
548356,2,10,2,7,0,7
548358,2,10,2,6,2,8
548367,2,10,2,6,0,6
548370,2,10,2,7,1,8
548380,2,10,2,2,0,2
598005,2,10,2,1,0,1
598014,2,10,2,7,0,7
598016,2,10,2,7,1,8
598023,2,10,2,12,0,12
598032,2,10,2,2,0,2
598040,2,10,2,10,0,10
598043,2,10,2,11,1,12
598047,2,10,2,7,1,8
598058,2,10,2,9,1,10
598005,1,11,2,6,0,6
598023,1,11,2,2,1,3
598035,1,11,2,4,2,6
598037,1,11,2,5,0,5
598053,1,11,2,5,0,5
598061,1,11,2,11,0,11
598065,1,11,2,11,1,12
598070,1,11,2,0,1,1
598076,1,11,2,1,0,1
729290,1,11,2,1,1,2
729306,1,11,2,6,3,9
729316,1,11,2,7,0,7
729322,1,11,2,4,1,5
733982,1,11,2,12,0,12
733994,1,11,2,10,0,10
734006,1,11,2,1,0,1
734012,1,11,2,3,1,4
734020,1,11,2,6,0,6
734042,1,11,2,1,4,5
829732,1,11,2,12,0,12
829748,1,11,2,8,0,8
829764,1,11,2,10,0,10
829778,1,11,2,3,0,3
829792,1,11,2,1,4,5
829798,1,11,2,7,0,7
829804,1,11,2,14,0,14
829812,1,11,2,9,0,9
829820,1,11,2,0,1,1
980920,1,11,2,5,0,5
980948,1,11,2,3,0,3
980958,1,11,2,8,0,8
980978,1,11,2,7,0,7
980984,1,11,2,8,1,9
980988,1,11,2,3,0,3
981008,1,11,2,9,0,9
981020,1,11,2,8,0,8
981024,1,11,2,3,2,5
1082591,1,11,2,15,1,16
1082600,1,11,2,2,1,3
1082609,1,11,2,3,3,6
1082611,1,11,2,2,0,2
1082615,1,11,2,1,4,5
1082623,1,11,2,10,0,10
1082627,1,11,2,12,0,12
1082630,1,11,2,11,0,11
1082648,1,11,2,6,0,6
598009,2,11,2,6,2,8
598015,2,11,2,0,0,0
598018,2,11,2,4,0,4
598026,2,11,2,8,0,8
598044,2,11,2,10,0,10
598049,2,11,2,11,0,11
598056,2,11,2,7,0,7
598074,2,11,2,10,0,10
729300,2,11,2,5,0,5
733998,2,11,2,3,4,7
734026,2,11,2,9,1,10
734034,2,11,2,12,0,12
829716,2,11,2,5,0,5
829724,2,11,2,19,1,20
829736,2,11,2,4,3,7
829756,2,11,2,5,0,5
829786,2,11,2,9,0,9
980912,2,11,2,10,0,10
980928,2,11,2,10,0,10
980934,2,11,2,7,6,13
980940,2,11,2,6,0,6
980972,2,11,2,15,1,16
980996,2,11,2,7,1,8
981014,2,11,2,7,0,7
981022,2,11,2,5,0,5
1082596,2,11,2,8,0,8
1082604,2,11,2,5,0,5
1082634,2,11,2,3,0,3
1082638,2,11,2,3,0,3
1082643,2,11,2,13,0,13
980916,1,12,2,11,0,11
980924,1,12,2,6,0,6
980944,1,12,2,4,0,4
980954,1,12,2,7,1,8
980962,1,12,2,1,0,1
980974,1,12,2,13,0,13
980994,1,12,2,6,1,7
1082594,1,12,2,2,0,2
1082603,1,12,2,9,0,9
1082607,1,12,2,8,0,8
1082618,1,12,2,9,0,9
1082620,1,12,2,8,0,8
1082624,1,12,2,5,0,5
1082634,1,12,2,3,0,3
1082647,1,12,2,3,0,3
980906,2,12,2,5,0,5
980936,2,12,2,1,0,1
980948,2,12,2,4,1,5
980970,2,12,2,7,0,7
980984,2,12,2,4,0,4
981002,2,12,2,11,1,12
981010,2,12,2,13,1,14
1082592,2,12,2,14,1,15
1082599,2,12,2,6,1,7
1082615,2,12,2,3,1,4
1082629,2,12,2,2,1,3
1082631,2,12,2,4,0,4
1082642,2,12,2,8,0,8
1082645,2,12,2,6,0,6
1082650,2,12,2,4,4,8
980934,1,13,2,9,0,9
980950,1,13,2,10,0,10
980966,1,13,2,8,1,9
980972,1,13,2,0,0,0
981018,1,13,2,5,0,5
981022,1,13,2,8,1,9
1082593,1,13,2,7,1,8
1082596,1,13,2,10,0,10
1082606,1,13,2,11,1,12
1082625,1,13,2,12,2,14
1082629,1,13,2,1,0,1
1082632,1,13,2,3,0,3
1082640,1,13,2,5,3,8
1082643,1,13,2,9,0,9
980910,2,13,2,11,0,11
980916,2,13,2,5,1,6
980922,2,13,2,3,1,4
980942,2,13,2,12,0,12
980954,2,13,2,3,0,3
980960,2,13,2,3,0,3
980980,2,13,2,9,0,9
980992,2,13,2,2,0,2
981006,2,13,2,3,5,8
981012,2,13,2,6,2,8
1082603,2,13,2,11,0,11
1082610,2,13,2,3,0,3
1082613,2,13,2,16,0,16
1082616,2,13,2,8,0,8
1082621,2,13,2,5,0,5
1082637,2,13,2,10,0,10
335987,1,1,3,5,1,6
335998,1,1,3,8,0,8
336002,1,1,3,7,0,7
336015,1,1,3,9,1,10
336019,1,1,3,11,0,11
336022,1,1,3,6,0,6
336026,1,1,3,3,1,4
336030,1,1,3,4,2,6
336032,1,1,3,4,1,5
392189,1,1,3,0,0,0
392204,1,1,3,5,5,10
392212,1,1,3,2,0,2
392216,1,1,3,21,0,21
392224,1,1,3,5,1,6
392226,1,1,3,2,0,2
392233,1,1,3,5,0,5
419111,1,1,3,4,4,8
419127,1,1,3,12,2,14
419132,1,1,3,0,1,1
419140,1,1,3,9,0,9
419144,1,1,3,8,0,8
419149,1,1,3,10,0,10
419153,1,1,3,8,1,9
419158,1,1,3,6,0,6
501208,1,1,3,2,0,2
501227,1,1,3,1,0,1
501235,1,1,3,2,0,2
501244,1,1,3,6,0,6
501260,1,1,3,5,0,5
501272,1,1,3,5,2,7
501274,1,1,3,5,0,5
548312,1,1,3,5,4,9
548320,1,1,3,8,0,8
548349,1,1,3,9,1,10
548358,1,1,3,6,0,6
548373,1,1,3,8,0,8
548375,1,1,3,1,0,1
548380,1,1,3,2,0,2
548383,1,1,3,5,1,6
598013,1,1,3,7,0,7
598018,1,1,3,6,0,6
598027,1,1,3,6,1,7
598034,1,1,3,10,0,10
598045,1,1,3,1,1,2
598058,1,1,3,11,0,11
598074,1,1,3,2,5,7
729284,1,1,3,5,0,5
729294,1,1,3,3,2,5
729304,1,1,3,5,0,5
734032,1,1,3,7,0,7
734048,1,1,3,7,2,9
829718,1,1,3,9,0,9
829766,1,1,3,9,0,9
829776,1,1,3,5,2,7
829786,1,1,3,10,0,10
980914,1,1,3,11,2,13
980952,1,1,3,17,0,17
980968,1,1,3,9,0,9
980980,1,1,3,2,0,2
981000,1,1,3,4,0,4
981006,1,1,3,7,2,9
981014,1,1,3,6,0,6
1082597,1,1,3,13,2,15
1082604,1,1,3,5,0,5
1082613,1,1,3,15,0,15
1082617,1,1,3,14,0,14
1082631,1,1,3,6,0,6
1082649,1,1,3,7,1,8
335991,2,1,3,1,1,2
336005,2,1,3,8,1,9
336008,2,1,3,7,0,7
336040,2,1,3,9,0,9
392191,2,1,3,7,0,7
392195,2,1,3,2,0,2
392202,2,1,3,7,0,7
392208,2,1,3,8,1,9
392236,2,1,3,15,1,16
392238,2,1,3,3,0,3
419114,2,1,3,7,0,7
419118,2,1,3,5,2,7
419123,2,1,3,7,0,7
419136,2,1,3,4,0,4
419163,2,1,3,4,1,5
419166,2,1,3,4,2,6
501203,2,1,3,6,5,11
501214,2,1,3,11,0,11
501219,2,1,3,2,1,3
501224,2,1,3,8,0,8
501239,2,1,3,9,0,9
501247,2,1,3,13,0,13
501250,2,1,3,7,0,7
501267,2,1,3,14,1,15
548317,2,1,3,1,1,2
548325,2,1,3,5,0,5
548328,2,1,3,9,0,9
548333,2,1,3,0,0,0
548340,2,1,3,7,1,8
548352,2,1,3,0,1,1
548362,2,1,3,6,1,7
548368,2,1,3,8,0,8
548386,2,1,3,5,2,7
598003,2,1,3,15,0,15
598010,2,1,3,4,1,5
598021,2,1,3,10,0,10
598036,2,1,3,2,0,2
598039,2,1,3,8,0,8
598048,2,1,3,10,0,10
598055,2,1,3,10,0,10
598062,2,1,3,5,1,6
598066,2,1,3,2,3,5
729312,2,1,3,2,0,2
729320,2,1,3,5,3,8
733976,2,1,3,4,0,4
733984,2,1,3,10,0,10
733990,2,1,3,12,0,12
734002,2,1,3,12,0,12
734014,2,1,3,8,0,8
734020,2,1,3,4,0,4
734028,2,1,3,13,0,13
734042,2,1,3,13,0,13
734054,2,1,3,10,2,12
829710,2,1,3,8,0,8
829728,2,1,3,8,0,8
829738,2,1,3,5,0,5
829744,2,1,3,10,1,11
829748,2,1,3,8,0,8
829770,2,1,3,12,1,13
829796,2,1,3,10,0,10
829810,2,1,3,8,0,8
829816,2,1,3,6,1,7
980908,2,1,3,9,0,9
980920,2,1,3,6,0,6
980930,2,1,3,13,0,13
980944,2,1,3,10,0,10
980956,2,1,3,8,0,8
980964,2,1,3,11,0,11
980994,2,1,3,21,1,22
981020,2,1,3,8,0,8
1082593,2,1,3,15,2,17
1082601,2,1,3,16,0,16
1082608,2,1,3,1,1,2
1082620,2,1,3,2,1,3
1082622,2,1,3,8,0,8
1082627,2,1,3,4,0,4
1082636,2,1,3,14,0,14
1082639,2,1,3,6,0,6
1082644,2,1,3,17,2,19
1082648,2,1,3,4,2,6
335997,1,2,3,1,0,1
336011,1,2,3,3,1,4
336017,1,2,3,7,0,7
336021,1,2,3,10,0,10
336031,1,2,3,2,0,2
336034,1,2,3,4,0,4
336039,1,2,3,9,0,9
392187,1,2,3,3,0,3
392196,1,2,3,18,0,18
392199,1,2,3,3,0,3
392209,1,2,3,7,0,7
392218,1,2,3,2,1,3
392241,1,2,3,8,0,8
419114,1,2,3,4,0,4
419128,1,2,3,9,0,9
419138,1,2,3,5,1,6
419150,1,2,3,1,0,1
501210,1,2,3,10,0,10
501237,1,2,3,20,0,20
501249,1,2,3,5,0,5
501273,1,2,3,12,0,12
501275,1,2,3,10,0,10
548315,1,2,3,19,0,19
548323,1,2,3,11,0,11
548341,1,2,3,8,0,8
548355,1,2,3,2,0,2
548367,1,2,3,14,0,14
548372,1,2,3,4,0,4
548377,1,2,3,8,0,8
598004,1,2,3,6,1,7
598009,1,2,3,5,1,6
598017,1,2,3,5,0,5
598032,1,2,3,4,0,4
598041,1,2,3,16,1,17
598047,1,2,3,5,1,6
598050,1,2,3,3,0,3
598059,1,2,3,9,1,10
598062,1,2,3,6,0,6
598069,1,2,3,6,1,7
598073,1,2,3,15,1,16
729310,1,2,3,6,0,6
729318,1,2,3,1,0,1
734004,1,2,3,1,0,1
734010,1,2,3,13,0,13
734026,1,2,3,7,0,7
734040,1,2,3,10,0,10
829724,1,2,3,1,2,3
829768,1,2,3,5,1,6
829790,1,2,3,23,1,24
829800,1,2,3,6,0,6
829824,1,2,3,10,4,14
829826,1,2,3,10,0,10
980912,1,2,3,4,0,4
980926,1,2,3,6,0,6
980932,1,2,3,9,0,9
980936,1,2,3,11,0,11
980942,1,2,3,10,0,10
980964,1,2,3,3,1,4
980982,1,2,3,10,1,11
980986,1,2,3,1,0,1
980992,1,2,3,7,0,7
981004,1,2,3,6,0,6
1082595,1,2,3,6,1,7
1082598,1,2,3,11,0,11
1082602,1,2,3,17,0,17
1082610,1,2,3,12,0,12
1082621,1,2,3,5,2,7
1082628,1,2,3,5,0,5
1082636,1,2,3,8,0,8
1082646,1,2,3,2,0,2
335987,2,2,3,2,1,3
335990,2,2,3,11,0,11
336001,2,2,3,1,0,1
336003,2,2,3,10,0,10
336007,2,2,3,8,0,8
336015,2,2,3,7,1,8
336028,2,2,3,0,2,2
392190,2,2,3,9,2,11
392193,2,2,3,2,0,2
392204,2,2,3,7,0,7
392213,2,2,3,2,1,3
392223,2,2,3,6,1,7
392226,2,2,3,9,1,10
392229,2,2,3,1,0,1
392237,2,2,3,4,0,4
392243,2,2,3,7,0,7
392244,2,2,3,9,2,11
419117,2,2,3,10,0,10
419120,2,2,3,3,0,3
419124,2,2,3,9,1,10
419133,2,2,3,7,2,9
419141,2,2,3,9,0,9
419145,2,2,3,7,0,7
419153,2,2,3,4,0,4
419156,2,2,3,4,0,4
419159,2,2,3,9,0,9
419162,2,2,3,7,0,7
419167,2,2,3,5,0,5
419169,2,2,3,1,0,1
501205,2,2,3,9,2,11
501213,2,2,3,7,1,8
501216,2,2,3,7,0,7
501227,2,2,3,4,0,4
501232,2,2,3,1,6,7
501252,2,2,3,36,1,37
501257,2,2,3,11,1,12
501260,2,2,3,7,0,7
501265,2,2,3,1,0,1
501271,2,2,3,5,0,5
501276,2,2,3,3,0,3
548320,2,2,3,1,0,1
548329,2,2,3,17,0,17
548332,2,2,3,9,4,13
548336,2,2,3,8,1,9
548349,2,2,3,13,0,13
548361,2,2,3,8,0,8
548365,2,2,3,1,0,1
548381,2,2,3,3,0,3
598013,2,2,3,7,1,8
598022,2,2,3,10,0,10
598028,2,2,3,6,2,8
598038,2,2,3,8,4,12
598053,2,2,3,6,0,6
729286,2,2,3,7,0,7
729292,2,2,3,5,0,5
729304,2,2,3,10,0,10
733982,2,2,3,8,0,8
733988,2,2,3,25,3,28
733996,2,2,3,1,0,1
734018,2,2,3,4,0,4
734032,2,2,3,2,0,2
829718,2,2,3,13,0,13
829742,2,2,3,8,0,8
829750,2,2,3,19,0,19
829754,2,2,3,15,0,15
829762,2,2,3,6,0,6
829776,2,2,3,14,0,14
829784,2,2,3,8,0,8
829808,2,2,3,16,1,17
829812,2,2,3,2,1,3
980958,2,2,3,7,0,7
980974,2,2,3,3,0,3
981000,2,2,3,17,0,17
981016,2,2,3,3,0,3
981018,2,2,3,7,1,8
981024,2,2,3,6,2,8
1082591,2,2,3,16,0,16
1082607,2,2,3,7,0,7
1082617,2,2,3,13,2,15
1082624,2,2,3,14,0,14
1082633,2,2,3,1,0,1
335988,1,3,3,6,1,7
335994,1,3,3,14,4,18
336001,1,3,3,5,2,7
336006,1,3,3,2,0,2
336010,1,3,3,1,1,2
336012,1,3,3,4,0,4
336018,1,3,3,1,1,2
336023,1,3,3,5,0,5
336045,1,3,3,4,0,4
392190,1,3,3,13,0,13
392201,1,3,3,10,0,10
392207,1,3,3,12,0,12
392211,1,3,3,3,0,3
392214,1,3,3,6,0,6
392219,1,3,3,16,0,16
392229,1,3,3,12,0,12
392236,1,3,3,10,0,10
392239,1,3,3,7,0,7
392243,1,3,3,11,0,11
419118,1,3,3,6,0,6
419130,1,3,3,7,2,9
419142,1,3,3,8,0,8
419147,1,3,3,6,6,12
419152,1,3,3,4,0,4
419160,1,3,3,5,0,5
419168,1,3,3,13,0,13
419170,1,3,3,7,0,7
501203,1,3,3,7,0,7
501211,1,3,3,2,2,4
501216,1,3,3,7,0,7
501220,1,3,3,1,1,2
501231,1,3,3,10,0,10
501241,1,3,3,7,0,7
501250,1,3,3,2,0,2
501254,1,3,3,10,0,10
501258,1,3,3,8,0,8
501266,1,3,3,14,0,14
501271,1,3,3,4,1,5
501276,1,3,3,10,0,10
548311,1,3,3,5,1,6
548316,1,3,3,6,0,6
548321,1,3,3,13,1,14
548327,1,3,3,5,0,5
548335,1,3,3,1,0,1
548352,1,3,3,9,1,10
548357,1,3,3,5,1,6
548360,1,3,3,3,0,3
548376,1,3,3,6,0,6
548384,1,3,3,0,0,0
548385,1,3,3,6,0,6
548386,1,3,3,10,1,11
598025,1,3,3,3,1,4
598039,1,3,3,14,0,14
598043,1,3,3,1,0,1
598046,1,3,3,12,0,12
598056,1,3,3,2,0,2
598063,1,3,3,9,0,9
598067,1,3,3,2,0,2
598075,1,3,3,9,0,9
729288,1,3,3,13,1,14
729298,1,3,3,9,0,9
729302,1,3,3,10,0,10
733976,1,3,3,6,0,6
734018,1,3,3,13,0,13
734028,1,3,3,5,1,6
734034,1,3,3,8,0,8
829712,1,3,3,6,4,10
829716,1,3,3,6,7,13
829728,1,3,3,16,0,16
829740,1,3,3,6,0,6
829750,1,3,3,1,0,1
829758,1,3,3,22,0,22
829770,1,3,3,11,1,12
829784,1,3,3,11,0,11
829794,1,3,3,15,0,15
829802,1,3,3,4,0,4
829806,1,3,3,5,0,5
335998,2,3,3,5,5,10
336014,2,3,3,3,1,4
336030,2,3,3,9,0,9
336034,2,3,3,14,6,20
336038,2,3,3,19,0,19
336042,2,3,3,4,0,4
336044,2,3,3,1,1,2
392186,2,3,3,2,0,2
392194,2,3,3,9,0,9
392207,2,3,3,1,0,1
392222,2,3,3,8,1,9
392232,2,3,3,0,1,1
419115,2,3,3,10,0,10
419121,2,3,3,2,0,2
419126,2,3,3,6,0,6
419128,2,3,3,7,1,8
419134,2,3,3,3,0,3
419138,2,3,3,24,0,24
419158,2,3,3,7,5,12
419164,2,3,3,5,0,5
501226,2,3,3,10,2,12
501233,2,3,3,8,1,9
501245,2,3,3,8,0,8
501273,2,3,3,0,1,1
548323,2,3,3,7,0,7
548337,2,3,3,9,0,9
548348,2,3,3,12,0,12
548366,2,3,3,1,4,5
548369,2,3,3,5,0,5
548373,2,3,3,14,0,14
598007,2,3,3,4,0,4
598012,2,3,3,5,0,5
598017,2,3,3,2,0,2
598020,2,3,3,2,1,3
598027,2,3,3,4,1,5
598031,2,3,3,9,0,9
598035,2,3,3,9,1,10
598051,2,3,3,1,0,1
598073,2,3,3,7,1,8
598078,2,3,3,5,2,7
729308,2,3,3,13,0,13
729316,2,3,3,7,1,8
733986,2,3,3,8,0,8
733992,2,3,3,5,0,5
734000,2,3,3,2,0,2
734008,2,3,3,8,0,8
734040,2,3,3,15,0,15
734050,2,3,3,4,0,4
734052,2,3,3,8,1,9
829734,2,3,3,11,0,11
829778,2,3,3,8,0,8
829814,2,3,3,7,0,7
829822,2,3,3,4,0,4
829826,2,3,3,11,0,11
829828,2,3,3,2,1,3
335992,1,4,3,10,0,10
335996,1,4,3,7,0,7
336008,1,4,3,7,0,7
336024,1,4,3,11,1,12
336033,1,4,3,1,0,1
336040,1,4,3,3,0,3
336044,1,4,3,4,1,5
392188,1,4,3,9,1,10
392191,1,4,3,6,0,6
392200,1,4,3,5,0,5
392205,1,4,3,4,0,4
392227,1,4,3,10,2,12
392234,1,4,3,2,1,3
419113,1,4,3,2,1,3
419117,1,4,3,6,2,8
419126,1,4,3,5,0,5
419137,1,4,3,11,0,11
419141,1,4,3,9,0,9
419148,1,4,3,5,0,5
419161,1,4,3,5,3,8
419164,1,4,3,12,1,13
501207,1,4,3,4,0,4
501225,1,4,3,24,1,25
501239,1,4,3,11,1,12
501253,1,4,3,4,0,4
501256,1,4,3,10,0,10
501262,1,4,3,6,0,6
501265,1,4,3,3,0,3
548328,1,4,3,1,2,3
548333,1,4,3,9,0,9
548336,1,4,3,5,0,5
548344,1,4,3,14,0,14
548348,1,4,3,4,1,5
548364,1,4,3,7,0,7
548374,1,4,3,4,1,5
548379,1,4,3,10,0,10
598012,1,4,3,4,0,4
598019,1,4,3,2,0,2
598021,1,4,3,14,0,14
598026,1,4,3,9,1,10
598033,1,4,3,7,0,7
598036,1,4,3,9,1,10
598057,1,4,3,5,0,5
598071,1,4,3,9,0,9
729300,1,4,3,16,0,16
729312,1,4,3,6,0,6
733978,1,4,3,7,0,7
733992,1,4,3,1,0,1
733996,1,4,3,6,4,10
734002,1,4,3,8,1,9
734030,1,4,3,1,0,1
734038,1,4,3,6,0,6
734052,1,4,3,7,1,8
734054,1,4,3,6,0,6
829722,1,4,3,17,0,17
829730,1,4,3,4,1,5
829738,1,4,3,12,0,12
829772,1,4,3,1,0,1
829796,1,4,3,18,0,18
829808,1,4,3,4,0,4
829814,1,4,3,10,0,10
980910,1,4,3,7,0,7
980918,1,4,3,0,0,0
980930,1,4,3,5,1,6
980940,1,4,3,5,0,5
980960,1,4,3,13,0,13
980976,1,4,3,13,0,13
980996,1,4,3,3,0,3
981010,1,4,3,6,1,7
1082601,1,4,3,9,0,9
1082612,1,4,3,10,1,11
1082616,1,4,3,6,0,6
1082633,1,4,3,4,0,4
1082637,1,4,3,10,0,10
1082639,1,4,3,6,2,8
1082641,1,4,3,3,0,3
1082645,1,4,3,8,0,8
335988,2,4,3,11,0,11
336000,2,4,3,9,1,10
336004,2,4,3,11,0,11
336011,2,4,3,8,1,9
336018,2,4,3,5,0,5
336021,2,4,3,4,0,4
336027,2,4,3,15,0,15
336036,2,4,3,12,0,12
392196,2,4,3,4,1,5
392209,2,4,3,5,1,6
392212,2,4,3,7,0,7
392215,2,4,3,5,2,7
392219,2,4,3,12,0,12
392221,2,4,3,9,0,9
392231,2,4,3,2,0,2
392239,2,4,3,6,0,6
419122,2,4,3,1,0,1
419129,2,4,3,15,0,15
419132,2,4,3,3,0,3
419144,2,4,3,10,2,12
419151,2,4,3,12,0,12
419154,2,4,3,1,1,2
501211,2,4,3,9,1,10
501217,2,4,3,9,1,10
501228,2,4,3,6,1,7
501242,2,4,3,3,0,3
501249,2,4,3,14,1,15
501259,2,4,3,12,0,12
501269,2,4,3,8,0,8
548314,2,4,3,3,0,3
548318,2,4,3,2,0,2
548324,2,4,3,1,0,1
548339,2,4,3,10,0,10
548355,2,4,3,10,0,10
548359,2,4,3,3,2,5
548371,2,4,3,4,0,4
548376,2,4,3,4,1,5
598008,2,4,3,2,0,2
598030,2,4,3,11,0,11
598042,2,4,3,3,2,5
598046,2,4,3,3,0,3
598050,2,4,3,5,0,5
598061,2,4,3,10,0,10
598064,2,4,3,17,2,19
598069,2,4,3,1,0,1
729288,2,4,3,17,0,17
729296,2,4,3,5,1,6
729318,2,4,3,2,0,2
734012,2,4,3,15,0,15
734024,2,4,3,14,2,16
734044,2,4,3,2,2,4
734048,2,4,3,9,0,9
829714,2,4,3,11,0,11
829746,2,4,3,9,0,9
829758,2,4,3,13,0,13
829764,2,4,3,2,2,4
829780,2,4,3,12,0,12
829790,2,4,3,1,0,1
829804,2,4,3,9,0,9
980924,2,4,3,10,0,10
980946,2,4,3,11,0,11
980968,2,4,3,1,5,6
980982,2,4,3,12,1,13
980990,2,4,3,5,0,5
981004,2,4,3,12,0,12
1082594,2,4,3,8,0,8
1082598,2,4,3,11,1,12
1082605,2,4,3,11,0,11
1082609,2,4,3,1,1,2
1082623,2,4,3,2,1,3
1082626,2,4,3,2,0,2
335989,1,5,3,0,0,0
336005,1,5,3,9,1,10
336013,1,5,3,9,0,9
336028,1,5,3,12,0,12
336038,1,5,3,10,0,10
336043,1,5,3,7,0,7
392195,1,5,3,16,0,16
392215,1,5,3,4,1,5
392222,1,5,3,5,0,5
392230,1,5,3,6,0,6
392238,1,5,3,1,1,2
419116,1,5,3,10,0,10
419120,1,5,3,2,1,3
419123,1,5,3,13,0,13
419129,1,5,3,13,0,13
419134,1,5,3,6,1,7
419146,1,5,3,1,5,6
419159,1,5,3,8,0,8
419163,1,5,3,6,0,6
501214,1,5,3,9,1,10
501219,1,5,3,6,1,7
501245,1,5,3,1,0,1
501257,1,5,3,9,0,9
501263,1,5,3,10,0,10
548314,1,5,3,16,0,16
548317,1,5,3,11,0,11
548325,1,5,3,5,0,5
548329,1,5,3,0,0,0
548337,1,5,3,6,0,6
548354,1,5,3,17,1,18
548359,1,5,3,7,0,7
548366,1,5,3,9,0,9
548370,1,5,3,6,0,6
548378,1,5,3,5,0,5
548382,1,5,3,8,1,9
598006,1,5,3,11,0,11
598010,1,5,3,6,1,7
598014,1,5,3,5,1,6
598024,1,5,3,11,0,11
598028,1,5,3,0,0,0
598031,1,5,3,14,0,14
598048,1,5,3,10,2,12
598077,1,5,3,9,0,9
729296,1,5,3,9,0,9
729320,1,5,3,2,0,2
733984,1,5,3,7,0,7
734008,1,5,3,3,5,8
734016,1,5,3,1,0,1
734046,1,5,3,9,1,10
829714,1,5,3,6,1,7
829746,1,5,3,7,1,8
829754,1,5,3,8,0,8
829782,1,5,3,2,2,4
829816,1,5,3,8,0,8
335992,2,5,3,14,1,15
335995,2,5,3,5,0,5
335997,2,5,3,7,0,7
336010,2,5,3,7,1,8
336016,2,5,3,8,1,9
336020,2,5,3,3,1,4
336024,2,5,3,2,0,2
336032,2,5,3,3,0,3
336041,2,5,3,11,0,11
336045,2,5,3,0,5,5
392187,2,5,3,0,1,1
392200,2,5,3,6,0,6
392203,2,5,3,8,0,8
392207,2,5,3,0,4,4
392210,2,5,3,2,0,2
392218,2,5,3,8,0,8
392225,2,5,3,5,1,6
392235,2,5,3,2,0,2
419112,2,5,3,14,0,14
419131,2,5,3,5,0,5
419139,2,5,3,10,0,10
419142,2,5,3,6,2,8
419148,2,5,3,14,3,17
419155,2,5,3,2,0,2
501204,2,5,3,1,1,2
501209,2,5,3,9,4,13
501225,2,5,3,6,0,6
501230,2,5,3,3,1,4
501236,2,5,3,5,0,5
501240,2,5,3,8,0,8
501254,2,5,3,7,0,7
501268,2,5,3,4,0,4
548322,2,5,3,3,0,3
548331,2,5,3,8,0,8
548341,2,5,3,7,0,7
548350,2,5,3,8,0,8
548363,2,5,3,16,0,16
598019,2,5,3,4,0,4
598037,2,5,3,0,0,0
598041,2,5,3,0,0,0
598052,2,5,3,8,0,8
598054,2,5,3,10,1,11
598057,2,5,3,6,0,6
598063,2,5,3,11,0,11
598068,2,5,3,7,0,7
598070,2,5,3,1,1,2
598076,2,5,3,2,0,2
729290,2,5,3,3,0,3
729302,2,5,3,3,0,3
729310,2,5,3,11,0,11
733980,2,5,3,5,2,7
733994,2,5,3,5,0,5
734004,2,5,3,14,0,14
734022,2,5,3,10,0,10
734038,2,5,3,7,0,7
829720,2,5,3,13,0,13
829726,2,5,3,3,0,3
829732,2,5,3,3,0,3
829740,2,5,3,11,0,11
829774,2,5,3,10,2,12
829792,2,5,3,9,0,9
829802,2,5,3,6,0,6
829824,2,5,3,7,0,7
336000,1,6,3,5,1,6
336003,1,6,3,9,1,10
336014,1,6,3,11,0,11
336020,1,6,3,8,0,8
336025,1,6,3,2,0,2
336027,1,6,3,10,0,10
392194,1,6,3,6,0,6
392203,1,6,3,10,0,10
392228,1,6,3,1,0,1
392231,1,6,3,4,2,6
392235,1,6,3,3,0,3
392237,1,6,3,12,0,12
392242,1,6,3,10,0,10
419121,1,6,3,9,0,9
419133,1,6,3,10,0,10
419136,1,6,3,15,2,17
419139,1,6,3,8,1,9
419145,1,6,3,14,0,14
419154,1,6,3,5,5,10
501206,1,6,3,6,0,6
501209,1,6,3,9,0,9
501228,1,6,3,10,2,12
501232,1,6,3,7,1,8
501238,1,6,3,7,0,7
501243,1,6,3,6,0,6
501270,1,6,3,13,0,13
548347,1,6,3,15,0,15
548350,1,6,3,6,0,6
548362,1,6,3,15,2,17
548369,1,6,3,6,0,6
598003,1,6,3,9,0,9
598015,1,6,3,2,2,4
598022,1,6,3,5,0,5
598040,1,6,3,4,5,9
598049,1,6,3,8,0,8
598054,1,6,3,1,0,1
598064,1,6,3,12,0,12
729286,1,6,3,8,0,8
733980,1,6,3,6,0,6
733986,1,6,3,8,1,9
733990,1,6,3,4,0,4
733998,1,6,3,4,0,4
734024,1,6,3,6,2,8
734044,1,6,3,9,0,9
829720,1,6,3,13,0,13
829736,1,6,3,4,1,5
829744,1,6,3,7,0,7
829752,1,6,3,10,0,10
829762,1,6,3,6,1,7
829788,1,6,3,8,0,8
829818,1,6,3,10,0,10
980908,1,6,3,2,0,2
980938,1,6,3,2,3,5
980956,1,6,3,10,0,10
980970,1,6,3,5,1,6
981002,1,6,3,0,0,0
981016,1,6,3,7,1,8
1082599,1,6,3,15,1,16
1082605,1,6,3,5,0,5
1082608,1,6,3,17,0,17
1082622,1,6,3,14,0,14
1082626,1,6,3,5,0,5
1082642,1,6,3,2,0,2
335989,2,6,3,5,0,5
335993,2,6,3,12,0,12
336006,2,6,3,5,1,6
336009,2,6,3,2,0,2
336022,2,6,3,2,0,2
336031,2,6,3,8,0,8
336037,2,6,3,6,0,6
336043,2,6,3,8,1,9
392188,2,6,3,11,2,13
392199,2,6,3,7,0,7
392206,2,6,3,11,1,12
392211,2,6,3,9,0,9
392216,2,6,3,17,0,17
392220,2,6,3,9,0,9
392224,2,6,3,5,0,5
392240,2,6,3,11,0,11
419113,2,6,3,8,4,12
419116,2,6,3,16,0,16
419119,2,6,3,3,1,4
419125,2,6,3,3,0,3
419149,2,6,3,5,1,6
419157,2,6,3,16,1,17
419160,2,6,3,5,0,5
419165,2,6,3,7,0,7
501218,2,6,3,12,0,12
501221,2,6,3,9,0,9
501235,2,6,3,2,0,2
501248,2,6,3,2,1,3
501251,2,6,3,2,1,3
501258,2,6,3,17,0,17
501262,2,6,3,0,0,0
548312,2,6,3,10,0,10
548315,2,6,3,5,1,6
548321,2,6,3,12,0,12
548326,2,6,3,7,0,7
548330,2,6,3,0,4,4
548334,2,6,3,6,0,6
548338,2,6,3,2,0,2
548342,2,6,3,7,0,7
548354,2,6,3,14,0,14
548374,2,6,3,7,0,7
548377,2,6,3,6,0,6
548379,2,6,3,7,0,7
548383,2,6,3,1,0,1
548385,2,6,3,2,2,4
598006,2,6,3,12,0,12
598011,2,6,3,6,1,7
598025,2,6,3,8,1,9
598029,2,6,3,7,0,7
598033,2,6,3,7,0,7
598045,2,6,3,7,0,7
598059,2,6,3,9,0,9
598067,2,6,3,5,0,5
598072,2,6,3,11,5,16
729294,2,6,3,13,0,13
729298,2,6,3,3,0,3
729306,2,6,3,8,0,8
729314,2,6,3,2,0,2
734010,2,6,3,7,1,8
734016,2,6,3,6,0,6
734036,2,6,3,2,0,2
829712,2,6,3,7,0,7
829730,2,6,3,6,3,9
829766,2,6,3,2,2,4
829772,2,6,3,1,1,2
829782,2,6,3,16,1,17
829798,2,6,3,2,0,2
829806,2,6,3,2,0,2
980918,2,6,3,0,0,0
980926,2,6,3,9,0,9
980950,2,6,3,4,1,5
980966,2,6,3,6,1,7
980976,2,6,3,6,0,6
980988,2,6,3,7,0,7
980998,2,6,3,8,0,8
981008,2,6,3,4,0,4
1082595,2,6,3,8,0,8
1082611,2,6,3,9,0,9
1082614,2,6,3,5,0,5
1082630,2,6,3,12,0,12
1082632,2,6,3,9,1,10
1082635,2,6,3,14,0,14
1082640,2,6,3,7,0,7
1082646,2,6,3,4,0,4
335990,1,7,3,5,1,6
335999,1,7,3,0,1,1
336009,1,7,3,3,0,3
336029,1,7,3,9,0,9
336037,1,7,3,9,0,9
336041,1,7,3,9,0,9
392186,1,7,3,10,0,10
392202,1,7,3,4,6,10
392208,1,7,3,1,2,3
392213,1,7,3,9,0,9
392220,1,7,3,2,0,2
392223,1,7,3,12,2,14
392232,1,7,3,1,0,1
392240,1,7,3,8,2,10
419112,1,7,3,10,0,10
419119,1,7,3,7,0,7
419124,1,7,3,1,6,7
419135,1,7,3,5,0,5
419143,1,7,3,9,1,10
419151,1,7,3,8,0,8
419155,1,7,3,10,2,12
419157,1,7,3,2,4,6
419162,1,7,3,2,1,3
419166,1,7,3,7,0,7
419167,1,7,3,7,5,12
501215,1,7,3,2,0,2
501226,1,7,3,1,0,1
501229,1,7,3,10,0,10
501236,1,7,3,11,0,11
501242,1,7,3,1,0,1
501246,1,7,3,5,0,5
501251,1,7,3,20,0,20
501268,1,7,3,7,0,7
548322,1,7,3,20,1,21
548330,1,7,3,2,0,2
548339,1,7,3,7,1,8
548356,1,7,3,6,1,7
548365,1,7,3,1,0,1
548368,1,7,3,5,0,5
598007,1,7,3,5,1,6
598011,1,7,3,8,0,8
598016,1,7,3,16,1,17
598029,1,7,3,1,0,1
598038,1,7,3,16,0,16
598042,1,7,3,2,1,3
598044,1,7,3,8,1,9
598051,1,7,3,5,1,6
598055,1,7,3,2,0,2
598068,1,7,3,15,0,15
598078,1,7,3,5,0,5
729292,1,7,3,7,0,7
729308,1,7,3,9,0,9
729314,1,7,3,2,0,2
733988,1,7,3,4,2,6
734000,1,7,3,8,0,8
734014,1,7,3,8,3,11
734022,1,7,3,6,0,6
734036,1,7,3,11,0,11
734050,1,7,3,4,0,4
829710,1,7,3,12,0,12
829726,1,7,3,5,0,5
829734,1,7,3,6,0,6
829742,1,7,3,10,0,10
829756,1,7,3,4,0,4
829774,1,7,3,8,0,8
829780,1,7,3,6,0,6
829810,1,7,3,6,0,6
829822,1,7,3,4,0,4
829828,1,7,3,11,0,11
980906,1,7,3,8,0,8
980922,1,7,3,9,1,10
980928,1,7,3,2,0,2
980946,1,7,3,2,0,2
980990,1,7,3,1,0,1
980998,1,7,3,3,0,3
981012,1,7,3,6,0,6
1082592,1,7,3,9,0,9
1082614,1,7,3,7,2,9
1082635,1,7,3,7,1,8
1082638,1,7,3,15,1,16
1082644,1,7,3,6,0,6
1082650,1,7,3,2,0,2
335994,2,7,3,12,0,12
335996,2,7,3,4,0,4
336002,2,7,3,0,1,1
336013,2,7,3,2,0,2
336017,2,7,3,7,0,7
336023,2,7,3,2,2,4
336026,2,7,3,23,0,23
336033,2,7,3,1,1,2
392197,2,7,3,6,2,8
392202,2,7,3,1,1,2
392205,2,7,3,3,0,3
392217,2,7,3,4,0,4
392227,2,7,3,3,1,4
392230,2,7,3,4,0,4
419119,2,7,3,4,0,4
419127,2,7,3,5,2,7
419130,2,7,3,5,2,7
419137,2,7,3,8,0,8
419147,2,7,3,7,0,7
419170,2,7,3,5,1,6
501206,2,7,3,6,1,7
501210,2,7,3,14,1,15
501223,2,7,3,1,0,1
501256,2,7,3,0,0,0
501261,2,7,3,2,0,2
501272,2,7,3,9,1,10
501274,2,7,3,2,1,3
501275,2,7,3,2,0,2
548311,2,7,3,11,1,12
548313,2,7,3,2,0,2
548319,2,7,3,2,0,2
548344,2,7,3,7,0,7
548347,2,7,3,1,0,1
548351,2,7,3,2,0,2
548360,2,7,3,6,0,6
548372,2,7,3,8,0,8
548375,2,7,3,1,0,1
548382,2,7,3,6,3,9
548384,2,7,3,6,1,7
598004,2,7,3,6,1,7
598024,2,7,3,4,0,4
598034,2,7,3,3,4,7
598060,2,7,3,9,0,9
598065,2,7,3,10,0,10
598071,2,7,3,5,0,5
598075,2,7,3,5,0,5
598077,2,7,3,3,0,3
729284,2,7,3,7,0,7
729322,2,7,3,4,0,4
733978,2,7,3,5,1,6
734006,2,7,3,6,0,6
734030,2,7,3,9,0,9
734046,2,7,3,15,0,15
829722,2,7,3,3,0,3
829752,2,7,3,8,2,10
829788,2,7,3,6,0,6
829794,2,7,3,13,0,13
829800,2,7,3,14,0,14
829820,2,7,3,13,0,13
980914,2,7,3,9,0,9
980932,2,7,3,6,0,6
980938,2,7,3,19,0,19
980952,2,7,3,10,0,10
980962,2,7,3,16,0,16
980978,2,7,3,11,0,11
980986,2,7,3,10,2,12
1082597,2,7,3,9,1,10
1082600,2,7,3,7,0,7
1082602,2,7,3,0,1,1
1082606,2,7,3,5,6,11
1082612,2,7,3,13,0,13
1082618,2,7,3,13,0,13
1082625,2,7,3,16,0,16
1082628,2,7,3,16,1,17
1082641,2,7,3,6,0,6
1082647,2,7,3,10,0,10
1082649,2,7,3,10,0,10
335991,1,8,3,7,0,7
335993,1,8,3,6,0,6
335995,1,8,3,10,0,10
336004,1,8,3,10,0,10
336007,1,8,3,2,0,2
336016,1,8,3,12,0,12
336036,1,8,3,12,0,12
336042,1,8,3,6,0,6
392193,1,8,3,6,2,8
392197,1,8,3,6,1,7
392206,1,8,3,3,0,3
392210,1,8,3,9,0,9
392217,1,8,3,4,1,5
392221,1,8,3,8,1,9
392225,1,8,3,8,0,8
392244,1,8,3,2,0,2
419115,1,8,3,14,0,14
419122,1,8,3,15,0,15
419125,1,8,3,6,0,6
419131,1,8,3,4,1,5
419156,1,8,3,5,1,6
419165,1,8,3,3,0,3
419169,1,8,3,5,1,6
501204,1,8,3,7,0,7
501213,1,8,3,6,0,6
501217,1,8,3,5,0,5
501221,1,8,3,6,0,6
501234,1,8,3,6,0,6
501248,1,8,3,5,0,5
501255,1,8,3,8,0,8
501261,1,8,3,3,0,3
501269,1,8,3,9,0,9
548319,1,8,3,2,0,2
548326,1,8,3,3,0,3
548331,1,8,3,10,0,10
548334,1,8,3,3,0,3
548340,1,8,3,13,0,13
548346,1,8,3,9,0,9
548351,1,8,3,7,1,8
548353,1,8,3,10,0,10
548361,1,8,3,2,0,2
548371,1,8,3,7,0,7
548381,1,8,3,6,0,6
335999,2,8,3,9,0,9
336012,2,8,3,11,0,11
336019,2,8,3,5,1,6
336025,2,8,3,6,0,6
336029,2,8,3,6,0,6
336039,2,8,3,6,0,6
392189,2,8,3,10,0,10
392201,2,8,3,16,1,17
392214,2,8,3,6,0,6
392228,2,8,3,2,1,3
392233,2,8,3,8,1,9
392234,2,8,3,7,0,7
392241,2,8,3,3,1,4
392242,2,8,3,16,1,17
419111,2,8,3,15,0,15
419135,2,8,3,6,0,6
419140,2,8,3,9,0,9
419143,2,8,3,7,0,7
419146,2,8,3,7,0,7
419150,2,8,3,4,0,4
419152,2,8,3,5,2,7
419161,2,8,3,5,1,6
419168,2,8,3,8,0,8
501208,2,8,3,6,0,6
501229,2,8,3,10,0,10
501241,2,8,3,19,1,20
501244,2,8,3,11,0,11
501264,2,8,3,6,0,6
548316,2,8,3,5,0,5
548357,2,8,3,8,0,8
548364,2,8,3,6,0,6
548378,2,8,3,6,3,9
501205,1,9,3,3,1,4
501212,1,9,3,3,0,3
501224,1,9,3,15,0,15
501230,1,9,3,10,1,11
501247,1,9,3,10,0,10
501252,1,9,3,9,0,9
501259,1,9,3,9,0,9
501215,2,9,3,17,0,17
501220,2,9,3,10,0,10
501234,2,9,3,4,0,4
501238,2,9,3,3,5,8
501243,2,9,3,4,0,4
501263,2,9,3,6,1,7
501266,2,9,3,4,0,4
501218,1,10,3,2,0,2
501223,1,10,3,6,0,6
501233,1,10,3,13,1,14
501240,1,10,3,8,0,8
501264,1,10,3,7,0,7
501267,1,10,3,7,0,7
548313,1,10,3,2,5,7
548318,1,10,3,5,1,6
548324,1,10,3,9,1,10
548332,1,10,3,12,0,12
548338,1,10,3,10,1,11
548342,1,10,3,5,0,5
548363,1,10,3,8,0,8
598008,1,10,3,11,0,11
598020,1,10,3,2,2,4
598030,1,10,3,8,0,8
598052,1,10,3,14,0,14
598060,1,10,3,2,0,2
598066,1,10,3,14,0,14
598072,1,10,3,9,0,9
501207,2,10,3,11,0,11
501212,2,10,3,7,0,7
501231,2,10,3,7,0,7
501237,2,10,3,14,0,14
501246,2,10,3,6,0,6
501253,2,10,3,10,1,11
501255,2,10,3,6,0,6
548327,2,10,3,15,0,15
548335,2,10,3,5,2,7
548346,2,10,3,8,0,8
548353,2,10,3,10,0,10
548356,2,10,3,6,0,6
548358,2,10,3,3,1,4
548367,2,10,3,4,0,4
548370,2,10,3,5,0,5
548380,2,10,3,2,0,2
598005,2,10,3,2,0,2
598014,2,10,3,17,0,17
598016,2,10,3,9,0,9
598023,2,10,3,9,0,9
598032,2,10,3,8,0,8
598040,2,10,3,8,0,8
598043,2,10,3,5,0,5
598047,2,10,3,8,0,8
598058,2,10,3,3,0,3
598005,1,11,3,8,0,8
598023,1,11,3,10,0,10
598035,1,11,3,1,0,1
598037,1,11,3,7,0,7
598053,1,11,3,5,0,5
598061,1,11,3,7,1,8
598065,1,11,3,4,1,5
598070,1,11,3,1,0,1
598076,1,11,3,3,0,3
729290,1,11,3,8,5,13
729306,1,11,3,7,0,7
729316,1,11,3,1,0,1
729322,1,11,3,5,1,6
733982,1,11,3,5,0,5
733994,1,11,3,9,0,9
734006,1,11,3,10,3,13
734012,1,11,3,7,1,8
734020,1,11,3,6,1,7
734042,1,11,3,5,5,10
829732,1,11,3,5,1,6
829748,1,11,3,9,0,9
829764,1,11,3,5,0,5
829778,1,11,3,21,1,22
829792,1,11,3,10,0,10
829798,1,11,3,10,0,10
829804,1,11,3,9,0,9
829812,1,11,3,10,2,12
829820,1,11,3,1,1,2
980920,1,11,3,4,1,5
980948,1,11,3,6,0,6
980958,1,11,3,6,1,7
980978,1,11,3,9,0,9
980984,1,11,3,7,0,7
980988,1,11,3,2,0,2
981008,1,11,3,7,0,7
981020,1,11,3,3,0,3
981024,1,11,3,9,0,9
1082591,1,11,3,6,0,6
1082600,1,11,3,8,0,8
1082609,1,11,3,8,1,9
1082611,1,11,3,6,0,6
1082615,1,11,3,8,0,8
1082623,1,11,3,9,0,9
1082627,1,11,3,17,0,17
1082630,1,11,3,10,0,10
1082648,1,11,3,7,0,7
598009,2,11,3,6,1,7
598015,2,11,3,5,0,5
598018,2,11,3,13,0,13
598026,2,11,3,3,0,3
598044,2,11,3,3,0,3
598049,2,11,3,6,0,6
598056,2,11,3,12,1,13
598074,2,11,3,3,1,4
729300,2,11,3,6,0,6
733998,2,11,3,5,2,7
734026,2,11,3,10,0,10
734034,2,11,3,12,0,12
829716,2,11,3,9,0,9
829724,2,11,3,5,0,5
829736,2,11,3,7,0,7
829756,2,11,3,7,0,7
829786,2,11,3,8,0,8
980912,2,11,3,13,0,13
980928,2,11,3,8,0,8
980934,2,11,3,6,1,7
980940,2,11,3,18,0,18
980972,2,11,3,3,0,3
980996,2,11,3,4,0,4
981014,2,11,3,11,0,11
981022,2,11,3,10,1,11
1082596,2,11,3,21,0,21
1082604,2,11,3,9,0,9
1082634,2,11,3,9,0,9
1082638,2,11,3,11,0,11
1082643,2,11,3,5,0,5
980916,1,12,3,7,0,7
980924,1,12,3,3,0,3
980944,1,12,3,11,0,11
980954,1,12,3,5,0,5
980962,1,12,3,14,0,14
980974,1,12,3,9,0,9
980994,1,12,3,8,0,8
1082594,1,12,3,4,0,4
1082603,1,12,3,8,0,8
1082607,1,12,3,13,4,17
1082618,1,12,3,7,0,7
1082620,1,12,3,10,1,11
1082624,1,12,3,9,0,9
1082634,1,12,3,6,0,6
1082647,1,12,3,10,0,10
980906,2,12,3,5,0,5
980936,2,12,3,5,1,6
980948,2,12,3,8,0,8
980970,2,12,3,3,0,3
980984,2,12,3,4,0,4
981002,2,12,3,14,0,14
981010,2,12,3,7,0,7
1082592,2,12,3,12,0,12
1082599,2,12,3,7,0,7
1082615,2,12,3,10,0,10
1082629,2,12,3,5,1,6
1082631,2,12,3,18,1,19
1082642,2,12,3,4,0,4
1082645,2,12,3,8,1,9
1082650,2,12,3,7,0,7
980934,1,13,3,9,1,10
980950,1,13,3,14,0,14
980966,1,13,3,3,0,3
980972,1,13,3,3,0,3
981018,1,13,3,2,0,2
981022,1,13,3,3,0,3
1082593,1,13,3,6,0,6
1082596,1,13,3,12,0,12
1082606,1,13,3,6,0,6
1082625,1,13,3,15,0,15
1082629,1,13,3,12,0,12
1082632,1,13,3,7,0,7
1082640,1,13,3,6,0,6
1082643,1,13,3,13,0,13
980910,2,13,3,11,0,11
980916,2,13,3,14,0,14
980922,2,13,3,5,0,5
980942,2,13,3,15,1,16
980954,2,13,3,22,2,24
980960,2,13,3,4,0,4
980980,2,13,3,13,0,13
980992,2,13,3,6,0,6
981006,2,13,3,7,1,8
981012,2,13,3,18,0,18
1082603,2,13,3,6,0,6
1082610,2,13,3,19,0,19
1082613,2,13,3,14,1,15
1082616,2,13,3,11,0,11
1082621,2,13,3,6,0,6
1082637,2,13,3,6,0,6
335987,1,1,4,17,6,23
335998,1,1,4,6,0,6
336002,1,1,4,10,1,11
336015,1,1,4,6,0,6
336019,1,1,4,9,0,9
336022,1,1,4,5,0,5
336026,1,1,4,3,2,5
336030,1,1,4,3,0,3
336032,1,1,4,2,0,2
392189,1,1,4,10,0,10
392204,1,1,4,14,0,14
392212,1,1,4,5,1,6
392216,1,1,4,9,0,9
392224,1,1,4,1,0,1
392226,1,1,4,2,0,2
392233,1,1,4,9,1,10
419111,1,1,4,7,1,8
419127,1,1,4,4,0,4
419132,1,1,4,5,0,5
419140,1,1,4,4,1,5
419144,1,1,4,5,1,6
419149,1,1,4,5,1,6
419153,1,1,4,9,0,9
419158,1,1,4,0,1,1
501208,1,1,4,7,0,7
501227,1,1,4,9,0,9
501235,1,1,4,13,0,13
501244,1,1,4,5,0,5
501260,1,1,4,1,1,2
501272,1,1,4,14,0,14
501274,1,1,4,2,0,2
548312,1,1,4,6,1,7
548320,1,1,4,15,0,15
548349,1,1,4,8,2,10
548358,1,1,4,3,7,10
548373,1,1,4,11,0,11
548375,1,1,4,9,1,10
548380,1,1,4,6,0,6
548383,1,1,4,8,0,8
598013,1,1,4,5,0,5
598018,1,1,4,6,1,7
598027,1,1,4,5,1,6
598034,1,1,4,2,0,2
598045,1,1,4,3,0,3
598058,1,1,4,7,0,7
598074,1,1,4,3,0,3
729284,1,1,4,10,0,10
729294,1,1,4,2,0,2
729304,1,1,4,6,0,6
734032,1,1,4,6,0,6
734048,1,1,4,16,1,17
829718,1,1,4,11,1,12
829766,1,1,4,16,0,16
829776,1,1,4,7,0,7
829786,1,1,4,10,1,11
980914,1,1,4,3,0,3
980952,1,1,4,6,0,6
980968,1,1,4,9,0,9
980980,1,1,4,4,0,4
981000,1,1,4,15,0,15
981006,1,1,4,11,0,11
981014,1,1,4,5,1,6
1082597,1,1,4,10,0,10
1082604,1,1,4,5,1,6
1082613,1,1,4,3,0,3
1082617,1,1,4,8,5,13
1082631,1,1,4,4,1,5
1082649,1,1,4,8,1,9
335991,2,1,4,3,0,3
336005,2,1,4,8,0,8
336008,2,1,4,2,0,2
336040,2,1,4,10,0,10
392191,2,1,4,14,0,14
392195,2,1,4,15,0,15
392202,2,1,4,0,0,0
392208,2,1,4,2,0,2
392236,2,1,4,6,0,6
392238,2,1,4,7,0,7
419114,2,1,4,17,0,17
419118,2,1,4,12,0,12
419123,2,1,4,9,0,9
419136,2,1,4,1,0,1
419163,2,1,4,4,0,4
419166,2,1,4,12,0,12
501203,2,1,4,14,0,14
501214,2,1,4,8,0,8
501219,2,1,4,6,1,7
501224,2,1,4,5,0,5
501239,2,1,4,15,0,15
501247,2,1,4,5,0,5
501250,2,1,4,4,0,4
501267,2,1,4,1,0,1
548317,2,1,4,3,0,3
548325,2,1,4,4,0,4
548328,2,1,4,11,0,11
548333,2,1,4,14,0,14
548340,2,1,4,8,1,9
548352,2,1,4,4,2,6
548362,2,1,4,16,0,16
548368,2,1,4,3,1,4
548386,2,1,4,18,2,20
598003,2,1,4,9,0,9
598010,2,1,4,3,0,3
598021,2,1,4,3,0,3
598036,2,1,4,12,0,12
598039,2,1,4,1,0,1
598048,2,1,4,10,0,10
598055,2,1,4,7,0,7
598062,2,1,4,12,0,12
598066,2,1,4,1,0,1
729312,2,1,4,6,0,6
729320,2,1,4,1,0,1
733976,2,1,4,15,0,15
733984,2,1,4,8,0,8
733990,2,1,4,3,0,3
734002,2,1,4,19,0,19
734014,2,1,4,10,0,10
734020,2,1,4,2,0,2
734028,2,1,4,2,0,2
734042,2,1,4,6,0,6
734054,2,1,4,9,0,9
829710,2,1,4,5,1,6
829728,2,1,4,12,0,12
829738,2,1,4,5,0,5
829744,2,1,4,7,0,7
829748,2,1,4,11,0,11
829770,2,1,4,14,0,14
829796,2,1,4,15,0,15
829810,2,1,4,9,0,9
829816,2,1,4,10,5,15
980908,2,1,4,6,1,7
980920,2,1,4,6,0,6
980930,2,1,4,11,0,11
980944,2,1,4,9,2,11
980956,2,1,4,6,1,7
980964,2,1,4,10,0,10
980994,2,1,4,11,2,13
981020,2,1,4,7,4,11
1082593,2,1,4,9,0,9
1082601,2,1,4,6,5,11
1082608,2,1,4,7,0,7
1082620,2,1,4,6,1,7
1082622,2,1,4,4,0,4
1082627,2,1,4,9,0,9
1082636,2,1,4,25,0,25
1082639,2,1,4,8,0,8
1082644,2,1,4,5,0,5
1082648,2,1,4,14,0,14
335997,1,2,4,12,0,12
336011,1,2,4,4,0,4
336017,1,2,4,9,0,9
336021,1,2,4,10,0,10
336031,1,2,4,7,0,7
336034,1,2,4,5,0,5
336039,1,2,4,9,1,10
392187,1,2,4,2,0,2
392196,1,2,4,6,1,7
392199,1,2,4,13,0,13
392209,1,2,4,12,0,12
392218,1,2,4,3,0,3
392241,1,2,4,10,0,10
419114,1,2,4,0,1,1
419128,1,2,4,2,0,2
419138,1,2,4,11,0,11
419150,1,2,4,6,1,7
501210,1,2,4,2,0,2
501237,1,2,4,9,0,9
501249,1,2,4,21,0,21
501273,1,2,4,6,0,6
501275,1,2,4,11,0,11
548315,1,2,4,6,1,7
548323,1,2,4,11,0,11
548341,1,2,4,2,0,2
548355,1,2,4,14,0,14
548367,1,2,4,1,3,4
548372,1,2,4,2,0,2
548377,1,2,4,11,0,11
598004,1,2,4,7,0,7
598009,1,2,4,3,1,4
598017,1,2,4,6,0,6
598032,1,2,4,5,0,5
598041,1,2,4,5,0,5
598047,1,2,4,5,0,5
598050,1,2,4,7,0,7
598059,1,2,4,6,1,7
598062,1,2,4,2,1,3
598069,1,2,4,5,0,5
598073,1,2,4,13,0,13
729310,1,2,4,1,0,1
729318,1,2,4,0,0,0
734004,1,2,4,9,0,9
734010,1,2,4,6,0,6
734026,1,2,4,6,0,6
734040,1,2,4,12,0,12
829724,1,2,4,5,0,5
829768,1,2,4,8,0,8
829790,1,2,4,6,0,6
829800,1,2,4,0,0,0
829824,1,2,4,3,1,4
829826,1,2,4,2,0,2
980912,1,2,4,14,1,15
980926,1,2,4,15,1,16
980932,1,2,4,17,0,17
980936,1,2,4,7,0,7
980942,1,2,4,8,0,8
980964,1,2,4,10,0,10
980982,1,2,4,20,0,20
980986,1,2,4,5,0,5
980992,1,2,4,5,0,5
981004,1,2,4,17,1,18
1082595,1,2,4,4,0,4
1082598,1,2,4,1,0,1
1082602,1,2,4,4,0,4
1082610,1,2,4,8,0,8
1082621,1,2,4,4,1,5
1082628,1,2,4,9,1,10
1082636,1,2,4,9,0,9
1082646,1,2,4,8,0,8
335987,2,2,4,3,1,4
335990,2,2,4,5,0,5
336001,2,2,4,7,0,7
336003,2,2,4,13,2,15
336007,2,2,4,6,0,6
336015,2,2,4,2,0,2
336028,2,2,4,9,0,9
392190,2,2,4,5,1,6
392193,2,2,4,4,0,4
392204,2,2,4,13,2,15
392213,2,2,4,17,0,17
392223,2,2,4,5,0,5
392226,2,2,4,10,0,10
392229,2,2,4,10,1,11
392237,2,2,4,6,0,6
392243,2,2,4,14,1,15
392244,2,2,4,5,0,5
419117,2,2,4,5,7,12
419120,2,2,4,8,1,9
419124,2,2,4,12,0,12
419133,2,2,4,11,0,11
419141,2,2,4,9,0,9
419145,2,2,4,1,0,1
419153,2,2,4,9,2,11
419156,2,2,4,9,0,9
419159,2,2,4,18,0,18
419162,2,2,4,10,0,10
419167,2,2,4,7,0,7
419169,2,2,4,6,0,6
501205,2,2,4,8,1,9
501213,2,2,4,6,0,6
501216,2,2,4,5,0,5
501227,2,2,4,14,1,15
501232,2,2,4,11,1,12
501252,2,2,4,1,0,1
501257,2,2,4,10,0,10
501260,2,2,4,3,1,4
501265,2,2,4,10,1,11
501271,2,2,4,18,0,18
501276,2,2,4,6,0,6
548320,2,2,4,6,0,6
548329,2,2,4,10,0,10
548332,2,2,4,18,0,18
548336,2,2,4,1,0,1
548349,2,2,4,9,0,9
548361,2,2,4,0,0,0
548365,2,2,4,14,0,14
548381,2,2,4,5,1,6
598013,2,2,4,0,0,0
598022,2,2,4,11,1,12
598028,2,2,4,10,0,10
598038,2,2,4,3,0,3
598053,2,2,4,2,0,2
729286,2,2,4,10,1,11
729292,2,2,4,1,0,1
729304,2,2,4,12,1,13
733982,2,2,4,2,0,2
733988,2,2,4,6,0,6
733996,2,2,4,8,0,8
734018,2,2,4,2,0,2
734032,2,2,4,8,0,8
829718,2,2,4,1,4,5
829742,2,2,4,4,0,4
829750,2,2,4,2,0,2
829754,2,2,4,8,0,8
829762,2,2,4,8,0,8
829776,2,2,4,13,0,13
829784,2,2,4,7,0,7
829808,2,2,4,6,0,6
829812,2,2,4,14,0,14
980958,2,2,4,7,1,8
980974,2,2,4,14,1,15
981000,2,2,4,12,0,12
981016,2,2,4,9,0,9
981018,2,2,4,0,0,0
981024,2,2,4,16,0,16
1082591,2,2,4,14,1,15
1082607,2,2,4,10,0,10
1082617,2,2,4,2,0,2
1082624,2,2,4,4,1,5
1082633,2,2,4,4,0,4
335988,1,3,4,6,0,6
335994,1,3,4,1,0,1
336001,1,3,4,4,0,4
336006,1,3,4,13,2,15
336010,1,3,4,4,0,4
336012,1,3,4,5,2,7
336018,1,3,4,4,1,5
336023,1,3,4,2,0,2
336045,1,3,4,12,1,13
392190,1,3,4,8,0,8
392201,1,3,4,7,3,10
392207,1,3,4,2,0,2
392211,1,3,4,9,0,9
392214,1,3,4,13,0,13
392219,1,3,4,6,0,6
392229,1,3,4,0,0,0
392236,1,3,4,6,2,8
392239,1,3,4,11,0,11
392243,1,3,4,8,1,9
419118,1,3,4,2,0,2
419130,1,3,4,4,1,5
419142,1,3,4,6,0,6
419147,1,3,4,2,1,3
419152,1,3,4,12,1,13
419160,1,3,4,5,0,5
419168,1,3,4,2,0,2
419170,1,3,4,7,0,7
501203,1,3,4,6,2,8
501211,1,3,4,7,0,7
501216,1,3,4,5,0,5
501220,1,3,4,8,0,8
501231,1,3,4,9,0,9
501241,1,3,4,3,4,7
501250,1,3,4,1,1,2
501254,1,3,4,9,0,9
501258,1,3,4,2,0,2
501266,1,3,4,4,0,4
501271,1,3,4,4,1,5
501276,1,3,4,4,6,10
548311,1,3,4,13,0,13
548316,1,3,4,5,0,5
548321,1,3,4,0,2,2
548327,1,3,4,18,0,18
548335,1,3,4,8,0,8
548352,1,3,4,11,0,11
548357,1,3,4,9,0,9
548360,1,3,4,3,1,4
548376,1,3,4,1,0,1
548384,1,3,4,10,0,10
548385,1,3,4,6,0,6
548386,1,3,4,14,0,14
598025,1,3,4,10,0,10
598039,1,3,4,14,1,15
598043,1,3,4,3,0,3
598046,1,3,4,5,0,5
598056,1,3,4,13,0,13
598063,1,3,4,4,2,6
598067,1,3,4,8,1,9
598075,1,3,4,2,0,2
729288,1,3,4,6,2,8
729298,1,3,4,2,0,2
729302,1,3,4,2,0,2
733976,1,3,4,9,0,9
734018,1,3,4,3,1,4
734028,1,3,4,16,0,16
734034,1,3,4,2,0,2
829712,1,3,4,1,1,2
829716,1,3,4,9,1,10
829728,1,3,4,12,1,13
829740,1,3,4,11,0,11
829750,1,3,4,12,0,12
829758,1,3,4,11,0,11
829770,1,3,4,14,1,15
829784,1,3,4,5,0,5
829794,1,3,4,7,0,7
829802,1,3,4,1,1,2
829806,1,3,4,5,0,5
335998,2,3,4,5,2,7
336014,2,3,4,6,0,6
336030,2,3,4,3,0,3
336034,2,3,4,13,0,13
336038,2,3,4,6,0,6
336042,2,3,4,12,1,13
336044,2,3,4,9,0,9
392186,2,3,4,1,0,1
392194,2,3,4,10,4,14
392207,2,3,4,0,0,0
392222,2,3,4,4,0,4
392232,2,3,4,6,0,6
419115,2,3,4,9,0,9
419121,2,3,4,9,0,9
419126,2,3,4,10,1,11
419128,2,3,4,2,1,3
419134,2,3,4,8,0,8
419138,2,3,4,3,0,3
419158,2,3,4,11,0,11
419164,2,3,4,13,0,13
501226,2,3,4,13,0,13
501233,2,3,4,6,2,8
501245,2,3,4,10,0,10
501273,2,3,4,2,1,3
548323,2,3,4,10,1,11
548337,2,3,4,6,0,6
548348,2,3,4,11,0,11
548366,2,3,4,12,1,13
548369,2,3,4,10,0,10
548373,2,3,4,2,0,2
598007,2,3,4,15,1,16
598012,2,3,4,10,0,10
598017,2,3,4,4,0,4
598020,2,3,4,12,0,12
598027,2,3,4,5,0,5
598031,2,3,4,13,1,14
598035,2,3,4,14,1,15
598051,2,3,4,8,0,8
598073,2,3,4,10,0,10
598078,2,3,4,10,0,10
729308,2,3,4,17,0,17
729316,2,3,4,5,0,5
733986,2,3,4,18,0,18
733992,2,3,4,8,0,8
734000,2,3,4,11,2,13
734008,2,3,4,11,1,12
734040,2,3,4,17,1,18
734050,2,3,4,18,0,18
734052,2,3,4,19,1,20
829734,2,3,4,19,2,21
829778,2,3,4,14,1,15
829814,2,3,4,10,1,11
829822,2,3,4,10,0,10
829826,2,3,4,2,0,2
829828,2,3,4,5,1,6
335992,1,4,4,8,0,8
335996,1,4,4,10,0,10
336008,1,4,4,8,1,9
336024,1,4,4,9,1,10
336033,1,4,4,11,0,11
336040,1,4,4,2,1,3
336044,1,4,4,12,0,12
392188,1,4,4,10,0,10
392191,1,4,4,7,0,7
392200,1,4,4,9,0,9
392205,1,4,4,8,0,8
392227,1,4,4,7,2,9
392234,1,4,4,11,0,11
419113,1,4,4,18,0,18
419117,1,4,4,7,1,8
419126,1,4,4,3,0,3
419137,1,4,4,9,0,9
419141,1,4,4,13,0,13
419148,1,4,4,1,1,2
419161,1,4,4,8,0,8
419164,1,4,4,2,0,2
501207,1,4,4,8,0,8
501225,1,4,4,15,0,15
501239,1,4,4,5,0,5
501253,1,4,4,2,1,3
501256,1,4,4,4,0,4
501262,1,4,4,7,0,7
501265,1,4,4,6,2,8
548328,1,4,4,2,2,4
548333,1,4,4,5,0,5
548336,1,4,4,5,0,5
548344,1,4,4,3,0,3
548348,1,4,4,5,0,5
548364,1,4,4,8,0,8
548374,1,4,4,2,0,2
548379,1,4,4,2,0,2
598012,1,4,4,11,0,11
598019,1,4,4,0,0,0
598021,1,4,4,4,0,4
598026,1,4,4,1,0,1
598033,1,4,4,10,0,10
598036,1,4,4,8,0,8
598057,1,4,4,13,0,13
598071,1,4,4,5,0,5
729300,1,4,4,7,0,7
729312,1,4,4,13,0,13
733978,1,4,4,8,1,9
733992,1,4,4,9,1,10
733996,1,4,4,9,0,9
734002,1,4,4,5,0,5
734030,1,4,4,9,0,9
734038,1,4,4,11,0,11
734052,1,4,4,23,1,24
734054,1,4,4,3,0,3
829722,1,4,4,5,1,6
829730,1,4,4,6,2,8
829738,1,4,4,5,0,5
829772,1,4,4,1,0,1
829796,1,4,4,4,0,4
829808,1,4,4,11,0,11
829814,1,4,4,7,0,7
980910,1,4,4,11,0,11
980918,1,4,4,5,0,5
980930,1,4,4,9,0,9
980940,1,4,4,1,1,2
980960,1,4,4,8,0,8
980976,1,4,4,8,4,12
980996,1,4,4,11,0,11
981010,1,4,4,8,0,8
1082601,1,4,4,14,1,15
1082612,1,4,4,6,0,6
1082616,1,4,4,2,1,3
1082633,1,4,4,4,0,4
1082637,1,4,4,6,2,8
1082639,1,4,4,9,0,9
1082641,1,4,4,17,2,19
1082645,1,4,4,4,0,4
335988,2,4,4,10,0,10
336000,2,4,4,13,0,13
336004,2,4,4,5,0,5
336011,2,4,4,9,1,10
336018,2,4,4,8,0,8
336021,2,4,4,8,0,8
336027,2,4,4,4,0,4
336036,2,4,4,15,0,15
392196,2,4,4,10,0,10
392209,2,4,4,11,0,11
392212,2,4,4,22,0,22
392215,2,4,4,5,1,6
392219,2,4,4,4,1,5
392221,2,4,4,11,0,11
392231,2,4,4,10,3,13
392239,2,4,4,13,0,13
419122,2,4,4,6,1,7
419129,2,4,4,15,0,15
419132,2,4,4,13,0,13
419144,2,4,4,13,0,13
419151,2,4,4,10,0,10
419154,2,4,4,12,1,13
501211,2,4,4,13,0,13
501217,2,4,4,8,2,10
501228,2,4,4,0,0,0
501242,2,4,4,9,0,9
501249,2,4,4,7,0,7
501259,2,4,4,4,2,6
501269,2,4,4,3,0,3
548314,2,4,4,17,0,17
548318,2,4,4,2,0,2
548324,2,4,4,6,0,6
548339,2,4,4,6,0,6
548355,2,4,4,8,0,8
548359,2,4,4,8,1,9
548371,2,4,4,13,0,13
548376,2,4,4,6,0,6
598008,2,4,4,21,0,21
598030,2,4,4,10,0,10
598042,2,4,4,6,0,6
598046,2,4,4,7,0,7
598050,2,4,4,3,0,3
598061,2,4,4,5,0,5
598064,2,4,4,5,0,5
598069,2,4,4,7,1,8
729288,2,4,4,8,1,9
729296,2,4,4,5,0,5
729318,2,4,4,8,0,8
734012,2,4,4,16,0,16
734024,2,4,4,12,1,13
734044,2,4,4,1,0,1
734048,2,4,4,7,0,7
829714,2,4,4,7,0,7
829746,2,4,4,12,1,13
829758,2,4,4,7,0,7
829764,2,4,4,4,0,4
829780,2,4,4,5,0,5
829790,2,4,4,5,0,5
829804,2,4,4,11,0,11
980924,2,4,4,4,0,4
980946,2,4,4,7,0,7
980968,2,4,4,3,0,3
980982,2,4,4,10,1,11
980990,2,4,4,9,1,10
981004,2,4,4,13,0,13
1082594,2,4,4,11,0,11
1082598,2,4,4,17,0,17
1082605,2,4,4,9,0,9
1082609,2,4,4,4,1,5
1082623,2,4,4,9,0,9
1082626,2,4,4,11,0,11
335989,1,5,4,10,0,10
336005,1,5,4,5,0,5
336013,1,5,4,5,0,5
336028,1,5,4,2,2,4
336038,1,5,4,14,0,14
336043,1,5,4,14,0,14
392195,1,5,4,7,0,7
392215,1,5,4,11,0,11
392222,1,5,4,9,0,9
392230,1,5,4,7,0,7
392238,1,5,4,4,0,4
419116,1,5,4,6,0,6
419120,1,5,4,1,2,3
419123,1,5,4,8,1,9
419129,1,5,4,6,1,7
419134,1,5,4,17,0,17
419146,1,5,4,12,0,12
419159,1,5,4,0,0,0
419163,1,5,4,10,0,10
501214,1,5,4,3,0,3
501219,1,5,4,6,0,6
501245,1,5,4,5,1,6
501257,1,5,4,1,1,2
501263,1,5,4,3,0,3
548314,1,5,4,7,3,10
548317,1,5,4,6,1,7
548325,1,5,4,7,0,7
548329,1,5,4,15,0,15
548337,1,5,4,15,0,15
548354,1,5,4,4,0,4
548359,1,5,4,15,0,15
548366,1,5,4,1,0,1
548370,1,5,4,10,0,10
548378,1,5,4,6,0,6
548382,1,5,4,8,0,8
598006,1,5,4,5,5,10
598010,1,5,4,8,0,8
598014,1,5,4,9,1,10
598024,1,5,4,7,0,7
598028,1,5,4,4,0,4
598031,1,5,4,8,0,8
598048,1,5,4,6,0,6
598077,1,5,4,3,0,3
729296,1,5,4,10,0,10
729320,1,5,4,8,0,8
733984,1,5,4,12,0,12
734008,1,5,4,8,0,8
734016,1,5,4,7,0,7
734046,1,5,4,5,0,5
829714,1,5,4,2,0,2
829746,1,5,4,9,0,9
829754,1,5,4,13,0,13
829782,1,5,4,7,0,7
829816,1,5,4,12,0,12
335992,2,5,4,12,2,14
335995,2,5,4,15,1,16
335997,2,5,4,6,0,6
336010,2,5,4,9,1,10
336016,2,5,4,7,1,8
336020,2,5,4,1,2,3
336024,2,5,4,17,1,18
336032,2,5,4,7,0,7
336041,2,5,4,2,1,3
336045,2,5,4,8,0,8
392187,2,5,4,1,1,2
392200,2,5,4,8,0,8
392203,2,5,4,1,0,1
392207,2,5,4,4,0,4
392210,2,5,4,2,0,2
392218,2,5,4,3,0,3
392225,2,5,4,5,1,6
392235,2,5,4,1,3,4
419112,2,5,4,12,0,12
419131,2,5,4,16,4,20
419139,2,5,4,10,1,11
419142,2,5,4,2,4,6
419148,2,5,4,20,0,20
419155,2,5,4,6,0,6
501204,2,5,4,6,0,6
501209,2,5,4,14,1,15
501225,2,5,4,13,0,13
501230,2,5,4,2,1,3
501236,2,5,4,5,0,5
501240,2,5,4,2,0,2
501254,2,5,4,3,0,3
501268,2,5,4,8,0,8
548322,2,5,4,11,0,11
548331,2,5,4,14,0,14
548341,2,5,4,5,1,6
548350,2,5,4,2,0,2
548363,2,5,4,8,0,8
598019,2,5,4,10,2,12
598037,2,5,4,5,1,6
598041,2,5,4,11,0,11
598052,2,5,4,13,1,14
598054,2,5,4,4,5,9
598057,2,5,4,8,0,8
598063,2,5,4,4,0,4
598068,2,5,4,4,0,4
598070,2,5,4,1,0,1
598076,2,5,4,10,0,10
729290,2,5,4,4,2,6
729302,2,5,4,10,0,10
729310,2,5,4,4,0,4
733980,2,5,4,5,1,6
733994,2,5,4,11,0,11
734004,2,5,4,6,1,7
734022,2,5,4,11,0,11
734038,2,5,4,4,1,5
829720,2,5,4,12,0,12
829726,2,5,4,9,0,9
829732,2,5,4,7,1,8
829740,2,5,4,13,0,13
829774,2,5,4,9,0,9
829792,2,5,4,9,0,9
829802,2,5,4,9,0,9
829824,2,5,4,9,0,9
336000,1,6,4,11,1,12
336003,1,6,4,16,2,18
336014,1,6,4,9,0,9
336020,1,6,4,6,0,6
336025,1,6,4,18,2,20
336027,1,6,4,9,0,9
392194,1,6,4,15,0,15
392203,1,6,4,5,1,6
392228,1,6,4,8,0,8
392231,1,6,4,3,0,3
392235,1,6,4,4,0,4
392237,1,6,4,2,0,2
392242,1,6,4,9,1,10
419121,1,6,4,8,0,8
419133,1,6,4,8,1,9
419136,1,6,4,7,0,7
419139,1,6,4,7,1,8
419145,1,6,4,10,0,10
419154,1,6,4,12,0,12
501206,1,6,4,0,0,0
501209,1,6,4,5,2,7
501228,1,6,4,9,0,9
501232,1,6,4,4,1,5
501238,1,6,4,6,2,8
501243,1,6,4,6,0,6
501270,1,6,4,9,0,9
548347,1,6,4,11,0,11
548350,1,6,4,5,0,5
548362,1,6,4,7,0,7
548369,1,6,4,3,0,3
598003,1,6,4,8,0,8
598015,1,6,4,9,0,9
598022,1,6,4,13,0,13
598040,1,6,4,2,1,3
598049,1,6,4,5,3,8
598054,1,6,4,2,0,2
598064,1,6,4,0,0,0
729286,1,6,4,2,0,2
733980,1,6,4,11,0,11
733986,1,6,4,17,0,17
733990,1,6,4,2,0,2
733998,1,6,4,9,0,9
734024,1,6,4,18,0,18
734044,1,6,4,9,0,9
829720,1,6,4,18,0,18
829736,1,6,4,6,0,6
829744,1,6,4,10,0,10
829752,1,6,4,14,0,14
829762,1,6,4,12,1,13
829788,1,6,4,14,0,14
829818,1,6,4,16,0,16
980908,1,6,4,1,0,1
980938,1,6,4,12,0,12
980956,1,6,4,7,0,7
980970,1,6,4,10,0,10
981002,1,6,4,11,0,11
981016,1,6,4,12,0,12
1082599,1,6,4,9,1,10
1082605,1,6,4,5,0,5
1082608,1,6,4,5,0,5
1082622,1,6,4,10,0,10
1082626,1,6,4,6,0,6
1082642,1,6,4,15,0,15
335989,2,6,4,10,0,10
335993,2,6,4,2,0,2
336006,2,6,4,12,0,12
336009,2,6,4,16,0,16
336022,2,6,4,9,1,10
336031,2,6,4,14,0,14
336037,2,6,4,3,0,3
336043,2,6,4,1,0,1
392188,2,6,4,5,0,5
392199,2,6,4,11,0,11
392206,2,6,4,3,0,3
392211,2,6,4,1,1,2
392216,2,6,4,10,0,10
392220,2,6,4,3,0,3
392224,2,6,4,7,6,13
392240,2,6,4,11,0,11
419113,2,6,4,5,0,5
419116,2,6,4,3,0,3
419119,2,6,4,5,0,5
419125,2,6,4,3,0,3
419149,2,6,4,5,1,6
419157,2,6,4,13,0,13
419160,2,6,4,4,2,6
419165,2,6,4,12,0,12
501218,2,6,4,11,0,11
501221,2,6,4,1,0,1
501235,2,6,4,12,0,12
501248,2,6,4,5,0,5
501251,2,6,4,5,0,5
501258,2,6,4,6,0,6
501262,2,6,4,1,2,3
548312,2,6,4,8,0,8
548315,2,6,4,2,0,2
548321,2,6,4,2,0,2
548326,2,6,4,6,0,6
548330,2,6,4,4,0,4
548334,2,6,4,13,0,13
548338,2,6,4,2,0,2
548342,2,6,4,12,0,12
548354,2,6,4,7,0,7
548374,2,6,4,4,0,4
548377,2,6,4,15,0,15
548379,2,6,4,7,0,7
548383,2,6,4,14,1,15
548385,2,6,4,6,0,6
598006,2,6,4,1,0,1
598011,2,6,4,10,0,10
598025,2,6,4,3,1,4
598029,2,6,4,17,0,17
598033,2,6,4,0,0,0
598045,2,6,4,8,0,8
598059,2,6,4,5,1,6
598067,2,6,4,11,0,11
598072,2,6,4,4,0,4
729294,2,6,4,8,0,8
729298,2,6,4,6,0,6
729306,2,6,4,9,0,9
729314,2,6,4,8,0,8
734010,2,6,4,7,1,8
734016,2,6,4,4,0,4
734036,2,6,4,9,0,9
829712,2,6,4,12,1,13
829730,2,6,4,7,0,7
829766,2,6,4,8,1,9
829772,2,6,4,2,1,3
829782,2,6,4,0,1,1
829798,2,6,4,6,0,6
829806,2,6,4,8,0,8
980918,2,6,4,3,0,3
980926,2,6,4,8,1,9
980950,2,6,4,9,0,9
980966,2,6,4,9,1,10
980976,2,6,4,7,0,7
980988,2,6,4,12,0,12
980998,2,6,4,19,0,19
981008,2,6,4,7,1,8
1082595,2,6,4,11,0,11
1082611,2,6,4,8,0,8
1082614,2,6,4,1,1,2
1082630,2,6,4,12,0,12
1082632,2,6,4,15,1,16
1082635,2,6,4,6,0,6
1082640,2,6,4,10,0,10
1082646,2,6,4,8,0,8
335990,1,7,4,3,0,3
335999,1,7,4,3,0,3
336009,1,7,4,8,1,9
336029,1,7,4,5,0,5
336037,1,7,4,15,0,15
336041,1,7,4,1,0,1
392186,1,7,4,7,0,7
392202,1,7,4,12,0,12
392208,1,7,4,4,2,6
392213,1,7,4,0,0,0
392220,1,7,4,4,1,5
392223,1,7,4,7,0,7
392232,1,7,4,8,0,8
392240,1,7,4,3,1,4
419112,1,7,4,4,1,5
419119,1,7,4,17,0,17
419124,1,7,4,13,1,14
419135,1,7,4,8,3,11
419143,1,7,4,11,0,11
419151,1,7,4,15,0,15
419155,1,7,4,10,0,10
419157,1,7,4,8,4,12
419162,1,7,4,5,0,5
419166,1,7,4,7,1,8
419167,1,7,4,7,1,8
501215,1,7,4,10,0,10
501226,1,7,4,11,0,11
501229,1,7,4,11,0,11
501236,1,7,4,6,0,6
501242,1,7,4,5,0,5
501246,1,7,4,4,1,5
501251,1,7,4,5,1,6
501268,1,7,4,2,1,3
548322,1,7,4,7,0,7
548330,1,7,4,2,0,2
548339,1,7,4,11,0,11
548356,1,7,4,13,0,13
548365,1,7,4,2,0,2
548368,1,7,4,11,0,11
598007,1,7,4,5,1,6
598011,1,7,4,4,2,6
598016,1,7,4,7,0,7
598029,1,7,4,5,0,5
598038,1,7,4,3,0,3
598042,1,7,4,3,0,3
598044,1,7,4,10,2,12
598051,1,7,4,4,0,4
598055,1,7,4,20,0,20
598068,1,7,4,1,1,2
598078,1,7,4,2,0,2
729292,1,7,4,2,2,4
729308,1,7,4,5,0,5
729314,1,7,4,4,1,5
733988,1,7,4,7,0,7
734000,1,7,4,1,1,2
734014,1,7,4,9,0,9
734022,1,7,4,6,1,7
734036,1,7,4,11,1,12
734050,1,7,4,6,0,6
829710,1,7,4,7,0,7
829726,1,7,4,4,0,4
829734,1,7,4,4,1,5
829742,1,7,4,12,1,13
829756,1,7,4,7,0,7
829774,1,7,4,11,1,12
829780,1,7,4,5,1,6
829810,1,7,4,9,0,9
829822,1,7,4,6,1,7
829828,1,7,4,11,1,12
980906,1,7,4,8,1,9
980922,1,7,4,0,0,0
980928,1,7,4,8,3,11
980946,1,7,4,5,0,5
980990,1,7,4,4,0,4
980998,1,7,4,14,0,14
981012,1,7,4,12,0,12
1082592,1,7,4,13,0,13
1082614,1,7,4,7,1,8
1082635,1,7,4,13,0,13
1082638,1,7,4,2,0,2
1082644,1,7,4,10,4,14
1082650,1,7,4,2,0,2
335994,2,7,4,5,1,6
335996,2,7,4,2,1,3
336002,2,7,4,8,0,8
336013,2,7,4,12,1,13
336017,2,7,4,3,2,5
336023,2,7,4,12,2,14
336026,2,7,4,4,0,4
336033,2,7,4,3,1,4
392197,2,7,4,10,1,11
392202,2,7,4,6,1,7
392205,2,7,4,4,0,4
392217,2,7,4,8,1,9
392227,2,7,4,5,0,5
392230,2,7,4,6,0,6
419119,2,7,4,5,0,5
419127,2,7,4,13,1,14
419130,2,7,4,8,0,8
419137,2,7,4,9,1,10
419147,2,7,4,6,2,8
419170,2,7,4,2,0,2
501206,2,7,4,5,1,6
501210,2,7,4,7,0,7
501223,2,7,4,8,0,8
501256,2,7,4,7,1,8
501261,2,7,4,7,1,8
501272,2,7,4,9,0,9
501274,2,7,4,10,0,10
501275,2,7,4,6,0,6
548311,2,7,4,10,1,11
548313,2,7,4,4,0,4
548319,2,7,4,0,0,0
548344,2,7,4,7,0,7
548347,2,7,4,10,1,11
548351,2,7,4,9,1,10
548360,2,7,4,12,0,12
548372,2,7,4,9,0,9
548375,2,7,4,6,0,6
548382,2,7,4,6,0,6
548384,2,7,4,14,0,14
598004,2,7,4,12,0,12
598024,2,7,4,5,1,6
598034,2,7,4,15,0,15
598060,2,7,4,7,0,7
598065,2,7,4,7,0,7
598071,2,7,4,9,0,9
598075,2,7,4,7,3,10
598077,2,7,4,11,0,11
729284,2,7,4,1,0,1
729322,2,7,4,0,1,1
733978,2,7,4,7,0,7
734006,2,7,4,7,0,7
734030,2,7,4,13,1,14
734046,2,7,4,18,1,19
829722,2,7,4,2,1,3
829752,2,7,4,14,0,14
829788,2,7,4,11,0,11
829794,2,7,4,12,0,12
829800,2,7,4,4,0,4
829820,2,7,4,10,0,10
980914,2,7,4,8,2,10
980932,2,7,4,10,0,10
980938,2,7,4,13,0,13
980952,2,7,4,10,1,11
980962,2,7,4,14,1,15
980978,2,7,4,10,0,10
980986,2,7,4,7,0,7
1082597,2,7,4,10,2,12
1082600,2,7,4,11,0,11
1082602,2,7,4,2,0,2
1082606,2,7,4,7,0,7
1082612,2,7,4,17,0,17
1082618,2,7,4,8,0,8
1082625,2,7,4,3,0,3
1082628,2,7,4,4,0,4
1082641,2,7,4,7,1,8
1082647,2,7,4,8,2,10
1082649,2,7,4,6,0,6
335991,1,8,4,0,0,0
335993,1,8,4,1,0,1
335995,1,8,4,1,0,1
336004,1,8,4,3,1,4
336007,1,8,4,2,1,3
336016,1,8,4,4,0,4
336036,1,8,4,10,0,10
336042,1,8,4,2,0,2
392193,1,8,4,8,4,12
392197,1,8,4,12,2,14
392206,1,8,4,4,0,4
392210,1,8,4,6,1,7
392217,1,8,4,8,0,8
392221,1,8,4,6,0,6
392225,1,8,4,9,0,9
392244,1,8,4,3,0,3
419115,1,8,4,6,0,6
419122,1,8,4,3,0,3
419125,1,8,4,10,0,10
419131,1,8,4,11,0,11
419156,1,8,4,4,0,4
419165,1,8,4,13,1,14
419169,1,8,4,1,0,1
501204,1,8,4,3,0,3
501213,1,8,4,5,1,6
501217,1,8,4,10,0,10
501221,1,8,4,9,1,10
501234,1,8,4,4,3,7
501248,1,8,4,5,0,5
501255,1,8,4,8,1,9
501261,1,8,4,8,1,9
501269,1,8,4,10,0,10
548319,1,8,4,9,0,9
548326,1,8,4,14,0,14
548331,1,8,4,6,7,13
548334,1,8,4,5,0,5
548340,1,8,4,9,0,9
548346,1,8,4,10,0,10
548351,1,8,4,9,0,9
548353,1,8,4,6,1,7
548361,1,8,4,6,1,7
548371,1,8,4,6,0,6
548381,1,8,4,3,1,4
335999,2,8,4,8,0,8
336012,2,8,4,8,1,9
336019,2,8,4,9,1,10
336025,2,8,4,16,1,17
336029,2,8,4,2,0,2
336039,2,8,4,9,0,9
392189,2,8,4,6,0,6
392201,2,8,4,12,0,12
392214,2,8,4,8,0,8
392228,2,8,4,7,0,7
392233,2,8,4,10,1,11
392234,2,8,4,4,0,4
392241,2,8,4,6,1,7
392242,2,8,4,14,1,15
419111,2,8,4,9,0,9
419135,2,8,4,8,1,9
419140,2,8,4,9,0,9
419143,2,8,4,10,0,10
419146,2,8,4,1,0,1
419150,2,8,4,6,1,7
419152,2,8,4,15,1,16
419161,2,8,4,10,0,10
419168,2,8,4,7,0,7
501208,2,8,4,3,0,3
501229,2,8,4,6,0,6
501241,2,8,4,5,1,6
501244,2,8,4,10,0,10
501264,2,8,4,6,6,12
548316,2,8,4,9,2,11
548357,2,8,4,8,0,8
548364,2,8,4,4,1,5
548378,2,8,4,8,0,8
501205,1,9,4,7,0,7
501212,1,9,4,9,0,9
501224,1,9,4,7,0,7
501230,1,9,4,6,0,6
501247,1,9,4,6,0,6
501252,1,9,4,8,0,8
501259,1,9,4,4,1,5
501215,2,9,4,5,0,5
501220,2,9,4,9,0,9
501234,2,9,4,5,0,5
501238,2,9,4,8,1,9
501243,2,9,4,21,2,23
501263,2,9,4,14,0,14
501266,2,9,4,12,1,13
501218,1,10,4,6,1,7
501223,1,10,4,0,1,1
501233,1,10,4,0,0,0
501240,1,10,4,3,0,3
501264,1,10,4,6,0,6
501267,1,10,4,1,0,1
548313,1,10,4,10,1,11
548318,1,10,4,7,0,7
548324,1,10,4,8,1,9
548332,1,10,4,6,1,7
548338,1,10,4,12,1,13
548342,1,10,4,7,0,7
548363,1,10,4,7,0,7
598008,1,10,4,4,1,5
598020,1,10,4,9,0,9
598030,1,10,4,9,0,9
598052,1,10,4,12,1,13
598060,1,10,4,4,0,4
598066,1,10,4,4,0,4
598072,1,10,4,7,0,7
501207,2,10,4,9,1,10
501212,2,10,4,3,1,4
501231,2,10,4,8,0,8
501237,2,10,4,3,0,3
501246,2,10,4,5,4,9
501253,2,10,4,9,0,9
501255,2,10,4,8,0,8
548327,2,10,4,11,1,12
548335,2,10,4,4,0,4
548346,2,10,4,10,1,11
548353,2,10,4,8,0,8
548356,2,10,4,1,0,1
548358,2,10,4,6,0,6
548367,2,10,4,12,0,12
548370,2,10,4,9,0,9
548380,2,10,4,8,0,8
598005,2,10,4,8,0,8
598014,2,10,4,20,1,21
598016,2,10,4,4,0,4
598023,2,10,4,10,0,10
598032,2,10,4,8,0,8
598040,2,10,4,7,0,7
598043,2,10,4,9,2,11
598047,2,10,4,4,1,5
598058,2,10,4,3,0,3
598005,1,11,4,2,1,3
598023,1,11,4,1,0,1
598035,1,11,4,11,4,15
598037,1,11,4,1,0,1
598053,1,11,4,8,0,8
598061,1,11,4,5,0,5
598065,1,11,4,3,0,3
598070,1,11,4,2,1,3
598076,1,11,4,6,0,6
729290,1,11,4,6,1,7
729306,1,11,4,10,0,10
729316,1,11,4,7,4,11
729322,1,11,4,10,0,10
733982,1,11,4,9,0,9
733994,1,11,4,8,1,9
734006,1,11,4,6,0,6
734012,1,11,4,3,2,5
734020,1,11,4,7,0,7
734042,1,11,4,13,0,13
829732,1,11,4,6,0,6
829748,1,11,4,10,0,10
829764,1,11,4,15,0,15
829778,1,11,4,12,0,12
829792,1,11,4,7,5,12
829798,1,11,4,5,1,6
829804,1,11,4,17,1,18
829812,1,11,4,5,1,6
829820,1,11,4,3,0,3
980920,1,11,4,7,0,7
980948,1,11,4,6,0,6
980958,1,11,4,7,0,7
980978,1,11,4,11,0,11
980984,1,11,4,1,0,1
980988,1,11,4,15,0,15
981008,1,11,4,15,0,15
981020,1,11,4,6,0,6
981024,1,11,4,6,0,6
1082591,1,11,4,4,0,4
1082600,1,11,4,4,0,4
1082609,1,11,4,3,0,3
1082611,1,11,4,10,0,10
1082615,1,11,4,8,0,8
1082623,1,11,4,11,0,11
1082627,1,11,4,17,0,17
1082630,1,11,4,15,0,15
1082648,1,11,4,4,1,5
598009,2,11,4,1,0,1
598015,2,11,4,8,0,8
598018,2,11,4,4,1,5
598026,2,11,4,5,0,5
598044,2,11,4,1,0,1
598049,2,11,4,7,0,7
598056,2,11,4,4,1,5
598074,2,11,4,7,1,8
729300,2,11,4,7,2,9
733998,2,11,4,13,0,13
734026,2,11,4,12,2,14
734034,2,11,4,5,0,5
829716,2,11,4,8,0,8
829724,2,11,4,2,0,2
829736,2,11,4,2,1,3
829756,2,11,4,18,0,18
829786,2,11,4,3,0,3
980912,2,11,4,3,0,3
980928,2,11,4,3,0,3
980934,2,11,4,18,0,18
980940,2,11,4,17,0,17
980972,2,11,4,5,0,5
980996,2,11,4,10,1,11
981014,2,11,4,7,0,7
981022,2,11,4,11,0,11
1082596,2,11,4,8,0,8
1082604,2,11,4,13,0,13
1082634,2,11,4,2,0,2
1082638,2,11,4,5,0,5
1082643,2,11,4,2,0,2
980916,1,12,4,5,0,5
980924,1,12,4,14,0,14
980944,1,12,4,7,0,7
980954,1,12,4,4,0,4
980962,1,12,4,14,0,14
980974,1,12,4,6,0,6
980994,1,12,4,5,0,5
1082594,1,12,4,13,0,13
1082603,1,12,4,12,0,12
1082607,1,12,4,13,0,13
1082618,1,12,4,6,0,6
1082620,1,12,4,4,1,5
1082624,1,12,4,6,0,6
1082634,1,12,4,7,0,7
1082647,1,12,4,5,0,5
980906,2,12,4,5,0,5
980936,2,12,4,5,0,5
980948,2,12,4,9,2,11
980970,2,12,4,12,0,12
980984,2,12,4,10,0,10
981002,2,12,4,1,1,2
981010,2,12,4,6,1,7
1082592,2,12,4,4,0,4
1082599,2,12,4,7,0,7
1082615,2,12,4,9,0,9
1082629,2,12,4,7,0,7
1082631,2,12,4,12,5,17
1082642,2,12,4,14,0,14
1082645,2,12,4,12,0,12
1082650,2,12,4,2,0,2
980934,1,13,4,2,0,2
980950,1,13,4,9,0,9
980966,1,13,4,6,1,7
980972,1,13,4,8,0,8
981018,1,13,4,1,0,1
981022,1,13,4,4,0,4
1082593,1,13,4,7,0,7
1082596,1,13,4,6,1,7
1082606,1,13,4,3,0,3
1082625,1,13,4,10,0,10
1082629,1,13,4,11,0,11
1082632,1,13,4,15,0,15
1082640,1,13,4,10,0,10
1082643,1,13,4,1,1,2
980910,2,13,4,13,0,13
980916,2,13,4,11,0,11
980922,2,13,4,8,1,9
980942,2,13,4,10,0,10
980954,2,13,4,14,1,15
980960,2,13,4,6,0,6
980980,2,13,4,6,5,11
980992,2,13,4,10,1,11
981006,2,13,4,11,0,11
981012,2,13,4,7,0,7
1082603,2,13,4,10,1,11
1082610,2,13,4,13,1,14
1082613,2,13,4,15,1,16
1082616,2,13,4,11,0,11
1082621,2,13,4,1,3,4
1082637,2,13,4,13,0,13
335987,1,1,5,10,0,10
335998,1,1,5,12,0,12
336002,1,1,5,5,0,5
336015,1,1,5,11,0,11
336019,1,1,5,5,0,5
336022,1,1,5,6,0,6
336026,1,1,5,1,0,1
336030,1,1,5,9,0,9
336032,1,1,5,10,0,10
392189,1,1,5,1,2,3
392204,1,1,5,7,0,7
392212,1,1,5,8,0,8
392216,1,1,5,6,0,6
392224,1,1,5,9,0,9
392226,1,1,5,10,0,10
392233,1,1,5,4,0,4
419111,1,1,5,7,2,9
419127,1,1,5,5,0,5
419132,1,1,5,11,1,12
419140,1,1,5,6,5,11
419144,1,1,5,15,0,15
419149,1,1,5,1,2,3
419153,1,1,5,21,0,21
419158,1,1,5,2,1,3
501208,1,1,5,7,1,8
501227,1,1,5,1,0,1
501235,1,1,5,6,0,6
501244,1,1,5,8,0,8
501260,1,1,5,4,0,4
501272,1,1,5,14,0,14
501274,1,1,5,3,0,3
548312,1,1,5,3,0,3
548320,1,1,5,12,0,12
548349,1,1,5,7,0,7
548358,1,1,5,13,4,17
548373,1,1,5,7,0,7
548375,1,1,5,3,0,3
548380,1,1,5,1,0,1
548383,1,1,5,8,0,8
598013,1,1,5,6,0,6
598018,1,1,5,10,1,11
598027,1,1,5,11,0,11
598034,1,1,5,6,0,6
598045,1,1,5,8,1,9
598058,1,1,5,9,0,9
598074,1,1,5,7,0,7
729284,1,1,5,6,2,8
729294,1,1,5,9,0,9
729304,1,1,5,9,1,10
734032,1,1,5,6,1,7
734048,1,1,5,11,0,11
829718,1,1,5,6,0,6
829766,1,1,5,2,0,2
829776,1,1,5,10,0,10
829786,1,1,5,9,0,9
980914,1,1,5,12,0,12
980952,1,1,5,9,1,10
980968,1,1,5,2,0,2
980980,1,1,5,0,0,0
981000,1,1,5,9,0,9
981006,1,1,5,2,0,2
981014,1,1,5,7,0,7
1082597,1,1,5,4,0,4
1082604,1,1,5,12,1,13
1082613,1,1,5,10,0,10
1082617,1,1,5,4,0,4
1082631,1,1,5,8,0,8
1082649,1,1,5,2,1,3
335991,2,1,5,2,0,2
336005,2,1,5,5,0,5
336008,2,1,5,4,0,4
336040,2,1,5,10,1,11
392191,2,1,5,16,1,17
392195,2,1,5,2,1,3
392202,2,1,5,15,0,15
392208,2,1,5,6,0,6
392236,2,1,5,1,0,1
392238,2,1,5,0,1,1
419114,2,1,5,16,0,16
419118,2,1,5,5,0,5
419123,2,1,5,10,0,10
419136,2,1,5,12,0,12
419163,2,1,5,7,1,8
419166,2,1,5,11,0,11
501203,2,1,5,5,0,5
501214,2,1,5,13,0,13
501219,2,1,5,4,0,4
501224,2,1,5,1,0,1
501239,2,1,5,6,0,6
501247,2,1,5,6,1,7
501250,2,1,5,6,0,6
501267,2,1,5,10,0,10
548317,2,1,5,10,0,10
548325,2,1,5,3,1,4
548328,2,1,5,5,3,8
548333,2,1,5,14,1,15
548340,2,1,5,5,1,6
548352,2,1,5,10,0,10
548362,2,1,5,13,0,13
548368,2,1,5,7,0,7
548386,2,1,5,5,0,5
598003,2,1,5,10,1,11
598010,2,1,5,10,0,10
598021,2,1,5,11,4,15
598036,2,1,5,8,0,8
598039,2,1,5,17,1,18
598048,2,1,5,5,0,5
598055,2,1,5,1,0,1
598062,2,1,5,5,0,5
598066,2,1,5,5,0,5
729312,2,1,5,0,0,0
729320,2,1,5,9,0,9
733976,2,1,5,3,0,3
733984,2,1,5,8,0,8
733990,2,1,5,10,2,12
734002,2,1,5,6,1,7
734014,2,1,5,9,0,9
734020,2,1,5,7,0,7
734028,2,1,5,9,0,9
734042,2,1,5,15,2,17
734054,2,1,5,8,0,8
829710,2,1,5,13,0,13
829728,2,1,5,3,0,3
829738,2,1,5,12,0,12
829744,2,1,5,4,0,4
829748,2,1,5,5,0,5
829770,2,1,5,10,0,10
829796,2,1,5,14,1,15
829810,2,1,5,8,1,9
829816,2,1,5,6,2,8
980908,2,1,5,6,0,6
980920,2,1,5,3,0,3
980930,2,1,5,10,1,11
980944,2,1,5,7,0,7
980956,2,1,5,5,0,5
980964,2,1,5,2,0,2
980994,2,1,5,3,6,9
981020,2,1,5,9,0,9
1082593,2,1,5,7,0,7
1082601,2,1,5,18,0,18
1082608,2,1,5,6,0,6
1082620,2,1,5,10,0,10
1082622,2,1,5,6,0,6
1082627,2,1,5,11,0,11
1082636,2,1,5,24,2,26
1082639,2,1,5,10,0,10
1082644,2,1,5,14,0,14
1082648,2,1,5,5,0,5
335997,1,2,5,13,0,13
336011,1,2,5,4,0,4
336017,1,2,5,7,0,7
336021,1,2,5,12,0,12
336031,1,2,5,5,1,6
336034,1,2,5,6,0,6
336039,1,2,5,6,1,7
392187,1,2,5,3,0,3
392196,1,2,5,8,0,8
392199,1,2,5,7,2,9
392209,1,2,5,0,0,0
392218,1,2,5,7,0,7
392241,1,2,5,6,0,6
419114,1,2,5,2,0,2
419128,1,2,5,8,2,10
419138,1,2,5,4,1,5
419150,1,2,5,13,1,14
501210,1,2,5,1,3,4
501237,1,2,5,3,0,3
501249,1,2,5,9,0,9
501273,1,2,5,8,1,9
501275,1,2,5,10,0,10
548315,1,2,5,2,2,4
548323,1,2,5,14,0,14
548341,1,2,5,0,2,2
548355,1,2,5,1,0,1
548367,1,2,5,11,1,12
548372,1,2,5,16,5,21
548377,1,2,5,8,1,9
598004,1,2,5,12,0,12
598009,1,2,5,10,0,10
598017,1,2,5,9,0,9
598032,1,2,5,28,0,28
598041,1,2,5,3,2,5
598047,1,2,5,3,0,3
598050,1,2,5,4,0,4
598059,1,2,5,9,0,9
598062,1,2,5,2,0,2
598069,1,2,5,18,0,18
598073,1,2,5,20,0,20
729310,1,2,5,4,0,4
729318,1,2,5,8,0,8
734004,1,2,5,7,0,7
734010,1,2,5,5,0,5
734026,1,2,5,3,0,3
734040,1,2,5,3,0,3
829724,1,2,5,10,1,11
829768,1,2,5,14,0,14
829790,1,2,5,6,1,7
829800,1,2,5,8,1,9
829824,1,2,5,9,1,10
829826,1,2,5,2,0,2
980912,1,2,5,16,0,16
980926,1,2,5,15,0,15
980932,1,2,5,9,0,9
980936,1,2,5,8,0,8
980942,1,2,5,11,0,11
980964,1,2,5,5,0,5
980982,1,2,5,5,0,5
980986,1,2,5,2,0,2
980992,1,2,5,11,1,12
981004,1,2,5,18,0,18
1082595,1,2,5,1,1,2
1082598,1,2,5,3,0,3
1082602,1,2,5,6,0,6
1082610,1,2,5,3,0,3
1082621,1,2,5,1,0,1
1082628,1,2,5,9,0,9
1082636,1,2,5,5,0,5
1082646,1,2,5,3,0,3
335987,2,2,5,8,0,8
335990,2,2,5,9,1,10
336001,2,2,5,12,0,12
336003,2,2,5,6,0,6
336007,2,2,5,5,1,6
336015,2,2,5,12,1,13
336028,2,2,5,2,1,3
392190,2,2,5,8,1,9
392193,2,2,5,4,2,6
392204,2,2,5,8,0,8
392213,2,2,5,10,0,10
392223,2,2,5,4,0,4
392226,2,2,5,8,1,9
392229,2,2,5,1,0,1
392237,2,2,5,3,0,3
392243,2,2,5,10,0,10
392244,2,2,5,12,0,12
419117,2,2,5,11,0,11
419120,2,2,5,8,0,8
419124,2,2,5,12,0,12
419133,2,2,5,4,0,4
419141,2,2,5,12,0,12
419145,2,2,5,10,0,10
419153,2,2,5,10,1,11
419156,2,2,5,4,1,5
419159,2,2,5,8,0,8
419162,2,2,5,8,0,8
419167,2,2,5,10,0,10
419169,2,2,5,5,0,5
501205,2,2,5,13,0,13
501213,2,2,5,5,0,5
501216,2,2,5,1,0,1
501227,2,2,5,14,0,14
501232,2,2,5,17,0,17
501252,2,2,5,3,2,5
501257,2,2,5,8,0,8
501260,2,2,5,7,1,8
501265,2,2,5,10,0,10
501271,2,2,5,3,0,3
501276,2,2,5,14,0,14
548320,2,2,5,6,0,6
548329,2,2,5,4,0,4
548332,2,2,5,5,0,5
548336,2,2,5,7,0,7
548349,2,2,5,1,0,1
548361,2,2,5,9,1,10
548365,2,2,5,5,0,5
548381,2,2,5,1,0,1
598013,2,2,5,2,0,2
598022,2,2,5,11,0,11
598028,2,2,5,10,5,15
598038,2,2,5,9,0,9
598053,2,2,5,15,0,15
729286,2,2,5,9,0,9
729292,2,2,5,7,0,7
729304,2,2,5,1,0,1
733982,2,2,5,16,0,16
733988,2,2,5,4,0,4
733996,2,2,5,5,0,5
734018,2,2,5,1,0,1
734032,2,2,5,12,1,13
829718,2,2,5,6,0,6
829742,2,2,5,10,0,10
829750,2,2,5,1,0,1
829754,2,2,5,1,0,1
829762,2,2,5,11,0,11
829776,2,2,5,3,0,3
829784,2,2,5,9,0,9
829808,2,2,5,8,2,10
829812,2,2,5,10,0,10
980958,2,2,5,5,0,5
980974,2,2,5,12,0,12
981000,2,2,5,9,0,9
981016,2,2,5,10,0,10
981018,2,2,5,3,0,3
981024,2,2,5,13,0,13
1082591,2,2,5,4,1,5
1082607,2,2,5,4,0,4
1082617,2,2,5,4,0,4
1082624,2,2,5,2,1,3
1082633,2,2,5,10,0,10
335988,1,3,5,8,1,9
335994,1,3,5,5,0,5
336001,1,3,5,3,0,3
336006,1,3,5,9,0,9
336010,1,3,5,14,0,14
336012,1,3,5,9,1,10
336018,1,3,5,10,1,11
336023,1,3,5,3,0,3
336045,1,3,5,10,0,10
392190,1,3,5,20,0,20
392201,1,3,5,17,0,17
392207,1,3,5,7,0,7
392211,1,3,5,7,1,8
392214,1,3,5,9,2,11
392219,1,3,5,10,0,10
392229,1,3,5,11,0,11
392236,1,3,5,7,0,7
392239,1,3,5,9,0,9
392243,1,3,5,11,0,11
419118,1,3,5,4,0,4
419130,1,3,5,2,0,2
419142,1,3,5,13,0,13
419147,1,3,5,8,0,8
419152,1,3,5,7,0,7
419160,1,3,5,8,3,11
419168,1,3,5,1,3,4
419170,1,3,5,9,0,9
501203,1,3,5,6,0,6
501211,1,3,5,13,1,14
501216,1,3,5,15,0,15
501220,1,3,5,13,0,13
501231,1,3,5,6,0,6
501241,1,3,5,6,0,6
501250,1,3,5,2,1,3
501254,1,3,5,13,0,13
501258,1,3,5,12,0,12
501266,1,3,5,1,0,1
501271,1,3,5,0,0,0
501276,1,3,5,12,0,12
548311,1,3,5,6,0,6
548316,1,3,5,18,0,18
548321,1,3,5,6,1,7
548327,1,3,5,8,0,8
548335,1,3,5,11,0,11
548352,1,3,5,6,0,6
548357,1,3,5,21,0,21
548360,1,3,5,23,1,24
548376,1,3,5,6,0,6
548384,1,3,5,8,0,8
548385,1,3,5,8,0,8
548386,1,3,5,4,0,4
598025,1,3,5,9,0,9
598039,1,3,5,9,0,9
598043,1,3,5,16,0,16
598046,1,3,5,5,0,5
598056,1,3,5,18,0,18
598063,1,3,5,4,0,4
598067,1,3,5,10,0,10
598075,1,3,5,9,1,10
729288,1,3,5,17,1,18
729298,1,3,5,5,0,5
729302,1,3,5,12,0,12
733976,1,3,5,4,0,4
734018,1,3,5,4,0,4
734028,1,3,5,6,0,6
734034,1,3,5,5,0,5
829712,1,3,5,11,0,11
829716,1,3,5,5,2,7
829728,1,3,5,12,0,12
829740,1,3,5,8,0,8
829750,1,3,5,8,1,9
829758,1,3,5,4,0,4
829770,1,3,5,10,0,10
829784,1,3,5,7,0,7
829794,1,3,5,14,0,14
829802,1,3,5,6,0,6
829806,1,3,5,5,0,5
335998,2,3,5,10,0,10
336014,2,3,5,7,1,8
336030,2,3,5,6,0,6
336034,2,3,5,2,0,2
336038,2,3,5,15,0,15
336042,2,3,5,5,1,6
336044,2,3,5,5,0,5
392186,2,3,5,13,1,14
392194,2,3,5,12,0,12
392207,2,3,5,8,0,8
392222,2,3,5,1,1,2
392232,2,3,5,10,0,10
419115,2,3,5,0,0,0
419121,2,3,5,18,0,18
419126,2,3,5,8,1,9
419128,2,3,5,1,0,1
419134,2,3,5,24,0,24
419138,2,3,5,5,1,6
419158,2,3,5,15,0,15
419164,2,3,5,10,1,11
501226,2,3,5,3,0,3
501233,2,3,5,0,0,0
501245,2,3,5,11,2,13
501273,2,3,5,8,0,8
548323,2,3,5,7,0,7
548337,2,3,5,11,0,11
548348,2,3,5,14,0,14
548366,2,3,5,2,0,2
548369,2,3,5,13,0,13
548373,2,3,5,12,0,12
598007,2,3,5,2,0,2
598012,2,3,5,7,0,7
598017,2,3,5,6,1,7
598020,2,3,5,3,0,3
598027,2,3,5,4,0,4
598031,2,3,5,7,0,7
598035,2,3,5,4,0,4
598051,2,3,5,3,0,3
598073,2,3,5,8,0,8
598078,2,3,5,7,0,7
729308,2,3,5,3,2,5
729316,2,3,5,11,0,11
733986,2,3,5,6,0,6
733992,2,3,5,13,0,13
734000,2,3,5,5,0,5
734008,2,3,5,2,0,2
734040,2,3,5,6,0,6
734050,2,3,5,5,0,5
734052,2,3,5,8,3,11
829734,2,3,5,21,1,22
829778,2,3,5,11,0,11
829814,2,3,5,12,0,12
829822,2,3,5,13,0,13
829826,2,3,5,5,0,5
829828,2,3,5,5,0,5
335992,1,4,5,14,0,14
335996,1,4,5,17,1,18
336008,1,4,5,11,1,12
336024,1,4,5,6,0,6
336033,1,4,5,10,0,10
336040,1,4,5,10,0,10
336044,1,4,5,2,0,2
392188,1,4,5,10,1,11
392191,1,4,5,14,0,14
392200,1,4,5,5,2,7
392205,1,4,5,4,1,5
392227,1,4,5,12,0,12
392234,1,4,5,7,0,7
419113,1,4,5,6,0,6
419117,1,4,5,7,2,9
419126,1,4,5,9,0,9
419137,1,4,5,3,4,7
419141,1,4,5,6,0,6
419148,1,4,5,12,0,12
419161,1,4,5,10,0,10
419164,1,4,5,7,0,7
501207,1,4,5,5,4,9
501225,1,4,5,6,0,6
501239,1,4,5,6,2,8
501253,1,4,5,4,0,4
501256,1,4,5,8,0,8
501262,1,4,5,8,2,10
501265,1,4,5,4,0,4
548328,1,4,5,3,0,3
548333,1,4,5,5,0,5
548336,1,4,5,7,0,7
548344,1,4,5,8,1,9
548348,1,4,5,8,0,8
548364,1,4,5,3,1,4
548374,1,4,5,12,0,12
548379,1,4,5,1,0,1
598012,1,4,5,7,0,7
598019,1,4,5,11,0,11
598021,1,4,5,4,0,4
598026,1,4,5,12,0,12
598033,1,4,5,2,0,2
598036,1,4,5,10,0,10
598057,1,4,5,4,0,4
598071,1,4,5,5,1,6
729300,1,4,5,12,0,12
729312,1,4,5,6,3,9
733978,1,4,5,2,0,2
733992,1,4,5,4,1,5
733996,1,4,5,9,1,10
734002,1,4,5,12,1,13
734030,1,4,5,1,0,1
734038,1,4,5,9,0,9
734052,1,4,5,13,1,14
734054,1,4,5,6,0,6
829722,1,4,5,8,0,8
829730,1,4,5,9,0,9
829738,1,4,5,14,0,14
829772,1,4,5,5,0,5
829796,1,4,5,9,0,9
829808,1,4,5,7,0,7
829814,1,4,5,4,0,4
980910,1,4,5,14,0,14
980918,1,4,5,6,0,6
980930,1,4,5,9,0,9
980940,1,4,5,14,0,14
980960,1,4,5,15,2,17
980976,1,4,5,4,0,4
980996,1,4,5,4,0,4
981010,1,4,5,12,3,15
1082601,1,4,5,1,7,8
1082612,1,4,5,7,0,7
1082616,1,4,5,10,1,11
1082633,1,4,5,10,0,10
1082637,1,4,5,8,0,8
1082639,1,4,5,10,1,11
1082641,1,4,5,9,0,9
1082645,1,4,5,6,0,6
335988,2,4,5,10,0,10
336000,2,4,5,9,0,9
336004,2,4,5,4,0,4
336011,2,4,5,12,0,12
336018,2,4,5,2,0,2
336021,2,4,5,8,0,8
336027,2,4,5,21,1,22
336036,2,4,5,13,0,13
392196,2,4,5,5,5,10
392209,2,4,5,7,0,7
392212,2,4,5,9,0,9
392215,2,4,5,9,0,9
392219,2,4,5,19,0,19
392221,2,4,5,1,1,2
392231,2,4,5,0,0,0
392239,2,4,5,1,0,1
419122,2,4,5,4,0,4
419129,2,4,5,18,0,18
419132,2,4,5,7,1,8
419144,2,4,5,8,0,8
419151,2,4,5,5,0,5
419154,2,4,5,6,0,6
501211,2,4,5,11,0,11
501217,2,4,5,22,1,23
501228,2,4,5,8,1,9
501242,2,4,5,2,1,3
501249,2,4,5,6,0,6
501259,2,4,5,4,0,4
501269,2,4,5,10,1,11
548314,2,4,5,4,1,5
548318,2,4,5,2,0,2
548324,2,4,5,8,0,8
548339,2,4,5,10,0,10
548355,2,4,5,9,0,9
548359,2,4,5,4,1,5
548371,2,4,5,3,1,4
548376,2,4,5,2,0,2
598008,2,4,5,10,0,10
598030,2,4,5,7,1,8
598042,2,4,5,15,0,15
598046,2,4,5,3,1,4
598050,2,4,5,6,0,6
598061,2,4,5,7,0,7
598064,2,4,5,6,0,6
598069,2,4,5,10,0,10
729288,2,4,5,12,0,12
729296,2,4,5,13,0,13
729318,2,4,5,9,0,9
734012,2,4,5,11,0,11
734024,2,4,5,8,1,9
734044,2,4,5,12,1,13
734048,2,4,5,15,0,15
829714,2,4,5,7,0,7
829746,2,4,5,8,0,8
829758,2,4,5,7,0,7
829764,2,4,5,4,0,4
829780,2,4,5,9,0,9
829790,2,4,5,4,0,4
829804,2,4,5,5,0,5
980924,2,4,5,13,0,13
980946,2,4,5,5,0,5
980968,2,4,5,11,0,11
980982,2,4,5,6,1,7
980990,2,4,5,5,0,5
981004,2,4,5,8,2,10
1082594,2,4,5,10,0,10
1082598,2,4,5,7,0,7
1082605,2,4,5,7,0,7
1082609,2,4,5,10,0,10
1082623,2,4,5,5,0,5
1082626,2,4,5,11,0,11
335989,1,5,5,6,0,6
336005,1,5,5,12,0,12
336013,1,5,5,5,0,5
336028,1,5,5,9,0,9
336038,1,5,5,13,0,13
336043,1,5,5,14,0,14
392195,1,5,5,9,0,9
392215,1,5,5,7,0,7
392222,1,5,5,3,0,3
392230,1,5,5,12,0,12
392238,1,5,5,6,0,6
419116,1,5,5,14,0,14
419120,1,5,5,7,0,7
419123,1,5,5,6,0,6
419129,1,5,5,12,0,12
419134,1,5,5,2,0,2
419146,1,5,5,3,0,3
419159,1,5,5,3,0,3
419163,1,5,5,8,0,8
501214,1,5,5,3,1,4
501219,1,5,5,2,0,2
501245,1,5,5,14,0,14
501257,1,5,5,7,0,7
501263,1,5,5,1,0,1
548314,1,5,5,6,0,6
548317,1,5,5,7,0,7
548325,1,5,5,10,0,10
548329,1,5,5,8,0,8
548337,1,5,5,2,0,2
548354,1,5,5,12,0,12
548359,1,5,5,14,1,15
548366,1,5,5,5,0,5
548370,1,5,5,5,0,5
548378,1,5,5,12,0,12
548382,1,5,5,5,0,5
598006,1,5,5,4,0,4
598010,1,5,5,6,0,6
598014,1,5,5,10,0,10
598024,1,5,5,12,1,13
598028,1,5,5,11,0,11
598031,1,5,5,15,1,16
598048,1,5,5,2,0,2
598077,1,5,5,9,1,10
729296,1,5,5,8,1,9
729320,1,5,5,2,0,2
733984,1,5,5,10,1,11
734008,1,5,5,1,0,1
734016,1,5,5,16,0,16
734046,1,5,5,9,1,10
829714,1,5,5,3,0,3
829746,1,5,5,1,2,3
829754,1,5,5,6,0,6
829782,1,5,5,13,0,13
829816,1,5,5,9,0,9
335992,2,5,5,5,1,6
335995,2,5,5,22,0,22
335997,2,5,5,7,1,8
336010,2,5,5,10,0,10
336016,2,5,5,5,0,5
336020,2,5,5,1,0,1
336024,2,5,5,1,0,1
336032,2,5,5,16,0,16
336041,2,5,5,8,1,9
336045,2,5,5,9,0,9
392187,2,5,5,3,1,4
392200,2,5,5,4,0,4
392203,2,5,5,10,0,10
392207,2,5,5,2,0,2
392210,2,5,5,13,0,13
392218,2,5,5,10,0,10
392225,2,5,5,5,0,5
392235,2,5,5,4,1,5
419112,2,5,5,4,0,4
419131,2,5,5,12,0,12
419139,2,5,5,2,0,2
419142,2,5,5,18,0,18
419148,2,5,5,9,1,10
419155,2,5,5,3,0,3
501204,2,5,5,1,1,2
501209,2,5,5,2,0,2
501225,2,5,5,6,1,7
501230,2,5,5,6,0,6
501236,2,5,5,0,0,0
501240,2,5,5,0,0,0
501254,2,5,5,10,0,10
501268,2,5,5,5,0,5
548322,2,5,5,12,0,12
548331,2,5,5,10,1,11
548341,2,5,5,4,0,4
548350,2,5,5,5,1,6
548363,2,5,5,12,0,12
598019,2,5,5,9,0,9
598037,2,5,5,7,1,8
598041,2,5,5,3,1,4
598052,2,5,5,7,0,7
598054,2,5,5,9,0,9
598057,2,5,5,11,0,11
598063,2,5,5,1,0,1
598068,2,5,5,5,0,5
598070,2,5,5,13,0,13
598076,2,5,5,3,0,3
729290,2,5,5,8,1,9
729302,2,5,5,14,0,14
729310,2,5,5,3,1,4
733980,2,5,5,4,0,4
733994,2,5,5,4,1,5
734004,2,5,5,6,1,7
734022,2,5,5,3,0,3
734038,2,5,5,3,0,3
829720,2,5,5,2,0,2
829726,2,5,5,9,0,9
829732,2,5,5,4,1,5
829740,2,5,5,10,0,10
829774,2,5,5,10,0,10
829792,2,5,5,5,0,5
829802,2,5,5,11,0,11
829824,2,5,5,4,0,4
336000,1,6,5,11,0,11
336003,1,6,5,8,0,8
336014,1,6,5,6,0,6
336020,1,6,5,8,2,10
336025,1,6,5,6,0,6
336027,1,6,5,12,1,13
392194,1,6,5,17,0,17
392203,1,6,5,5,0,5
392228,1,6,5,4,2,6
392231,1,6,5,0,5,5
392235,1,6,5,7,0,7
392237,1,6,5,12,0,12
392242,1,6,5,7,1,8
419121,1,6,5,13,1,14
419133,1,6,5,10,0,10
419136,1,6,5,11,0,11
419139,1,6,5,12,1,13
419145,1,6,5,12,1,13
419154,1,6,5,3,0,3
501206,1,6,5,4,0,4
501209,1,6,5,6,1,7
501228,1,6,5,16,1,17
501232,1,6,5,5,0,5
501238,1,6,5,12,0,12
501243,1,6,5,11,0,11
501270,1,6,5,1,1,2
548347,1,6,5,6,0,6
548350,1,6,5,9,2,11
548362,1,6,5,2,0,2
548369,1,6,5,2,1,3
598003,1,6,5,7,0,7
598015,1,6,5,3,0,3
598022,1,6,5,7,1,8
598040,1,6,5,4,0,4
598049,1,6,5,3,0,3
598054,1,6,5,17,0,17
598064,1,6,5,10,0,10
729286,1,6,5,0,0,0
733980,1,6,5,2,0,2
733986,1,6,5,3,0,3
733990,1,6,5,6,0,6
733998,1,6,5,13,1,14
734024,1,6,5,9,1,10
734044,1,6,5,13,0,13
829720,1,6,5,2,0,2
829736,1,6,5,1,1,2
829744,1,6,5,4,0,4
829752,1,6,5,8,0,8
829762,1,6,5,4,0,4
829788,1,6,5,14,0,14
829818,1,6,5,8,0,8
980908,1,6,5,8,1,9
980938,1,6,5,7,0,7
980956,1,6,5,2,0,2
980970,1,6,5,12,1,13
981002,1,6,5,10,0,10
981016,1,6,5,8,0,8
1082599,1,6,5,8,0,8
1082605,1,6,5,13,1,14
1082608,1,6,5,9,0,9
1082622,1,6,5,2,5,7
1082626,1,6,5,9,0,9
1082642,1,6,5,13,1,14
335989,2,6,5,12,0,12
335993,2,6,5,5,0,5
336006,2,6,5,11,0,11
336009,2,6,5,7,0,7
336022,2,6,5,4,0,4
336031,2,6,5,14,1,15
336037,2,6,5,12,0,12
336043,2,6,5,1,0,1
392188,2,6,5,11,1,12
392199,2,6,5,8,0,8
392206,2,6,5,4,0,4
392211,2,6,5,16,0,16
392216,2,6,5,11,0,11
392220,2,6,5,9,1,10
392224,2,6,5,15,0,15
392240,2,6,5,5,0,5
419113,2,6,5,1,2,3
419116,2,6,5,2,2,4
419119,2,6,5,4,0,4
419125,2,6,5,6,0,6
419149,2,6,5,15,1,16
419157,2,6,5,10,1,11
419160,2,6,5,4,4,8
419165,2,6,5,4,0,4
501218,2,6,5,17,0,17
501221,2,6,5,5,0,5
501235,2,6,5,6,0,6
501248,2,6,5,4,4,8
501251,2,6,5,1,0,1
501258,2,6,5,6,0,6
501262,2,6,5,7,0,7
548312,2,6,5,4,1,5
548315,2,6,5,8,0,8
548321,2,6,5,11,0,11
548326,2,6,5,6,1,7
548330,2,6,5,12,0,12
548334,2,6,5,2,0,2
548338,2,6,5,13,0,13
548342,2,6,5,12,0,12
548354,2,6,5,12,4,16
548374,2,6,5,4,0,4
548377,2,6,5,8,0,8
548379,2,6,5,6,0,6
548383,2,6,5,6,1,7
548385,2,6,5,7,1,8
598006,2,6,5,10,0,10
598011,2,6,5,15,0,15
598025,2,6,5,4,0,4
598029,2,6,5,17,0,17
598033,2,6,5,2,0,2
598045,2,6,5,5,0,5
598059,2,6,5,17,0,17
598067,2,6,5,6,0,6
598072,2,6,5,2,1,3
729294,2,6,5,4,0,4
729298,2,6,5,1,0,1
729306,2,6,5,8,0,8
729314,2,6,5,1,2,3
734010,2,6,5,5,5,10
734016,2,6,5,0,1,1
734036,2,6,5,10,0,10
829712,2,6,5,6,0,6
829730,2,6,5,9,0,9
829766,2,6,5,10,0,10
829772,2,6,5,7,0,7
829782,2,6,5,6,3,9
829798,2,6,5,12,1,13
829806,2,6,5,0,0,0
980918,2,6,5,7,1,8
980926,2,6,5,8,0,8
980950,2,6,5,3,0,3
980966,2,6,5,10,0,10
980976,2,6,5,11,1,12
980988,2,6,5,9,0,9
980998,2,6,5,7,0,7
981008,2,6,5,13,1,14
1082595,2,6,5,5,0,5
1082611,2,6,5,15,0,15
1082614,2,6,5,0,0,0
1082630,2,6,5,6,0,6
1082632,2,6,5,17,0,17
1082635,2,6,5,5,0,5
1082640,2,6,5,15,0,15
1082646,2,6,5,14,1,15
335990,1,7,5,18,1,19
335999,1,7,5,3,1,4
336009,1,7,5,9,0,9
336029,1,7,5,4,0,4
336037,1,7,5,3,0,3
336041,1,7,5,11,1,12
392186,1,7,5,8,0,8
392202,1,7,5,7,0,7
392208,1,7,5,7,0,7
392213,1,7,5,2,0,2
392220,1,7,5,9,0,9
392223,1,7,5,11,2,13
392232,1,7,5,16,2,18
392240,1,7,5,0,1,1
419112,1,7,5,8,3,11
419119,1,7,5,10,0,10
419124,1,7,5,5,0,5
419135,1,7,5,12,0,12
419143,1,7,5,8,0,8
419151,1,7,5,14,0,14
419155,1,7,5,6,1,7
419157,1,7,5,5,0,5
419162,1,7,5,6,2,8
419166,1,7,5,7,0,7
419167,1,7,5,7,1,8
501215,1,7,5,3,1,4
501226,1,7,5,10,0,10
501229,1,7,5,11,0,11
501236,1,7,5,1,0,1
501242,1,7,5,5,0,5
501246,1,7,5,11,0,11
501251,1,7,5,9,0,9
501268,1,7,5,3,0,3
548322,1,7,5,11,0,11
548330,1,7,5,9,0,9
548339,1,7,5,6,0,6
548356,1,7,5,3,1,4
548365,1,7,5,3,4,7
548368,1,7,5,14,0,14
598007,1,7,5,5,0,5
598011,1,7,5,1,1,2
598016,1,7,5,2,0,2
598029,1,7,5,6,0,6
598038,1,7,5,7,0,7
598042,1,7,5,11,1,12
598044,1,7,5,0,1,1
598051,1,7,5,5,1,6
598055,1,7,5,3,2,5
598068,1,7,5,8,0,8
598078,1,7,5,7,0,7
729292,1,7,5,9,1,10
729308,1,7,5,1,0,1
729314,1,7,5,10,0,10
733988,1,7,5,7,2,9
734000,1,7,5,14,0,14
734014,1,7,5,3,0,3
734022,1,7,5,13,0,13
734036,1,7,5,13,5,18
734050,1,7,5,10,1,11
829710,1,7,5,8,1,9
829726,1,7,5,1,0,1
829734,1,7,5,7,0,7
829742,1,7,5,9,0,9
829756,1,7,5,5,1,6
829774,1,7,5,5,0,5
829780,1,7,5,18,0,18
829810,1,7,5,9,0,9
829822,1,7,5,13,0,13
829828,1,7,5,6,1,7
980906,1,7,5,1,0,1
980922,1,7,5,5,2,7
980928,1,7,5,8,0,8
980946,1,7,5,7,0,7
980990,1,7,5,2,0,2
980998,1,7,5,2,0,2
981012,1,7,5,8,0,8
1082592,1,7,5,7,0,7
1082614,1,7,5,10,0,10
1082635,1,7,5,10,0,10
1082638,1,7,5,7,0,7
1082644,1,7,5,5,2,7
1082650,1,7,5,4,1,5
335994,2,7,5,19,0,19
335996,2,7,5,13,0,13
336002,2,7,5,4,0,4
336013,2,7,5,8,0,8
336017,2,7,5,8,6,14
336023,2,7,5,19,1,20
336026,2,7,5,3,2,5
336033,2,7,5,16,0,16
392197,2,7,5,19,0,19
392202,2,7,5,0,0,0
392205,2,7,5,0,1,1
392217,2,7,5,7,0,7
392227,2,7,5,21,0,21
392230,2,7,5,3,1,4
419119,2,7,5,2,0,2
419127,2,7,5,6,0,6
419130,2,7,5,14,2,16
419137,2,7,5,8,0,8
419147,2,7,5,7,0,7
419170,2,7,5,10,0,10
501206,2,7,5,2,1,3
501210,2,7,5,0,0,0
501223,2,7,5,7,0,7
501256,2,7,5,1,0,1
501261,2,7,5,5,0,5
501272,2,7,5,3,0,3
501274,2,7,5,16,1,17
501275,2,7,5,13,0,13
548311,2,7,5,3,0,3
548313,2,7,5,9,1,10
548319,2,7,5,5,0,5
548344,2,7,5,3,0,3
548347,2,7,5,6,0,6
548351,2,7,5,7,1,8
548360,2,7,5,12,0,12
548372,2,7,5,3,1,4
548375,2,7,5,6,0,6
548382,2,7,5,11,1,12
548384,2,7,5,6,0,6
598004,2,7,5,4,0,4
598024,2,7,5,6,2,8
598034,2,7,5,2,0,2
598060,2,7,5,2,0,2
598065,2,7,5,5,0,5
598071,2,7,5,7,3,10
598075,2,7,5,13,0,13
598077,2,7,5,4,0,4
729284,2,7,5,8,0,8
729322,2,7,5,11,0,11
733978,2,7,5,12,0,12
734006,2,7,5,16,0,16
734030,2,7,5,10,0,10
734046,2,7,5,7,1,8
829722,2,7,5,0,1,1
829752,2,7,5,3,0,3
829788,2,7,5,11,0,11
829794,2,7,5,15,0,15
829800,2,7,5,5,1,6
829820,2,7,5,5,1,6
980914,2,7,5,12,1,13
980932,2,7,5,18,1,19
980938,2,7,5,2,0,2
980952,2,7,5,8,0,8
980962,2,7,5,4,0,4
980978,2,7,5,1,0,1
980986,2,7,5,7,0,7
1082597,2,7,5,7,0,7
1082600,2,7,5,3,0,3
1082602,2,7,5,8,0,8
1082606,2,7,5,15,0,15
1082612,2,7,5,17,0,17
1082618,2,7,5,0,0,0
1082625,2,7,5,9,0,9
1082628,2,7,5,10,1,11
1082641,2,7,5,14,1,15
1082647,2,7,5,12,0,12
1082649,2,7,5,2,0,2
335991,1,8,5,2,0,2
335993,1,8,5,7,0,7
335995,1,8,5,15,0,15
336004,1,8,5,7,1,8
336007,1,8,5,11,1,12
336016,1,8,5,12,0,12
336036,1,8,5,4,0,4
336042,1,8,5,3,0,3
392193,1,8,5,2,0,2
392197,1,8,5,7,1,8
392206,1,8,5,4,0,4
392210,1,8,5,1,0,1
392217,1,8,5,14,1,15
392221,1,8,5,13,0,13
392225,1,8,5,4,0,4
392244,1,8,5,5,0,5
419115,1,8,5,6,2,8
419122,1,8,5,7,0,7
419125,1,8,5,10,0,10
419131,1,8,5,6,2,8
419156,1,8,5,6,2,8
419165,1,8,5,2,0,2
419169,1,8,5,4,1,5
501204,1,8,5,10,0,10
501213,1,8,5,7,1,8
501217,1,8,5,10,0,10
501221,1,8,5,4,2,6
501234,1,8,5,2,0,2
501248,1,8,5,6,0,6
501255,1,8,5,10,0,10
501261,1,8,5,9,0,9
501269,1,8,5,12,1,13
548319,1,8,5,9,0,9
548326,1,8,5,9,0,9
548331,1,8,5,10,0,10
548334,1,8,5,4,0,4
548340,1,8,5,4,1,5
548346,1,8,5,8,1,9
548351,1,8,5,7,0,7
548353,1,8,5,5,0,5
548361,1,8,5,8,0,8
548371,1,8,5,7,1,8
548381,1,8,5,1,0,1
335999,2,8,5,10,0,10
336012,2,8,5,6,0,6
336019,2,8,5,14,0,14
336025,2,8,5,17,0,17
336029,2,8,5,2,1,3
336039,2,8,5,5,0,5
392189,2,8,5,5,0,5
392201,2,8,5,6,0,6
392214,2,8,5,17,2,19
392228,2,8,5,0,0,0
392233,2,8,5,1,0,1
392234,2,8,5,6,0,6
392241,2,8,5,21,1,22
392242,2,8,5,3,0,3
419111,2,8,5,16,0,16
419135,2,8,5,13,0,13
419140,2,8,5,5,0,5
419143,2,8,5,6,0,6
419146,2,8,5,17,1,18
419150,2,8,5,7,1,8
419152,2,8,5,3,0,3
419161,2,8,5,3,1,4
419168,2,8,5,2,0,2
501208,2,8,5,6,0,6
501229,2,8,5,8,0,8
501241,2,8,5,12,1,13
501244,2,8,5,7,0,7
501264,2,8,5,10,0,10
548316,2,8,5,3,0,3
548357,2,8,5,15,0,15
548364,2,8,5,10,0,10
548378,2,8,5,10,0,10
501205,1,9,5,8,0,8
501212,1,9,5,2,0,2
501224,1,9,5,5,0,5
501230,1,9,5,1,0,1
501247,1,9,5,7,0,7
501252,1,9,5,11,1,12
501259,1,9,5,11,0,11
501215,2,9,5,2,0,2
501220,2,9,5,11,0,11
501234,2,9,5,10,2,12
501238,2,9,5,2,0,2
501243,2,9,5,8,0,8
501263,2,9,5,14,0,14
501266,2,9,5,2,0,2
501218,1,10,5,12,2,14
501223,1,10,5,6,0,6
501233,1,10,5,5,0,5
501240,1,10,5,10,0,10
501264,1,10,5,4,0,4
501267,1,10,5,7,0,7
548313,1,10,5,7,0,7
548318,1,10,5,6,2,8
548324,1,10,5,0,1,1
548332,1,10,5,11,0,11
548338,1,10,5,7,0,7
548342,1,10,5,4,0,4
548363,1,10,5,5,1,6
598008,1,10,5,3,0,3
598020,1,10,5,10,0,10
598030,1,10,5,10,0,10
598052,1,10,5,7,0,7
598060,1,10,5,10,1,11
598066,1,10,5,5,0,5
598072,1,10,5,5,0,5
501207,2,10,5,5,0,5
501212,2,10,5,6,0,6
501231,2,10,5,11,2,13
501237,2,10,5,4,1,5
501246,2,10,5,6,0,6
501253,2,10,5,2,0,2
501255,2,10,5,5,0,5
548327,2,10,5,5,0,5
548335,2,10,5,9,0,9
548346,2,10,5,7,2,9
548353,2,10,5,1,1,2
548356,2,10,5,11,0,11
548358,2,10,5,7,0,7
548367,2,10,5,12,0,12
548370,2,10,5,1,0,1
548380,2,10,5,11,3,14
598005,2,10,5,5,0,5
598014,2,10,5,6,1,7
598016,2,10,5,7,1,8
598023,2,10,5,1,0,1
598032,2,10,5,9,1,10
598040,2,10,5,11,1,12
598043,2,10,5,6,0,6
598047,2,10,5,10,0,10
598058,2,10,5,3,1,4
598005,1,11,5,11,0,11
598023,1,11,5,0,1,1
598035,1,11,5,9,0,9
598037,1,11,5,4,0,4
598053,1,11,5,7,0,7
598061,1,11,5,1,0,1
598065,1,11,5,5,0,5
598070,1,11,5,8,1,9
598076,1,11,5,9,0,9
729290,1,11,5,8,1,9
729306,1,11,5,15,0,15
729316,1,11,5,5,0,5
729322,1,11,5,7,0,7
733982,1,11,5,7,2,9
733994,1,11,5,9,0,9
734006,1,11,5,7,0,7
734012,1,11,5,24,2,26
734020,1,11,5,10,2,12
734042,1,11,5,0,4,4
829732,1,11,5,9,1,10
829748,1,11,5,5,1,6
829764,1,11,5,16,0,16
829778,1,11,5,15,0,15
829792,1,11,5,9,0,9
829798,1,11,5,1,0,1
829804,1,11,5,7,0,7
829812,1,11,5,17,0,17
829820,1,11,5,8,0,8
980920,1,11,5,4,0,4
980948,1,11,5,7,0,7
980958,1,11,5,5,0,5
980978,1,11,5,6,0,6
980984,1,11,5,1,1,2
980988,1,11,5,16,1,17
981008,1,11,5,10,0,10
981020,1,11,5,10,0,10
981024,1,11,5,19,0,19
1082591,1,11,5,9,0,9
1082600,1,11,5,9,0,9
1082609,1,11,5,4,0,4
1082611,1,11,5,3,0,3
1082615,1,11,5,6,0,6
1082623,1,11,5,17,0,17
1082627,1,11,5,14,1,15
1082630,1,11,5,9,0,9
1082648,1,11,5,2,0,2
598009,2,11,5,8,3,11
598015,2,11,5,10,0,10
598018,2,11,5,4,0,4
598026,2,11,5,9,0,9
598044,2,11,5,5,0,5
598049,2,11,5,3,0,3
598056,2,11,5,16,1,17
598074,2,11,5,5,0,5
729300,2,11,5,1,1,2
733998,2,11,5,7,0,7
734026,2,11,5,5,0,5
734034,2,11,5,4,0,4
829716,2,11,5,5,0,5
829724,2,11,5,15,0,15
829736,2,11,5,12,0,12
829756,2,11,5,6,0,6
829786,2,11,5,3,0,3
980912,2,11,5,11,0,11
980928,2,11,5,4,0,4
980934,2,11,5,5,0,5
980940,2,11,5,11,0,11
980972,2,11,5,2,0,2
980996,2,11,5,13,0,13
981014,2,11,5,9,1,10
981022,2,11,5,10,0,10
1082596,2,11,5,8,0,8
1082604,2,11,5,7,0,7
1082634,2,11,5,8,0,8
1082638,2,11,5,11,0,11
1082643,2,11,5,5,1,6
980916,1,12,5,12,1,13
980924,1,12,5,10,1,11
980944,1,12,5,4,0,4
980954,1,12,5,13,0,13
980962,1,12,5,8,0,8
980974,1,12,5,11,0,11
980994,1,12,5,3,0,3
1082594,1,12,5,12,0,12
1082603,1,12,5,25,0,25
1082607,1,12,5,9,0,9
1082618,1,12,5,5,1,6
1082620,1,12,5,12,0,12
1082624,1,12,5,7,0,7
1082634,1,12,5,5,0,5
1082647,1,12,5,7,0,7
980906,2,12,5,14,0,14
980936,2,12,5,8,1,9
980948,2,12,5,6,5,11
980970,2,12,5,10,0,10
980984,2,12,5,1,0,1
981002,2,12,5,1,0,1
981010,2,12,5,1,0,1
1082592,2,12,5,4,0,4
1082599,2,12,5,7,0,7
1082615,2,12,5,13,0,13
1082629,2,12,5,13,0,13
1082631,2,12,5,12,0,12
1082642,2,12,5,5,0,5
1082645,2,12,5,6,0,6
1082650,2,12,5,8,1,9
980934,1,13,5,15,0,15
980950,1,13,5,12,0,12
980966,1,13,5,3,0,3
980972,1,13,5,13,0,13
981018,1,13,5,10,0,10
981022,1,13,5,8,1,9
1082593,1,13,5,11,0,11
1082596,1,13,5,3,0,3
1082606,1,13,5,7,0,7
1082625,1,13,5,1,0,1
1082629,1,13,5,11,0,11
1082632,1,13,5,11,0,11
1082640,1,13,5,7,1,8
1082643,1,13,5,13,0,13
980910,2,13,5,7,2,9
980916,2,13,5,4,0,4
980922,2,13,5,6,0,6
980942,2,13,5,6,0,6
980954,2,13,5,14,0,14
980960,2,13,5,10,0,10
980980,2,13,5,2,0,2
980992,2,13,5,11,0,11
981006,2,13,5,6,0,6
981012,2,13,5,18,0,18
1082603,2,13,5,2,0,2
1082610,2,13,5,11,0,11
1082613,2,13,5,6,0,6
1082616,2,13,5,7,0,7
1082621,2,13,5,15,0,15
1082637,2,13,5,11,2,13
335987,1,1,6,1,0,1
335998,1,1,6,11,0,11
336002,1,1,6,2,0,2
336015,1,1,6,5,0,5
336019,1,1,6,10,0,10
336022,1,1,6,5,2,7
336026,1,1,6,4,1,5
336030,1,1,6,7,0,7
336032,1,1,6,8,0,8
392189,1,1,6,5,1,6
392204,1,1,6,1,0,1
392212,1,1,6,5,0,5
392216,1,1,6,6,0,6
392224,1,1,6,11,1,12
392226,1,1,6,11,0,11
392233,1,1,6,2,0,2
419111,1,1,6,7,0,7
419127,1,1,6,5,2,7
419132,1,1,6,4,1,5
419140,1,1,6,6,0,6
419144,1,1,6,7,0,7
419149,1,1,6,9,0,9
419153,1,1,6,9,1,10
419158,1,1,6,1,0,1
501208,1,1,6,11,1,12
501227,1,1,6,5,1,6
501235,1,1,6,8,0,8
501244,1,1,6,5,1,6
501260,1,1,6,7,0,7
501272,1,1,6,2,0,2
501274,1,1,6,6,0,6
548312,1,1,6,11,1,12
548320,1,1,6,13,0,13
548349,1,1,6,6,0,6
548358,1,1,6,18,1,19
548373,1,1,6,11,0,11
548375,1,1,6,7,0,7
548380,1,1,6,5,0,5
548383,1,1,6,12,0,12
598013,1,1,6,12,1,13
598018,1,1,6,6,0,6
598027,1,1,6,3,0,3
598034,1,1,6,7,0,7
598045,1,1,6,8,0,8
598058,1,1,6,6,0,6
598074,1,1,6,4,2,6
729284,1,1,6,3,0,3
729294,1,1,6,4,0,4
729304,1,1,6,4,0,4
734032,1,1,6,9,1,10
734048,1,1,6,13,0,13
829718,1,1,6,7,0,7
829766,1,1,6,11,0,11
829776,1,1,6,17,0,17
829786,1,1,6,6,4,10
980914,1,1,6,6,0,6
980952,1,1,6,11,0,11
980968,1,1,6,8,0,8
980980,1,1,6,6,1,7
981000,1,1,6,9,0,9
981006,1,1,6,7,1,8
981014,1,1,6,7,0,7
1082597,1,1,6,8,3,11
1082604,1,1,6,7,0,7
1082613,1,1,6,8,0,8
1082617,1,1,6,9,0,9
1082631,1,1,6,14,0,14
1082649,1,1,6,0,0,0
335991,2,1,6,3,0,3
336005,2,1,6,6,1,7
336008,2,1,6,1,1,2
336040,2,1,6,6,0,6
392191,2,1,6,13,0,13
392195,2,1,6,10,0,10
392202,2,1,6,4,0,4
392208,2,1,6,5,0,5
392236,2,1,6,22,0,22
392238,2,1,6,8,0,8
419114,2,1,6,9,0,9
419118,2,1,6,11,0,11
419123,2,1,6,1,0,1
419136,2,1,6,3,1,4
419163,2,1,6,4,0,4
419166,2,1,6,2,1,3
501203,2,1,6,7,1,8
501214,2,1,6,18,0,18
501219,2,1,6,3,0,3
501224,2,1,6,9,0,9
501239,2,1,6,4,1,5
501247,2,1,6,3,0,3
501250,2,1,6,2,0,2
501267,2,1,6,1,0,1
548317,2,1,6,3,1,4
548325,2,1,6,10,0,10
548328,2,1,6,7,0,7
548333,2,1,6,6,0,6
548340,2,1,6,10,0,10
548352,2,1,6,3,3,6
548362,2,1,6,10,0,10
548368,2,1,6,9,0,9
548386,2,1,6,15,0,15
598003,2,1,6,6,0,6
598010,2,1,6,4,0,4
598021,2,1,6,11,0,11
598036,2,1,6,9,0,9
598039,2,1,6,11,1,12
598048,2,1,6,3,5,8
598055,2,1,6,8,0,8
598062,2,1,6,3,1,4
598066,2,1,6,3,0,3
729312,2,1,6,5,0,5
729320,2,1,6,2,1,3
733976,2,1,6,1,0,1
733984,2,1,6,11,0,11
733990,2,1,6,6,4,10
734002,2,1,6,7,0,7
734014,2,1,6,4,1,5
734020,2,1,6,9,0,9
734028,2,1,6,7,0,7
734042,2,1,6,5,1,6
734054,2,1,6,11,0,11
829710,2,1,6,6,0,6
829728,2,1,6,1,1,2
829738,2,1,6,15,0,15
829744,2,1,6,12,1,13
829748,2,1,6,8,1,9
829770,2,1,6,2,0,2
829796,2,1,6,2,0,2
829810,2,1,6,11,1,12
829816,2,1,6,4,5,9
980908,2,1,6,5,0,5
980920,2,1,6,8,0,8
980930,2,1,6,10,0,10
980944,2,1,6,9,1,10
980956,2,1,6,10,0,10
980964,2,1,6,2,1,3
981020,2,1,6,3,0,3
1082593,2,1,6,16,4,20
1082601,2,1,6,16,0,16
1082608,2,1,6,15,0,15
1082620,2,1,6,7,0,7
1082622,2,1,6,7,4,11
1082627,2,1,6,8,0,8
1082636,2,1,6,20,0,20
1082639,2,1,6,12,0,12
1082644,2,1,6,4,0,4
1082648,2,1,6,2,0,2
335997,1,2,6,15,0,15
336011,1,2,6,7,0,7
336017,1,2,6,2,0,2
336021,1,2,6,9,5,14
336031,1,2,6,6,0,6
336034,1,2,6,0,1,1
336039,1,2,6,7,0,7
392187,1,2,6,12,0,12
392196,1,2,6,2,0,2
392199,1,2,6,9,1,10
392209,1,2,6,11,0,11
392218,1,2,6,5,1,6
392241,1,2,6,2,0,2
419114,1,2,6,6,0,6
419128,1,2,6,9,0,9
419138,1,2,6,17,2,19
419150,1,2,6,7,0,7
501210,1,2,6,4,0,4
501237,1,2,6,17,0,17
501249,1,2,6,1,0,1
501273,1,2,6,4,1,5
501275,1,2,6,1,0,1
548315,1,2,6,5,0,5
548323,1,2,6,4,1,5
548341,1,2,6,10,0,10
548355,1,2,6,8,0,8
548367,1,2,6,25,0,25
548372,1,2,6,5,1,6
548377,1,2,6,2,1,3
598004,1,2,6,2,1,3
598009,1,2,6,7,0,7
598017,1,2,6,7,0,7
598032,1,2,6,0,1,1
598041,1,2,6,6,0,6
598047,1,2,6,7,0,7
598050,1,2,6,5,0,5
598059,1,2,6,8,0,8
598062,1,2,6,6,0,6
598069,1,2,6,17,0,17
598073,1,2,6,10,0,10
729310,1,2,6,4,2,6
729318,1,2,6,10,0,10
734004,1,2,6,9,0,9
734010,1,2,6,1,0,1
734026,1,2,6,1,1,2
734040,1,2,6,3,0,3
829724,1,2,6,8,0,8
829768,1,2,6,3,2,5
829790,1,2,6,8,2,10
829800,1,2,6,10,0,10
829824,1,2,6,3,0,3
829826,1,2,6,4,0,4
980912,1,2,6,6,0,6
980926,1,2,6,12,1,13
980932,1,2,6,8,0,8
980936,1,2,6,10,1,11
980942,1,2,6,12,0,12
980964,1,2,6,10,0,10
980982,1,2,6,7,0,7
980986,1,2,6,6,0,6
980992,1,2,6,11,0,11
981004,1,2,6,10,0,10
1082595,1,2,6,9,0,9
1082598,1,2,6,1,0,1
1082602,1,2,6,7,0,7
1082610,1,2,6,9,0,9
1082621,1,2,6,12,0,12
1082628,1,2,6,12,0,12
1082636,1,2,6,5,1,6
1082646,1,2,6,7,0,7
335987,2,2,6,2,0,2
335990,2,2,6,3,0,3
336001,2,2,6,13,0,13
336003,2,2,6,7,0,7
336007,2,2,6,6,1,7
336015,2,2,6,3,0,3
336028,2,2,6,5,0,5
392190,2,2,6,6,0,6
392193,2,2,6,6,0,6
392204,2,2,6,6,0,6
392213,2,2,6,0,0,0
392223,2,2,6,8,0,8
392226,2,2,6,10,0,10
392229,2,2,6,3,0,3
392237,2,2,6,8,0,8
392243,2,2,6,10,0,10
392244,2,2,6,3,0,3
419117,2,2,6,18,0,18
419120,2,2,6,7,0,7
419124,2,2,6,15,0,15
419133,2,2,6,8,1,9
419141,2,2,6,11,0,11
419145,2,2,6,1,1,2
419153,2,2,6,15,0,15
419156,2,2,6,3,3,6
419159,2,2,6,17,0,17
419162,2,2,6,4,0,4
419167,2,2,6,3,0,3
419169,2,2,6,6,1,7
501205,2,2,6,4,0,4
501213,2,2,6,1,0,1
501216,2,2,6,2,0,2
501227,2,2,6,11,0,11
501232,2,2,6,3,0,3
501252,2,2,6,7,0,7
501257,2,2,6,11,1,12
501260,2,2,6,7,0,7
501265,2,2,6,7,0,7
501271,2,2,6,10,0,10
501276,2,2,6,9,0,9
548320,2,2,6,0,0,0
548329,2,2,6,12,0,12
548332,2,2,6,2,0,2
548336,2,2,6,11,0,11
548349,2,2,6,3,0,3
548361,2,2,6,10,0,10
548365,2,2,6,8,0,8
548381,2,2,6,3,0,3
598013,2,2,6,21,1,22
598022,2,2,6,5,0,5
598028,2,2,6,2,0,2
598038,2,2,6,0,1,1
598053,2,2,6,7,1,8
729286,2,2,6,13,0,13
729292,2,2,6,6,0,6
729304,2,2,6,15,0,15
733982,2,2,6,4,0,4
733988,2,2,6,11,0,11
733996,2,2,6,12,0,12
734018,2,2,6,0,0,0
734032,2,2,6,6,0,6
829718,2,2,6,12,0,12
829742,2,2,6,3,4,7
829750,2,2,6,4,0,4
829754,2,2,6,12,0,12
829762,2,2,6,7,0,7
829776,2,2,6,10,0,10
829784,2,2,6,8,0,8
829808,2,2,6,12,0,12
829812,2,2,6,15,0,15
980958,2,2,6,3,0,3
980974,2,2,6,9,0,9
981000,2,2,6,10,0,10
981016,2,2,6,11,0,11
981018,2,2,6,3,0,3
981024,2,2,6,4,0,4
1082591,2,2,6,6,0,6
1082607,2,2,6,3,0,3
1082617,2,2,6,9,2,11
1082624,2,2,6,6,0,6
1082633,2,2,6,9,0,9
335988,1,3,6,11,0,11
335994,1,3,6,11,2,13
336001,1,3,6,10,1,11
336006,1,3,6,10,0,10
336010,1,3,6,8,0,8
336012,1,3,6,2,1,3
336018,1,3,6,13,2,15
336023,1,3,6,5,0,5
336045,1,3,6,3,0,3
392190,1,3,6,12,0,12
392201,1,3,6,7,0,7
392207,1,3,6,14,0,14
392211,1,3,6,16,1,17
392214,1,3,6,8,0,8
392219,1,3,6,12,0,12
392229,1,3,6,9,0,9
392236,1,3,6,8,4,12
392239,1,3,6,6,0,6
392243,1,3,6,6,0,6
419118,1,3,6,9,0,9
419130,1,3,6,13,0,13
419142,1,3,6,16,0,16
419147,1,3,6,7,0,7
419152,1,3,6,14,0,14
419160,1,3,6,5,0,5
419168,1,3,6,7,1,8
419170,1,3,6,9,2,11
501203,1,3,6,13,0,13
501211,1,3,6,4,0,4
501216,1,3,6,12,0,12
501220,1,3,6,9,1,10
501231,1,3,6,10,0,10
501241,1,3,6,8,0,8
501250,1,3,6,2,1,3
501254,1,3,6,7,1,8
501258,1,3,6,3,0,3
501266,1,3,6,17,0,17
501271,1,3,6,6,0,6
501276,1,3,6,8,0,8
548311,1,3,6,4,4,8
548316,1,3,6,6,0,6
548321,1,3,6,6,0,6
548327,1,3,6,4,0,4
548335,1,3,6,13,1,14
548352,1,3,6,11,0,11
548357,1,3,6,8,1,9
548360,1,3,6,6,0,6
548376,1,3,6,1,0,1
548384,1,3,6,8,0,8
548385,1,3,6,12,1,13
548386,1,3,6,18,1,19
598025,1,3,6,5,0,5
598039,1,3,6,18,0,18
598043,1,3,6,3,0,3
598046,1,3,6,3,1,4
598056,1,3,6,6,0,6
598063,1,3,6,10,1,11
598067,1,3,6,17,0,17
598075,1,3,6,8,0,8
729288,1,3,6,11,0,11
729298,1,3,6,3,1,4
729302,1,3,6,18,1,19
733976,1,3,6,10,0,10
734018,1,3,6,10,0,10
734028,1,3,6,2,0,2
734034,1,3,6,21,0,21
829712,1,3,6,9,1,10
829716,1,3,6,8,0,8
829728,1,3,6,5,0,5
829740,1,3,6,3,0,3
829750,1,3,6,6,1,7
829758,1,3,6,2,1,3
829770,1,3,6,5,0,5
829784,1,3,6,8,0,8
829794,1,3,6,0,0,0
829802,1,3,6,13,0,13
829806,1,3,6,0,0,0
335998,2,3,6,9,1,10
336014,2,3,6,18,2,20
336030,2,3,6,6,1,7
336034,2,3,6,2,0,2
336038,2,3,6,10,0,10
336042,2,3,6,3,0,3
336044,2,3,6,5,0,5
392186,2,3,6,1,6,7
392194,2,3,6,4,1,5
392207,2,3,6,4,0,4
392222,2,3,6,12,0,12
392232,2,3,6,1,0,1
419115,2,3,6,3,0,3
419121,2,3,6,6,0,6
419126,2,3,6,5,3,8
419128,2,3,6,7,0,7
419134,2,3,6,8,0,8
419138,2,3,6,9,0,9
419158,2,3,6,7,0,7
419164,2,3,6,10,2,12
501226,2,3,6,6,0,6
501233,2,3,6,7,2,9
501245,2,3,6,4,0,4
501273,2,3,6,1,0,1
548323,2,3,6,20,0,20
548337,2,3,6,5,0,5
548348,2,3,6,3,0,3
548366,2,3,6,6,0,6
548369,2,3,6,7,0,7
548373,2,3,6,7,0,7
598007,2,3,6,4,0,4
598012,2,3,6,7,0,7
598017,2,3,6,14,0,14
598020,2,3,6,13,0,13
598027,2,3,6,1,0,1
598031,2,3,6,12,1,13
598035,2,3,6,12,0,12
598051,2,3,6,9,2,11
598073,2,3,6,19,0,19
598078,2,3,6,6,0,6
729308,2,3,6,14,0,14
729316,2,3,6,10,1,11
733986,2,3,6,1,1,2
733992,2,3,6,12,0,12
734000,2,3,6,4,0,4
734008,2,3,6,6,0,6
734040,2,3,6,5,0,5
734050,2,3,6,17,0,17
734052,2,3,6,32,1,33
829734,2,3,6,18,0,18
829778,2,3,6,6,0,6
829814,2,3,6,6,1,7
829822,2,3,6,8,0,8
829826,2,3,6,6,0,6
829828,2,3,6,5,0,5
335992,1,4,6,16,0,16
335996,1,4,6,16,1,17
336008,1,4,6,4,1,5
336024,1,4,6,10,0,10
336033,1,4,6,12,1,13
336040,1,4,6,9,1,10
336044,1,4,6,5,0,5
392188,1,4,6,14,1,15
392191,1,4,6,10,0,10
392200,1,4,6,7,3,10
392205,1,4,6,2,1,3
392227,1,4,6,8,0,8
392234,1,4,6,6,0,6
419113,1,4,6,4,1,5
419117,1,4,6,15,0,15
419126,1,4,6,8,0,8
419137,1,4,6,2,5,7
419141,1,4,6,5,0,5
419148,1,4,6,8,2,10
419161,1,4,6,9,0,9
419164,1,4,6,6,0,6
501207,1,4,6,9,1,10
501225,1,4,6,0,4,4
501239,1,4,6,5,0,5
501253,1,4,6,5,0,5
501256,1,4,6,5,4,9
501262,1,4,6,9,1,10
501265,1,4,6,1,0,1
548328,1,4,6,2,0,2
548333,1,4,6,11,0,11
548336,1,4,6,14,0,14
548344,1,4,6,9,0,9
548348,1,4,6,5,0,5
548364,1,4,6,9,0,9
548374,1,4,6,9,0,9
548379,1,4,6,2,0,2
598012,1,4,6,5,0,5
598019,1,4,6,13,0,13
598021,1,4,6,6,0,6
598026,1,4,6,7,0,7
598033,1,4,6,17,0,17
598036,1,4,6,12,0,12
598057,1,4,6,9,0,9
598071,1,4,6,13,0,13
729300,1,4,6,4,1,5
729312,1,4,6,14,0,14
733978,1,4,6,5,0,5
733992,1,4,6,1,0,1
733996,1,4,6,15,4,19
734002,1,4,6,1,0,1
734030,1,4,6,13,1,14
734038,1,4,6,7,0,7
734052,1,4,6,13,0,13
734054,1,4,6,2,0,2
829722,1,4,6,10,1,11
829730,1,4,6,8,0,8
829738,1,4,6,11,0,11
829772,1,4,6,9,2,11
829796,1,4,6,4,0,4
829808,1,4,6,15,1,16
829814,1,4,6,6,0,6
980910,1,4,6,7,0,7
980918,1,4,6,14,0,14
980930,1,4,6,6,0,6
980940,1,4,6,0,0,0
980960,1,4,6,8,0,8
980976,1,4,6,5,0,5
980996,1,4,6,10,0,10
981010,1,4,6,12,0,12
1082601,1,4,6,4,0,4
1082612,1,4,6,7,0,7
1082616,1,4,6,14,0,14
1082633,1,4,6,6,0,6
1082637,1,4,6,15,0,15
1082639,1,4,6,2,0,2
1082641,1,4,6,11,0,11
1082645,1,4,6,1,2,3
335988,2,4,6,14,2,16
336000,2,4,6,12,0,12
336004,2,4,6,4,0,4
336011,2,4,6,8,0,8
336018,2,4,6,4,0,4
336021,2,4,6,9,0,9
336027,2,4,6,17,0,17
336036,2,4,6,11,0,11
392196,2,4,6,4,1,5
392209,2,4,6,7,0,7
392212,2,4,6,6,1,7
392215,2,4,6,3,1,4
392219,2,4,6,5,1,6
392221,2,4,6,3,0,3
392231,2,4,6,1,1,2
392239,2,4,6,3,0,3
419122,2,4,6,5,0,5
419129,2,4,6,16,1,17
419132,2,4,6,11,0,11
419144,2,4,6,16,1,17
419151,2,4,6,10,0,10
419154,2,4,6,7,0,7
501211,2,4,6,16,0,16
501217,2,4,6,2,1,3
501228,2,4,6,12,0,12
501242,2,4,6,5,1,6
501249,2,4,6,5,0,5
501259,2,4,6,14,0,14
501269,2,4,6,9,0,9
548314,2,4,6,4,1,5
548318,2,4,6,6,0,6
548324,2,4,6,10,0,10
548339,2,4,6,6,0,6
548355,2,4,6,9,0,9
548359,2,4,6,5,1,6
548371,2,4,6,16,0,16
548376,2,4,6,9,0,9
598008,2,4,6,2,0,2
598030,2,4,6,11,0,11
598042,2,4,6,17,0,17
598046,2,4,6,9,0,9
598050,2,4,6,13,0,13
598061,2,4,6,12,0,12
598064,2,4,6,5,0,5
598069,2,4,6,10,0,10
729288,2,4,6,10,2,12
729296,2,4,6,7,2,9
729318,2,4,6,2,0,2
734012,2,4,6,20,0,20
734024,2,4,6,10,1,11
734044,2,4,6,14,4,18
734048,2,4,6,6,1,7
829714,2,4,6,4,1,5
829746,2,4,6,7,0,7
829758,2,4,6,4,0,4
829764,2,4,6,13,2,15
829780,2,4,6,3,0,3
829790,2,4,6,5,0,5
829804,2,4,6,5,0,5
980924,2,4,6,7,0,7
980946,2,4,6,7,0,7
980968,2,4,6,9,1,10
980982,2,4,6,7,0,7
980990,2,4,6,4,2,6
981004,2,4,6,3,2,5
1082594,2,4,6,8,0,8
1082598,2,4,6,11,1,12
1082605,2,4,6,7,0,7
1082609,2,4,6,15,4,19
1082623,2,4,6,17,0,17
1082626,2,4,6,10,1,11
335989,1,5,6,2,1,3
336005,1,5,6,3,4,7
336013,1,5,6,17,0,17
336028,1,5,6,8,0,8
336038,1,5,6,15,0,15
336043,1,5,6,15,0,15
392195,1,5,6,13,1,14
392215,1,5,6,13,0,13
392222,1,5,6,8,1,9
392230,1,5,6,1,2,3
392238,1,5,6,8,0,8
419116,1,5,6,2,0,2
419120,1,5,6,3,1,4
419123,1,5,6,14,0,14
419129,1,5,6,3,1,4
419134,1,5,6,9,0,9
419146,1,5,6,11,0,11
419159,1,5,6,6,0,6
419163,1,5,6,14,0,14
501214,1,5,6,2,0,2
501219,1,5,6,8,0,8
501245,1,5,6,11,0,11
501257,1,5,6,11,0,11
501263,1,5,6,10,0,10
548314,1,5,6,9,0,9
548317,1,5,6,8,0,8
548325,1,5,6,12,0,12
548329,1,5,6,9,0,9
548337,1,5,6,5,0,5
548354,1,5,6,6,0,6
548359,1,5,6,18,1,19
548366,1,5,6,3,0,3
548370,1,5,6,11,0,11
548378,1,5,6,10,0,10
548382,1,5,6,0,0,0
598006,1,5,6,8,1,9
598010,1,5,6,8,0,8
598014,1,5,6,4,0,4
598024,1,5,6,12,4,16
598028,1,5,6,6,0,6
598031,1,5,6,7,0,7
598048,1,5,6,4,2,6
598077,1,5,6,9,0,9
729296,1,5,6,12,1,13
729320,1,5,6,17,3,20
733984,1,5,6,6,0,6
734008,1,5,6,16,1,17
734016,1,5,6,9,0,9
734046,1,5,6,5,0,5
829714,1,5,6,15,0,15
829746,1,5,6,9,0,9
829754,1,5,6,12,0,12
829782,1,5,6,7,0,7
829816,1,5,6,14,0,14
335992,2,5,6,4,1,5
335995,2,5,6,16,0,16
335997,2,5,6,5,1,6
336010,2,5,6,10,0,10
336016,2,5,6,17,0,17
336020,2,5,6,2,4,6
336024,2,5,6,9,0,9
336032,2,5,6,0,0,0
336041,2,5,6,2,2,4
336045,2,5,6,5,0,5
392187,2,5,6,1,0,1
392200,2,5,6,5,0,5
392203,2,5,6,2,0,2
392207,2,5,6,6,0,6
392210,2,5,6,9,1,10
392218,2,5,6,6,0,6
392225,2,5,6,5,0,5
392235,2,5,6,5,0,5
419112,2,5,6,1,0,1
419131,2,5,6,3,0,3
419139,2,5,6,6,0,6
419142,2,5,6,15,0,15
419148,2,5,6,5,0,5
419155,2,5,6,9,5,14
501204,2,5,6,1,1,2
501209,2,5,6,14,0,14
501225,2,5,6,7,0,7
501230,2,5,6,5,0,5
501236,2,5,6,1,0,1
501240,2,5,6,5,0,5
501254,2,5,6,10,0,10
501268,2,5,6,15,0,15
548322,2,5,6,8,1,9
548331,2,5,6,10,2,12
548341,2,5,6,13,0,13
548350,2,5,6,10,0,10
548363,2,5,6,8,0,8
598019,2,5,6,4,0,4
598037,2,5,6,9,0,9
598041,2,5,6,9,0,9
598052,2,5,6,13,0,13
598054,2,5,6,13,0,13
598057,2,5,6,7,0,7
598063,2,5,6,5,0,5
598068,2,5,6,2,0,2
598070,2,5,6,2,1,3
598076,2,5,6,16,0,16
729290,2,5,6,2,0,2
729302,2,5,6,1,0,1
729310,2,5,6,3,1,4
733980,2,5,6,7,0,7
733994,2,5,6,5,0,5
734004,2,5,6,7,0,7
734022,2,5,6,5,1,6
734038,2,5,6,12,1,13
829720,2,5,6,5,0,5
829726,2,5,6,9,0,9
829732,2,5,6,8,1,9
829740,2,5,6,5,0,5
829774,2,5,6,6,0,6
829792,2,5,6,1,0,1
829802,2,5,6,8,0,8
829824,2,5,6,6,0,6
336000,1,6,6,5,0,5
336003,1,6,6,5,0,5
336014,1,6,6,5,0,5
336020,1,6,6,6,2,8
336025,1,6,6,7,1,8
336027,1,6,6,22,0,22
392194,1,6,6,13,0,13
392203,1,6,6,6,0,6
392228,1,6,6,24,0,24
392231,1,6,6,9,2,11
392235,1,6,6,9,0,9
392237,1,6,6,9,0,9
392242,1,6,6,8,0,8
419121,1,6,6,2,0,2
419133,1,6,6,6,0,6
419136,1,6,6,6,0,6
419139,1,6,6,7,0,7
419145,1,6,6,6,0,6
419154,1,6,6,1,0,1
501206,1,6,6,11,0,11
501209,1,6,6,0,0,0
501228,1,6,6,12,6,18
501232,1,6,6,8,0,8
501238,1,6,6,0,3,3
501243,1,6,6,3,1,4
501270,1,6,6,5,1,6
548347,1,6,6,11,3,14
548350,1,6,6,7,0,7
548362,1,6,6,7,0,7
548369,1,6,6,2,1,3
598003,1,6,6,4,0,4
598015,1,6,6,1,0,1
598022,1,6,6,1,0,1
598040,1,6,6,10,3,13
598049,1,6,6,3,0,3
598054,1,6,6,1,0,1
598064,1,6,6,8,0,8
729286,1,6,6,13,0,13
733980,1,6,6,11,0,11
733986,1,6,6,9,0,9
733990,1,6,6,3,0,3
733998,1,6,6,15,0,15
734024,1,6,6,7,1,8
734044,1,6,6,0,1,1
829720,1,6,6,5,0,5
829736,1,6,6,11,1,12
829744,1,6,6,8,0,8
829752,1,6,6,2,0,2
829762,1,6,6,3,1,4
829788,1,6,6,0,1,1
829818,1,6,6,12,0,12
980908,1,6,6,0,0,0
980938,1,6,6,5,1,6
980956,1,6,6,5,0,5
980970,1,6,6,8,0,8
981002,1,6,6,3,0,3
981016,1,6,6,2,0,2
1082599,1,6,6,14,1,15
1082605,1,6,6,8,0,8
1082608,1,6,6,3,0,3
1082622,1,6,6,5,0,5
1082626,1,6,6,3,0,3
1082642,1,6,6,13,1,14
335989,2,6,6,6,1,7
335993,2,6,6,10,1,11
336006,2,6,6,10,0,10
336009,2,6,6,8,0,8
336022,2,6,6,5,0,5
336031,2,6,6,11,0,11
336037,2,6,6,6,0,6
336043,2,6,6,4,0,4
392199,2,6,6,4,0,4
392206,2,6,6,4,2,6
392211,2,6,6,11,0,11
392216,2,6,6,6,2,8
392220,2,6,6,3,0,3
392224,2,6,6,2,0,2
392240,2,6,6,14,0,14
419113,2,6,6,9,0,9
419116,2,6,6,13,0,13
419119,2,6,6,5,0,5
419125,2,6,6,7,0,7
419149,2,6,6,5,0,5
419157,2,6,6,13,1,14
419160,2,6,6,7,0,7
419165,2,6,6,2,0,2
501218,2,6,6,8,7,15
501221,2,6,6,5,0,5
501235,2,6,6,6,1,7
501248,2,6,6,4,1,5
501251,2,6,6,10,0,10
501258,2,6,6,1,5,6
501262,2,6,6,16,1,17
548312,2,6,6,8,1,9
548315,2,6,6,6,0,6
548321,2,6,6,6,0,6
548326,2,6,6,7,0,7
548330,2,6,6,7,0,7
548334,2,6,6,20,0,20
548338,2,6,6,20,0,20
548342,2,6,6,15,0,15
548354,2,6,6,10,0,10
548374,2,6,6,1,0,1
548377,2,6,6,4,0,4
548379,2,6,6,5,5,10
548383,2,6,6,2,0,2
548385,2,6,6,11,0,11
598006,2,6,6,5,1,6
598011,2,6,6,3,1,4
598025,2,6,6,2,0,2
598029,2,6,6,9,0,9
598033,2,6,6,7,0,7
598045,2,6,6,2,0,2
598059,2,6,6,1,0,1
598067,2,6,6,15,0,15
598072,2,6,6,7,0,7
729294,2,6,6,6,0,6
729298,2,6,6,6,0,6
729306,2,6,6,6,1,7
729314,2,6,6,0,1,1
734010,2,6,6,10,0,10
734016,2,6,6,2,2,4
734036,2,6,6,4,0,4
829712,2,6,6,1,0,1
829730,2,6,6,7,0,7
829766,2,6,6,2,0,2
829772,2,6,6,8,0,8
829782,2,6,6,14,0,14
829798,2,6,6,15,0,15
829806,2,6,6,4,0,4
980918,2,6,6,8,0,8
980926,2,6,6,1,0,1
980950,2,6,6,3,0,3
980966,2,6,6,10,0,10
980976,2,6,6,16,0,16
980988,2,6,6,8,1,9
980998,2,6,6,2,0,2
981008,2,6,6,1,0,1
1082595,2,6,6,6,0,6
1082611,2,6,6,8,1,9
1082614,2,6,6,1,1,2
1082630,2,6,6,16,0,16
1082632,2,6,6,5,0,5
1082635,2,6,6,4,0,4
1082640,2,6,6,17,0,17
1082646,2,6,6,2,0,2
335990,1,7,6,6,0,6
335999,1,7,6,4,1,5
336009,1,7,6,15,0,15
336029,1,7,6,9,0,9
336037,1,7,6,17,0,17
336041,1,7,6,1,0,1
392186,1,7,6,5,0,5
392202,1,7,6,15,1,16
392208,1,7,6,9,0,9
392213,1,7,6,2,0,2
392220,1,7,6,5,0,5
392223,1,7,6,4,0,4
392232,1,7,6,15,0,15
392240,1,7,6,2,0,2
419112,1,7,6,17,0,17
419119,1,7,6,10,1,11
419124,1,7,6,8,0,8
419135,1,7,6,10,0,10
419143,1,7,6,6,0,6
419151,1,7,6,6,0,6
419155,1,7,6,6,0,6
419157,1,7,6,4,0,4
419162,1,7,6,5,0,5
419166,1,7,6,13,0,13
419167,1,7,6,15,0,15
501215,1,7,6,8,1,9
501226,1,7,6,8,1,9
501229,1,7,6,8,2,10
501236,1,7,6,2,0,2
501242,1,7,6,11,0,11
501246,1,7,6,8,6,14
501251,1,7,6,0,0,0
501268,1,7,6,6,0,6
548322,1,7,6,10,0,10
548330,1,7,6,6,1,7
548339,1,7,6,10,1,11
548356,1,7,6,14,0,14
548365,1,7,6,13,0,13
548368,1,7,6,6,0,6
598007,1,7,6,12,1,13
598011,1,7,6,16,0,16
598016,1,7,6,11,0,11
598029,1,7,6,2,0,2
598038,1,7,6,10,4,14
598042,1,7,6,8,0,8
598044,1,7,6,9,0,9
598051,1,7,6,11,0,11
598055,1,7,6,3,0,3
598068,1,7,6,12,2,14
598078,1,7,6,9,0,9
729292,1,7,6,13,5,18
729308,1,7,6,5,0,5
729314,1,7,6,6,0,6
733988,1,7,6,5,4,9
734000,1,7,6,10,0,10
734014,1,7,6,2,0,2
734022,1,7,6,7,1,8
734036,1,7,6,10,1,11
734050,1,7,6,19,0,19
829710,1,7,6,0,0,0
829726,1,7,6,4,0,4
829734,1,7,6,11,0,11
829742,1,7,6,2,1,3
829756,1,7,6,10,0,10
829774,1,7,6,3,1,4
829780,1,7,6,5,0,5
829810,1,7,6,10,2,12
829822,1,7,6,13,0,13
829828,1,7,6,14,0,14
980906,1,7,6,1,6,7
980922,1,7,6,5,0,5
980928,1,7,6,9,0,9
980946,1,7,6,13,1,14
980990,1,7,6,7,0,7
980998,1,7,6,12,0,12
981012,1,7,6,4,0,4
1082592,1,7,6,13,0,13
1082614,1,7,6,1,0,1
1082635,1,7,6,13,6,19
1082638,1,7,6,7,0,7
1082644,1,7,6,12,0,12
1082650,1,7,6,16,0,16
335994,2,7,6,2,0,2
335996,2,7,6,5,0,5
336002,2,7,6,9,0,9
336013,2,7,6,5,0,5
336017,2,7,6,3,0,3
336023,2,7,6,20,1,21
336026,2,7,6,10,5,15
336033,2,7,6,12,0,12
392197,2,7,6,5,3,8
392202,2,7,6,4,0,4
392205,2,7,6,10,0,10
392217,2,7,6,13,1,14
392227,2,7,6,7,0,7
392230,2,7,6,3,0,3
419119,2,7,6,2,0,2
419127,2,7,6,6,0,6
419130,2,7,6,13,0,13
419137,2,7,6,3,5,8
419147,2,7,6,8,0,8
419170,2,7,6,11,1,12
501206,2,7,6,8,1,9
501210,2,7,6,7,0,7
501223,2,7,6,5,0,5
501256,2,7,6,5,0,5
501261,2,7,6,2,0,2
501272,2,7,6,13,5,18
501274,2,7,6,11,0,11
501275,2,7,6,10,1,11
548311,2,7,6,16,0,16
548313,2,7,6,6,0,6
548319,2,7,6,14,0,14
548344,2,7,6,9,2,11
548347,2,7,6,13,0,13
548351,2,7,6,4,0,4
548360,2,7,6,8,0,8
548372,2,7,6,3,1,4
548375,2,7,6,6,0,6
548382,2,7,6,5,0,5
548384,2,7,6,7,0,7
598004,2,7,6,10,1,11
598024,2,7,6,2,0,2
598034,2,7,6,12,0,12
598060,2,7,6,11,0,11
598065,2,7,6,4,0,4
598071,2,7,6,14,0,14
598075,2,7,6,16,0,16
598077,2,7,6,9,0,9
729284,2,7,6,7,0,7
729322,2,7,6,8,0,8
733978,2,7,6,6,1,7
734006,2,7,6,6,0,6
734030,2,7,6,9,0,9
734046,2,7,6,9,1,10
829722,2,7,6,0,0,0
829752,2,7,6,10,0,10
829788,2,7,6,5,0,5
829794,2,7,6,11,0,11
829800,2,7,6,10,0,10
829820,2,7,6,1,0,1
980914,2,7,6,2,1,3
980932,2,7,6,7,1,8
980938,2,7,6,5,0,5
980952,2,7,6,19,0,19
980962,2,7,6,4,0,4
980978,2,7,6,1,0,1
980986,2,7,6,9,0,9
1082597,2,7,6,4,1,5
1082600,2,7,6,19,0,19
1082602,2,7,6,3,0,3
1082606,2,7,6,9,0,9
1082612,2,7,6,13,1,14
1082618,2,7,6,8,1,9
1082625,2,7,6,9,0,9
1082628,2,7,6,8,0,8
1082641,2,7,6,16,0,16
1082647,2,7,6,1,0,1
1082649,2,7,6,4,0,4
335991,1,8,6,16,0,16
335993,1,8,6,2,0,2
335995,1,8,6,9,1,10
336004,1,8,6,12,0,12
336007,1,8,6,7,0,7
336016,1,8,6,9,0,9
336036,1,8,6,2,1,3
336042,1,8,6,8,0,8
392193,1,8,6,13,0,13
392197,1,8,6,10,1,11
392206,1,8,6,7,0,7
392210,1,8,6,4,0,4
392217,1,8,6,1,0,1
392221,1,8,6,8,0,8
392225,1,8,6,10,0,10
392244,1,8,6,8,0,8
419115,1,8,6,1,1,2
419122,1,8,6,3,0,3
419125,1,8,6,3,0,3
419131,1,8,6,13,0,13
419156,1,8,6,7,0,7
419165,1,8,6,4,0,4
419169,1,8,6,7,0,7
501204,1,8,6,4,0,4
501213,1,8,6,7,0,7
501217,1,8,6,9,1,10
501221,1,8,6,7,0,7
501234,1,8,6,1,0,1
501248,1,8,6,13,0,13
501255,1,8,6,11,0,11
501261,1,8,6,9,0,9
501269,1,8,6,11,0,11
548319,1,8,6,18,0,18
548326,1,8,6,15,0,15
548331,1,8,6,8,0,8
548334,1,8,6,5,0,5
548340,1,8,6,4,0,4
548346,1,8,6,2,0,2
548351,1,8,6,2,0,2
548353,1,8,6,7,0,7
548361,1,8,6,7,0,7
548371,1,8,6,6,0,6
548381,1,8,6,2,0,2
335999,2,8,6,11,2,13
336012,2,8,6,20,0,20
336019,2,8,6,11,3,14
336025,2,8,6,10,0,10
336029,2,8,6,8,1,9
336039,2,8,6,2,0,2
392189,2,8,6,2,0,2
392201,2,8,6,3,0,3
392214,2,8,6,18,0,18
392228,2,8,6,9,1,10
392233,2,8,6,9,0,9
392234,2,8,6,6,0,6
392241,2,8,6,14,5,19
392242,2,8,6,24,1,25
419111,2,8,6,6,0,6
419135,2,8,6,0,2,2
419140,2,8,6,12,1,13
419143,2,8,6,4,0,4
419146,2,8,6,4,0,4
419150,2,8,6,2,0,2
419152,2,8,6,2,0,2
419161,2,8,6,7,1,8
419168,2,8,6,4,0,4
501208,2,8,6,7,0,7
501229,2,8,6,2,0,2
501241,2,8,6,7,0,7
501244,2,8,6,3,0,3
501264,2,8,6,16,1,17
548316,2,8,6,9,1,10
548357,2,8,6,7,0,7
548364,2,8,6,3,6,9
548378,2,8,6,13,1,14
501205,1,9,6,18,1,19
501212,1,9,6,13,0,13
501224,1,9,6,7,0,7
501230,1,9,6,3,0,3
501247,1,9,6,5,0,5
501252,1,9,6,8,0,8
501259,1,9,6,11,5,16
501215,2,9,6,15,3,18
501220,2,9,6,9,0,9
501234,2,9,6,6,0,6
501238,2,9,6,8,0,8
501243,2,9,6,3,3,6
501263,2,9,6,10,4,14
501266,2,9,6,11,0,11
501218,1,10,6,20,1,21
501223,1,10,6,5,5,10
501233,1,10,6,10,0,10
501240,1,10,6,12,0,12
501264,1,10,6,4,0,4
501267,1,10,6,2,2,4
548313,1,10,6,3,0,3
548318,1,10,6,2,0,2
548324,1,10,6,1,0,1
548332,1,10,6,10,0,10
548338,1,10,6,17,1,18
548342,1,10,6,10,0,10
548363,1,10,6,6,1,7
598008,1,10,6,3,0,3
598020,1,10,6,6,0,6
598030,1,10,6,0,1,1
598052,1,10,6,6,5,11
598060,1,10,6,7,0,7
598066,1,10,6,3,0,3
598072,1,10,6,1,2,3
501207,2,10,6,12,0,12
501212,2,10,6,6,1,7
501231,2,10,6,0,0,0
501237,2,10,6,7,0,7
501246,2,10,6,1,3,4
501253,2,10,6,8,0,8
501255,2,10,6,9,0,9
548327,2,10,6,8,0,8
548335,2,10,6,18,0,18
548346,2,10,6,5,0,5
548353,2,10,6,17,0,17
548356,2,10,6,6,0,6
548358,2,10,6,9,1,10
548367,2,10,6,11,1,12
548370,2,10,6,7,0,7
548380,2,10,6,5,0,5
598005,2,10,6,8,1,9
598014,2,10,6,5,1,6
598016,2,10,6,6,0,6
598023,2,10,6,2,0,2
598032,2,10,6,6,0,6
598040,2,10,6,4,2,6
598043,2,10,6,3,0,3
598047,2,10,6,4,0,4
598058,2,10,6,5,0,5
598005,1,11,6,5,1,6
598023,1,11,6,8,0,8
598035,1,11,6,3,0,3
598037,1,11,6,9,1,10
598053,1,11,6,8,0,8
598061,1,11,6,8,0,8
598065,1,11,6,7,1,8
598070,1,11,6,4,0,4
598076,1,11,6,6,0,6
729290,1,11,6,8,0,8
729306,1,11,6,8,0,8
729316,1,11,6,4,1,5
729322,1,11,6,6,0,6
733982,1,11,6,8,1,9
733994,1,11,6,3,1,4
734006,1,11,6,12,0,12
734012,1,11,6,6,0,6
734020,1,11,6,1,0,1
734042,1,11,6,8,0,8
829732,1,11,6,0,0,0
829748,1,11,6,7,0,7
829764,1,11,6,9,1,10
829778,1,11,6,13,1,14
829792,1,11,6,7,0,7
829798,1,11,6,8,1,9
829804,1,11,6,2,1,3
829812,1,11,6,16,2,18
829820,1,11,6,7,1,8
980920,1,11,6,6,0,6
980948,1,11,6,1,0,1
980958,1,11,6,14,2,16
980978,1,11,6,11,0,11
980984,1,11,6,13,0,13
980988,1,11,6,4,4,8
981008,1,11,6,4,0,4
981020,1,11,6,11,1,12
981024,1,11,6,12,1,13
1082591,1,11,6,17,0,17
1082600,1,11,6,8,0,8
1082609,1,11,6,3,1,4
1082611,1,11,6,8,0,8
1082615,1,11,6,11,0,11
1082623,1,11,6,10,0,10
1082627,1,11,6,9,3,12
1082630,1,11,6,13,4,17
1082648,1,11,6,3,0,3
598009,2,11,6,6,0,6
598015,2,11,6,13,0,13
598018,2,11,6,5,1,6
598026,2,11,6,8,0,8
598044,2,11,6,11,0,11
598049,2,11,6,7,1,8
598056,2,11,6,3,0,3
598074,2,11,6,15,0,15
729300,2,11,6,12,0,12
734026,2,11,6,6,0,6
734034,2,11,6,20,1,21
829716,2,11,6,9,0,9
829724,2,11,6,7,0,7
829736,2,11,6,18,0,18
829756,2,11,6,6,1,7
829786,2,11,6,4,0,4
980912,2,11,6,7,0,7
980928,2,11,6,3,1,4
980934,2,11,6,10,0,10
980940,2,11,6,7,0,7
980972,2,11,6,5,0,5
980996,2,11,6,11,0,11
981014,2,11,6,9,0,9
981022,2,11,6,3,0,3
1082596,2,11,6,11,0,11
1082604,2,11,6,6,0,6
1082634,2,11,6,14,0,14
1082638,2,11,6,6,0,6
1082643,2,11,6,14,0,14
980916,1,12,6,16,0,16
980924,1,12,6,9,2,11
980944,1,12,6,3,0,3
980954,1,12,6,13,0,13
980962,1,12,6,10,0,10
980974,1,12,6,12,0,12
980994,1,12,6,10,0,10
1082594,1,12,6,3,0,3
1082603,1,12,6,4,0,4
1082607,1,12,6,4,1,5
1082618,1,12,6,11,0,11
1082620,1,12,6,15,0,15
1082624,1,12,6,12,0,12
1082634,1,12,6,10,1,11
1082647,1,12,6,2,0,2
980906,2,12,6,19,1,20
980936,2,12,6,4,0,4
980948,2,12,6,10,1,11
980970,2,12,6,12,0,12
980984,2,12,6,5,0,5
981002,2,12,6,9,2,11
981010,2,12,6,9,0,9
1082592,2,12,6,16,0,16
1082599,2,12,6,11,1,12
1082615,2,12,6,18,0,18
1082629,2,12,6,6,0,6
1082631,2,12,6,14,1,15
1082642,2,12,6,11,1,12
1082645,2,12,6,7,0,7
1082650,2,12,6,6,0,6
980934,1,13,6,9,0,9
980950,1,13,6,8,0,8
980966,1,13,6,7,1,8
980972,1,13,6,2,0,2
981018,1,13,6,3,0,3
981022,1,13,6,6,0,6
1082593,1,13,6,12,0,12
1082596,1,13,6,4,1,5
1082606,1,13,6,15,0,15
1082625,1,13,6,1,0,1
1082629,1,13,6,9,0,9
1082632,1,13,6,12,0,12
1082640,1,13,6,11,0,11
1082643,1,13,6,13,0,13
980910,2,13,6,12,0,12
980916,2,13,6,16,4,20
980922,2,13,6,7,0,7
980942,2,13,6,20,5,25
980954,2,13,6,9,1,10
980960,2,13,6,2,0,2
980980,2,13,6,10,0,10
980992,2,13,6,2,2,4
981006,2,13,6,9,1,10
981012,2,13,6,19,0,19
1082603,2,13,6,15,0,15
1082610,2,13,6,9,0,9
1082613,2,13,6,8,2,10
1082616,2,13,6,7,0,7
1082621,2,13,6,11,0,11
1082637,2,13,6,9,0,9
335987,1,1,7,7,0,7
335998,1,1,7,1,1,2
336002,1,1,7,3,4,7
336015,1,1,7,4,0,4
336019,1,1,7,5,0,5
336022,1,1,7,10,3,13
336026,1,1,7,2,0,2
336030,1,1,7,5,0,5
336032,1,1,7,8,0,8
392189,1,1,7,2,0,2
392204,1,1,7,3,0,3
392212,1,1,7,2,0,2
392216,1,1,7,4,0,4
392224,1,1,7,6,0,6
392226,1,1,7,8,0,8
392233,1,1,7,3,0,3
419111,1,1,7,8,0,8
419127,1,1,7,4,1,5
419132,1,1,7,5,0,5
419140,1,1,7,12,1,13
419144,1,1,7,2,0,2
419149,1,1,7,15,0,15
419153,1,1,7,5,6,11
419158,1,1,7,4,4,8
501208,1,1,7,3,0,3
501227,1,1,7,9,0,9
501235,1,1,7,7,1,8
501244,1,1,7,4,0,4
501260,1,1,7,5,1,6
501272,1,1,7,6,0,6
501274,1,1,7,5,0,5
548312,1,1,7,10,0,10
548320,1,1,7,3,0,3
548349,1,1,7,9,0,9
548358,1,1,7,7,0,7
548373,1,1,7,7,0,7
548375,1,1,7,5,1,6
548380,1,1,7,5,0,5
548383,1,1,7,3,0,3
598013,1,1,7,3,0,3
598018,1,1,7,9,0,9
598027,1,1,7,2,0,2
598034,1,1,7,4,0,4
598045,1,1,7,5,0,5
598058,1,1,7,1,1,2
598074,1,1,7,9,0,9
729284,1,1,7,6,0,6
729294,1,1,7,11,2,13
729304,1,1,7,15,0,15
734032,1,1,7,11,0,11
734048,1,1,7,3,0,3
829718,1,1,7,5,0,5
829766,1,1,7,1,0,1
829776,1,1,7,12,0,12
829786,1,1,7,5,0,5
980914,1,1,7,12,0,12
980952,1,1,7,8,0,8
980968,1,1,7,3,0,3
980980,1,1,7,5,0,5
981000,1,1,7,16,0,16
981006,1,1,7,2,1,3
981014,1,1,7,5,1,6
1082597,1,1,7,6,0,6
1082604,1,1,7,7,0,7
1082613,1,1,7,6,0,6
1082617,1,1,7,3,0,3
1082631,1,1,7,3,0,3
1082649,1,1,7,6,0,6
335991,2,1,7,2,5,7
336005,2,1,7,3,0,3
336008,2,1,7,4,0,4
336040,2,1,7,3,0,3
392191,2,1,7,6,0,6
392195,2,1,7,4,1,5
392202,2,1,7,2,0,2
392208,2,1,7,11,2,13
392236,2,1,7,4,0,4
392238,2,1,7,1,0,1
419114,2,1,7,4,2,6
419118,2,1,7,4,0,4
419123,2,1,7,5,0,5
419136,2,1,7,8,1,9
419163,2,1,7,5,0,5
419166,2,1,7,9,0,9
501203,2,1,7,4,0,4
501214,2,1,7,5,0,5
501219,2,1,7,5,0,5
501224,2,1,7,5,0,5
501239,2,1,7,6,3,9
501247,2,1,7,7,0,7
501250,2,1,7,6,0,6
501267,2,1,7,6,0,6
548317,2,1,7,7,0,7
548325,2,1,7,7,2,9
548328,2,1,7,6,0,6
548333,2,1,7,2,1,3
548340,2,1,7,2,0,2
548352,2,1,7,10,0,10
548362,2,1,7,8,0,8
548368,2,1,7,7,1,8
548386,2,1,7,10,3,13
598003,2,1,7,6,0,6
598010,2,1,7,3,0,3
598021,2,1,7,14,0,14
598036,2,1,7,7,0,7
598039,2,1,7,3,1,4
598048,2,1,7,5,2,7
598055,2,1,7,8,0,8
598062,2,1,7,6,1,7
598066,2,1,7,12,0,12
729312,2,1,7,3,1,4
729320,2,1,7,5,0,5
733976,2,1,7,10,0,10
733984,2,1,7,11,0,11
733990,2,1,7,11,0,11
734002,2,1,7,12,1,13
734014,2,1,7,5,0,5
734020,2,1,7,5,1,6
734028,2,1,7,12,0,12
734042,2,1,7,4,0,4
734054,2,1,7,8,0,8
829710,2,1,7,11,0,11
829728,2,1,7,4,2,6
829738,2,1,7,7,0,7
829744,2,1,7,4,0,4
829748,2,1,7,11,0,11
829770,2,1,7,7,0,7
829796,2,1,7,3,1,4
829810,2,1,7,4,0,4
829816,2,1,7,13,0,13
980908,2,1,7,2,0,2
980920,2,1,7,6,0,6
980930,2,1,7,7,0,7
980944,2,1,7,3,0,3
980956,2,1,7,7,1,8
980964,2,1,7,15,0,15
981020,2,1,7,7,0,7
1082593,2,1,7,23,0,23
1082601,2,1,7,13,0,13
1082608,2,1,7,3,0,3
1082620,2,1,7,11,0,11
1082622,2,1,7,14,0,14
1082627,2,1,7,8,0,8
1082636,2,1,7,0,0,0
1082639,2,1,7,3,0,3
1082644,2,1,7,10,0,10
335997,1,2,7,5,2,7
336011,1,2,7,5,1,6
336017,1,2,7,3,0,3
336021,1,2,7,3,0,3
336031,1,2,7,2,0,2
336034,1,2,7,4,0,4
336039,1,2,7,5,0,5
392187,1,2,7,10,0,10
392196,1,2,7,4,0,4
392199,1,2,7,4,0,4
392209,1,2,7,6,0,6
392218,1,2,7,8,1,9
392241,1,2,7,6,0,6
419114,1,2,7,11,0,11
419128,1,2,7,10,4,14
419138,1,2,7,3,0,3
419150,1,2,7,8,0,8
501210,1,2,7,5,0,5
501237,1,2,7,1,0,1
501249,1,2,7,6,1,7
501273,1,2,7,5,2,7
501275,1,2,7,8,0,8
548315,1,2,7,9,0,9
548323,1,2,7,6,0,6
548341,1,2,7,3,0,3
548355,1,2,7,4,0,4
548367,1,2,7,2,1,3
548372,1,2,7,8,0,8
548377,1,2,7,9,0,9
598004,1,2,7,1,4,5
598009,1,2,7,2,0,2
598017,1,2,7,2,0,2
598032,1,2,7,17,1,18
598041,1,2,7,6,0,6
598047,1,2,7,10,0,10
598050,1,2,7,6,0,6
598059,1,2,7,8,0,8
598062,1,2,7,6,0,6
598069,1,2,7,7,2,9
598073,1,2,7,13,1,14
729310,1,2,7,4,0,4
729318,1,2,7,6,0,6
734004,1,2,7,2,0,2
734010,1,2,7,3,0,3
734026,1,2,7,4,0,4
734040,1,2,7,4,1,5
829724,1,2,7,4,6,10
829768,1,2,7,15,0,15
829790,1,2,7,3,0,3
829800,1,2,7,7,0,7
829824,1,2,7,3,0,3
829826,1,2,7,7,0,7
980912,1,2,7,3,0,3
980926,1,2,7,9,0,9
980932,1,2,7,6,1,7
980936,1,2,7,5,0,5
980942,1,2,7,5,0,5
980964,1,2,7,11,0,11
980982,1,2,7,5,0,5
980986,1,2,7,8,0,8
980992,1,2,7,8,0,8
981004,1,2,7,18,1,19
1082595,1,2,7,4,0,4
1082598,1,2,7,8,0,8
1082602,1,2,7,7,2,9
1082610,1,2,7,9,0,9
1082621,1,2,7,10,0,10
1082628,1,2,7,4,0,4
1082636,1,2,7,9,0,9
1082646,1,2,7,4,0,4
335987,2,2,7,5,2,7
335990,2,2,7,6,0,6
336001,2,2,7,9,2,11
336003,2,2,7,4,0,4
336007,2,2,7,3,0,3
336015,2,2,7,2,1,3
336028,2,2,7,3,1,4
392190,2,2,7,2,0,2
392193,2,2,7,7,0,7
392204,2,2,7,3,0,3
392213,2,2,7,2,1,3
392223,2,2,7,4,0,4
392226,2,2,7,4,1,5
392229,2,2,7,5,0,5
392237,2,2,7,6,0,6
392243,2,2,7,4,0,4
392244,2,2,7,6,0,6
419117,2,2,7,5,1,6
419120,2,2,7,3,0,3
419124,2,2,7,9,0,9
419133,2,2,7,8,1,9
419141,2,2,7,3,0,3
419145,2,2,7,4,0,4
419153,2,2,7,3,0,3
419156,2,2,7,8,0,8
419159,2,2,7,9,1,10
419162,2,2,7,3,1,4
419167,2,2,7,10,2,12
419169,2,2,7,2,0,2
501205,2,2,7,11,0,11
501213,2,2,7,3,0,3
501216,2,2,7,5,0,5
501227,2,2,7,3,0,3
501232,2,2,7,12,1,13
501252,2,2,7,5,0,5
501257,2,2,7,3,0,3
501260,2,2,7,5,0,5
501265,2,2,7,9,0,9
501271,2,2,7,4,0,4
501276,2,2,7,3,0,3
548320,2,2,7,3,0,3
548329,2,2,7,4,1,5
548332,2,2,7,5,0,5
548336,2,2,7,3,0,3
548349,2,2,7,3,0,3
548361,2,2,7,10,0,10
548365,2,2,7,4,0,4
548381,2,2,7,4,0,4
598013,2,2,7,7,0,7
598022,2,2,7,4,0,4
598028,2,2,7,5,0,5
598038,2,2,7,3,0,3
598053,2,2,7,1,0,1
729286,2,2,7,5,0,5
729292,2,2,7,6,0,6
729304,2,2,7,8,4,12
733982,2,2,7,2,0,2
733988,2,2,7,2,1,3
733996,2,2,7,5,0,5
734018,2,2,7,9,7,16
734032,2,2,7,10,0,10
829718,2,2,7,6,0,6
829742,2,2,7,4,0,4
829750,2,2,7,6,0,6
829754,2,2,7,11,0,11
829762,2,2,7,11,0,11
829776,2,2,7,18,0,18
829784,2,2,7,7,0,7
829808,2,2,7,6,2,8
980958,2,2,7,7,0,7
980974,2,2,7,4,0,4
981000,2,2,7,2,0,2
981016,2,2,7,5,0,5
981018,2,2,7,10,0,10
981024,2,2,7,10,0,10
1082591,2,2,7,7,0,7
1082607,2,2,7,7,0,7
1082617,2,2,7,0,1,1
1082624,2,2,7,4,0,4
1082633,2,2,7,4,0,4
335988,1,3,7,9,0,9
335994,1,3,7,5,1,6
336001,1,3,7,7,0,7
336006,1,3,7,6,1,7
336010,1,3,7,3,0,3
336012,1,3,7,9,0,9
336018,1,3,7,10,1,11
336023,1,3,7,8,0,8
336045,1,3,7,9,0,9
392190,1,3,7,9,0,9
392201,1,3,7,3,0,3
392207,1,3,7,7,0,7
392211,1,3,7,5,0,5
392214,1,3,7,8,0,8
392219,1,3,7,5,0,5
392229,1,3,7,2,0,2
392236,1,3,7,8,5,13
392239,1,3,7,4,0,4
392243,1,3,7,9,0,9
419118,1,3,7,10,0,10
419130,1,3,7,4,0,4
419142,1,3,7,11,0,11
419147,1,3,7,6,5,11
419152,1,3,7,6,0,6
419160,1,3,7,5,0,5
419168,1,3,7,4,0,4
419170,1,3,7,3,0,3
501203,1,3,7,12,0,12
501211,1,3,7,8,0,8
501216,1,3,7,9,0,9
501220,1,3,7,5,0,5
501231,1,3,7,3,0,3
501241,1,3,7,3,0,3
501250,1,3,7,5,0,5
501254,1,3,7,11,0,11
501258,1,3,7,1,0,1
501266,1,3,7,6,0,6
501271,1,3,7,3,1,4
501276,1,3,7,5,0,5
548311,1,3,7,4,2,6
548316,1,3,7,11,0,11
548321,1,3,7,6,0,6
548327,1,3,7,6,0,6
548335,1,3,7,1,0,1
548352,1,3,7,7,0,7
548357,1,3,7,2,0,2
548360,1,3,7,4,1,5
548376,1,3,7,2,1,3
548384,1,3,7,6,0,6
548385,1,3,7,12,0,12
548386,1,3,7,9,0,9
598025,1,3,7,9,0,9
598039,1,3,7,5,0,5
598043,1,3,7,5,0,5
598046,1,3,7,8,0,8
598056,1,3,7,5,0,5
598063,1,3,7,7,0,7
598067,1,3,7,9,5,14
598075,1,3,7,5,0,5
729288,1,3,7,4,2,6
729298,1,3,7,9,0,9
729302,1,3,7,2,0,2
733976,1,3,7,7,1,8
734018,1,3,7,5,1,6
734028,1,3,7,6,0,6
734034,1,3,7,8,0,8
829712,1,3,7,6,0,6
829716,1,3,7,15,1,16
829728,1,3,7,3,1,4
829740,1,3,7,1,0,1
829750,1,3,7,2,0,2
829758,1,3,7,14,6,20
829770,1,3,7,2,0,2
829784,1,3,7,6,1,7
829794,1,3,7,5,0,5
829802,1,3,7,7,0,7
829806,1,3,7,8,0,8
335998,2,3,7,10,0,10
336014,2,3,7,9,0,9
336030,2,3,7,4,0,4
336034,2,3,7,9,0,9
336038,2,3,7,6,1,7
336042,2,3,7,9,0,9
336044,2,3,7,8,1,9
392186,2,3,7,15,0,15
392194,2,3,7,19,5,24
392207,2,3,7,0,0,0
392222,2,3,7,0,3,3
392232,2,3,7,4,0,4
419115,2,3,7,15,1,16
419121,2,3,7,6,2,8
419126,2,3,7,9,0,9
419128,2,3,7,4,0,4
419134,2,3,7,9,1,10
419138,2,3,7,6,0,6
419158,2,3,7,9,0,9
419164,2,3,7,11,0,11
501226,2,3,7,9,0,9
501233,2,3,7,5,0,5
501245,2,3,7,9,1,10
501273,2,3,7,3,0,3
548323,2,3,7,5,0,5
548337,2,3,7,8,0,8
548348,2,3,7,9,0,9
548366,2,3,7,4,0,4
548369,2,3,7,10,0,10
548373,2,3,7,7,0,7
598007,2,3,7,3,1,4
598012,2,3,7,4,1,5
598017,2,3,7,6,0,6
598020,2,3,7,7,0,7
598027,2,3,7,3,0,3
598031,2,3,7,3,0,3
598035,2,3,7,2,0,2
598051,2,3,7,2,0,2
598073,2,3,7,11,1,12
598078,2,3,7,3,0,3
729308,2,3,7,9,0,9
729316,2,3,7,6,0,6
733986,2,3,7,3,0,3
733992,2,3,7,7,0,7
734000,2,3,7,4,0,4
734008,2,3,7,3,1,4
734040,2,3,7,5,0,5
734050,2,3,7,2,2,4
734052,2,3,7,3,0,3
829734,2,3,7,14,3,17
829778,2,3,7,10,0,10
829814,2,3,7,6,2,8
829822,2,3,7,5,2,7
829826,2,3,7,5,2,7
829828,2,3,7,6,1,7
335992,1,4,7,5,0,5
335996,1,4,7,9,1,10
336008,1,4,7,8,0,8
336024,1,4,7,17,0,17
336033,1,4,7,9,1,10
336040,1,4,7,11,0,11
336044,1,4,7,0,0,0
392188,1,4,7,1,0,1
392191,1,4,7,2,0,2
392200,1,4,7,4,0,4
392205,1,4,7,6,0,6
392227,1,4,7,5,5,10
392234,1,4,7,7,0,7
419113,1,4,7,5,0,5
419117,1,4,7,5,0,5
419126,1,4,7,3,0,3
419137,1,4,7,7,0,7
419141,1,4,7,5,0,5
419148,1,4,7,6,0,6
419161,1,4,7,7,0,7
419164,1,4,7,9,0,9
501207,1,4,7,4,1,5
501225,1,4,7,8,0,8
501239,1,4,7,1,0,1
501253,1,4,7,10,1,11
501256,1,4,7,10,5,15
501262,1,4,7,1,0,1
501265,1,4,7,10,1,11
548328,1,4,7,5,0,5
548333,1,4,7,5,0,5
548336,1,4,7,10,0,10
548344,1,4,7,0,0,0
548348,1,4,7,8,0,8
548364,1,4,7,5,0,5
548374,1,4,7,7,0,7
548379,1,4,7,6,1,7
598012,1,4,7,7,0,7
598019,1,4,7,5,0,5
598021,1,4,7,9,0,9
598026,1,4,7,2,4,6
598033,1,4,7,1,2,3
598036,1,4,7,5,0,5
598057,1,4,7,14,0,14
598071,1,4,7,8,0,8
729300,1,4,7,9,0,9
729312,1,4,7,5,0,5
733978,1,4,7,5,1,6
733992,1,4,7,7,0,7
733996,1,4,7,5,0,5
734002,1,4,7,4,0,4
734030,1,4,7,11,0,11
734038,1,4,7,3,0,3
734052,1,4,7,10,1,11
734054,1,4,7,4,0,4
829722,1,4,7,5,0,5
829730,1,4,7,3,1,4
829738,1,4,7,2,0,2
829772,1,4,7,4,0,4
829796,1,4,7,3,0,3
829808,1,4,7,13,0,13
829814,1,4,7,2,0,2
980910,1,4,7,3,2,5
980918,1,4,7,8,0,8
980930,1,4,7,3,0,3
980940,1,4,7,4,0,4
980960,1,4,7,7,1,8
980976,1,4,7,3,0,3
980996,1,4,7,4,0,4
981010,1,4,7,4,0,4
1082601,1,4,7,4,1,5
1082612,1,4,7,6,0,6
1082616,1,4,7,2,1,3
1082633,1,4,7,4,0,4
1082637,1,4,7,10,0,10
1082639,1,4,7,4,0,4
1082641,1,4,7,14,0,14
1082645,1,4,7,1,1,2
335988,2,4,7,5,1,6
336000,2,4,7,7,0,7
336004,2,4,7,4,1,5
336011,2,4,7,3,0,3
336018,2,4,7,10,0,10
336021,2,4,7,3,0,3
336027,2,4,7,11,1,12
336036,2,4,7,4,0,4
392196,2,4,7,13,0,13
392209,2,4,7,11,0,11
392212,2,4,7,6,2,8
392215,2,4,7,2,0,2
392219,2,4,7,4,0,4
392221,2,4,7,11,0,11
392231,2,4,7,2,0,2
392239,2,4,7,3,0,3
419122,2,4,7,12,0,12
419129,2,4,7,4,1,5
419132,2,4,7,9,1,10
419144,2,4,7,5,1,6
419151,2,4,7,4,0,4
419154,2,4,7,3,0,3
501211,2,4,7,7,0,7
501217,2,4,7,12,1,13
501228,2,4,7,13,0,13
501242,2,4,7,9,0,9
501249,2,4,7,11,0,11
501259,2,4,7,5,0,5
501269,2,4,7,7,1,8
548314,2,4,7,8,1,9
548318,2,4,7,3,1,4
548324,2,4,7,7,0,7
548339,2,4,7,4,0,4
548355,2,4,7,8,0,8
548359,2,4,7,18,0,18
548371,2,4,7,11,0,11
548376,2,4,7,8,0,8
598008,2,4,7,7,0,7
598030,2,4,7,4,0,4
598042,2,4,7,5,0,5
598046,2,4,7,7,0,7
598050,2,4,7,4,1,5
598061,2,4,7,3,1,4
598064,2,4,7,3,0,3
598069,2,4,7,4,0,4
729288,2,4,7,8,0,8
729296,2,4,7,17,0,17
729318,2,4,7,7,0,7
734012,2,4,7,9,0,9
734024,2,4,7,8,1,9
734044,2,4,7,7,5,12
734048,2,4,7,7,0,7
829714,2,4,7,2,0,2
829746,2,4,7,7,0,7
829758,2,4,7,2,1,3
829764,2,4,7,6,0,6
829780,2,4,7,4,1,5
829790,2,4,7,5,0,5
829804,2,4,7,8,0,8
980924,2,4,7,4,0,4
980946,2,4,7,9,1,10
980968,2,4,7,4,2,6
980982,2,4,7,7,0,7
980990,2,4,7,6,4,10
981004,2,4,7,16,1,17
1082594,2,4,7,3,0,3
1082598,2,4,7,5,0,5
1082605,2,4,7,6,1,7
1082609,2,4,7,2,0,2
1082623,2,4,7,8,0,8
1082626,2,4,7,9,0,9
335989,1,5,7,4,0,4
336005,1,5,7,8,0,8
336013,1,5,7,4,4,8
336028,1,5,7,7,5,12
336038,1,5,7,8,2,10
336043,1,5,7,7,0,7
392195,1,5,7,6,1,7
392215,1,5,7,6,0,6
392222,1,5,7,6,1,7
392230,1,5,7,3,0,3
392238,1,5,7,1,0,1
419116,1,5,7,2,0,2
419120,1,5,7,2,0,2
419123,1,5,7,1,2,3
419129,1,5,7,7,0,7
419134,1,5,7,10,0,10
419146,1,5,7,5,0,5
419159,1,5,7,1,0,1
419163,1,5,7,11,0,11
501214,1,5,7,5,1,6
501219,1,5,7,3,0,3
501245,1,5,7,5,0,5
501257,1,5,7,7,0,7
501263,1,5,7,5,1,6
548314,1,5,7,3,1,4
548317,1,5,7,9,0,9
548325,1,5,7,2,0,2
548329,1,5,7,4,0,4
548337,1,5,7,2,0,2
548354,1,5,7,5,1,6
548359,1,5,7,4,0,4
548366,1,5,7,4,2,6
548370,1,5,7,6,0,6
548378,1,5,7,4,0,4
548382,1,5,7,9,0,9
598006,1,5,7,5,0,5
598010,1,5,7,6,1,7
598014,1,5,7,5,0,5
598024,1,5,7,3,0,3
598028,1,5,7,3,0,3
598031,1,5,7,16,0,16
598048,1,5,7,5,0,5
598077,1,5,7,2,0,2
729296,1,5,7,8,0,8
729320,1,5,7,4,0,4
733984,1,5,7,8,0,8
734008,1,5,7,8,0,8
734016,1,5,7,4,3,7
734046,1,5,7,3,0,3
829714,1,5,7,9,1,10
829746,1,5,7,5,2,7
829754,1,5,7,6,0,6
829782,1,5,7,10,0,10
829816,1,5,7,13,1,14
335992,2,5,7,7,0,7
335995,2,5,7,9,0,9
335997,2,5,7,7,0,7
336010,2,5,7,2,12,14
336016,2,5,7,6,1,7
336020,2,5,7,11,1,12
336024,2,5,7,7,1,8
336032,2,5,7,4,0,4
336041,2,5,7,11,0,11
336045,2,5,7,3,0,3
392187,2,5,7,2,1,3
392200,2,5,7,6,0,6
392203,2,5,7,3,0,3
392207,2,5,7,3,1,4
392210,2,5,7,5,0,5
392218,2,5,7,4,0,4
392225,2,5,7,5,0,5
392235,2,5,7,1,1,2
419112,2,5,7,4,0,4
419131,2,5,7,9,2,11
419139,2,5,7,15,0,15
419142,2,5,7,5,1,6
419148,2,5,7,12,0,12
419155,2,5,7,5,1,6
501204,2,5,7,7,0,7
501209,2,5,7,2,0,2
501225,2,5,7,3,0,3
501230,2,5,7,8,0,8
501236,2,5,7,4,0,4
501240,2,5,7,9,0,9
501254,2,5,7,6,0,6
501268,2,5,7,14,0,14
548322,2,5,7,9,1,10
548331,2,5,7,8,0,8
548341,2,5,7,8,0,8
548350,2,5,7,7,0,7
548363,2,5,7,5,0,5
598019,2,5,7,9,1,10
598037,2,5,7,10,0,10
598041,2,5,7,2,1,3
598052,2,5,7,10,0,10
598054,2,5,7,5,1,6
598057,2,5,7,9,0,9
598063,2,5,7,7,0,7
598068,2,5,7,2,1,3
598070,2,5,7,4,0,4
598076,2,5,7,6,0,6
729290,2,5,7,6,0,6
729302,2,5,7,6,0,6
729310,2,5,7,4,0,4
733980,2,5,7,9,0,9
733994,2,5,7,5,0,5
734004,2,5,7,9,0,9
734022,2,5,7,11,0,11
734038,2,5,7,10,0,10
829720,2,5,7,8,0,8
829726,2,5,7,7,0,7
829732,2,5,7,11,1,12
829740,2,5,7,4,0,4
829774,2,5,7,4,3,7
829792,2,5,7,5,1,6
829802,2,5,7,7,0,7
829824,2,5,7,10,0,10
336000,1,6,7,7,2,9
336003,1,6,7,13,0,13
336014,1,6,7,7,2,9
336020,1,6,7,5,0,5
336025,1,6,7,8,0,8
336027,1,6,7,6,1,7
392194,1,6,7,8,0,8
392203,1,6,7,6,0,6
392228,1,6,7,4,0,4
392231,1,6,7,7,0,7
392235,1,6,7,2,1,3
392237,1,6,7,8,0,8
392242,1,6,7,11,0,11
419121,1,6,7,14,1,15
419133,1,6,7,11,0,11
419136,1,6,7,4,0,4
419139,1,6,7,6,0,6
419145,1,6,7,3,0,3
419154,1,6,7,2,6,8
501206,1,6,7,2,0,2
501209,1,6,7,6,0,6
501228,1,6,7,9,0,9
501232,1,6,7,4,0,4
501238,1,6,7,2,0,2
501243,1,6,7,5,1,6
501270,1,6,7,5,0,5
548347,1,6,7,8,1,9
548350,1,6,7,10,1,11
548362,1,6,7,7,5,12
548369,1,6,7,4,1,5
598003,1,6,7,2,0,2
598015,1,6,7,3,0,3
598022,1,6,7,6,0,6
598040,1,6,7,9,0,9
598049,1,6,7,5,1,6
598054,1,6,7,4,0,4
598064,1,6,7,3,2,5
729286,1,6,7,2,3,5
733980,1,6,7,4,0,4
733986,1,6,7,3,0,3
733990,1,6,7,8,2,10
733998,1,6,7,8,0,8
734024,1,6,7,11,0,11
734044,1,6,7,6,0,6
829720,1,6,7,3,0,3
829736,1,6,7,6,0,6
829744,1,6,7,3,6,9
829752,1,6,7,4,0,4
829762,1,6,7,1,1,2
829788,1,6,7,8,0,8
829818,1,6,7,3,0,3
980908,1,6,7,7,0,7
980938,1,6,7,7,0,7
980956,1,6,7,6,0,6
980970,1,6,7,6,0,6
981002,1,6,7,2,0,2
981016,1,6,7,5,0,5
1082599,1,6,7,3,1,4
1082605,1,6,7,5,1,6
1082608,1,6,7,6,0,6
1082622,1,6,7,7,0,7
1082626,1,6,7,3,1,4
1082642,1,6,7,9,0,9
335989,2,6,7,4,0,4
335993,2,6,7,7,0,7
336006,2,6,7,18,1,19
336009,2,6,7,4,1,5
336022,2,6,7,4,0,4
336031,2,6,7,19,0,19
336037,2,6,7,11,0,11
336043,2,6,7,9,0,9
392199,2,6,7,7,0,7
392206,2,6,7,9,0,9
392211,2,6,7,4,1,5
392216,2,6,7,3,0,3
392220,2,6,7,2,0,2
392224,2,6,7,7,1,8
392240,2,6,7,3,0,3
419113,2,6,7,4,0,4
419116,2,6,7,18,0,18
419119,2,6,7,5,0,5
419125,2,6,7,12,0,12
419149,2,6,7,14,0,14
419157,2,6,7,4,0,4
419160,2,6,7,5,0,5
419165,2,6,7,6,0,6
501218,2,6,7,8,0,8
501221,2,6,7,3,0,3
501235,2,6,7,3,0,3
501248,2,6,7,2,1,3
501251,2,6,7,10,0,10
501258,2,6,7,2,0,2
501262,2,6,7,7,0,7
548312,2,6,7,8,0,8
548315,2,6,7,7,0,7
548321,2,6,7,3,0,3
548326,2,6,7,8,0,8
548330,2,6,7,3,0,3
548334,2,6,7,2,8,10
548338,2,6,7,7,0,7
548342,2,6,7,12,0,12
548354,2,6,7,12,0,12
548374,2,6,7,2,0,2
548377,2,6,7,9,0,9
548379,2,6,7,23,0,23
548383,2,6,7,6,2,8
548385,2,6,7,16,0,16
598006,2,6,7,7,0,7
598011,2,6,7,11,0,11
598025,2,6,7,3,0,3
598029,2,6,7,10,0,10
598033,2,6,7,6,1,7
598045,2,6,7,4,0,4
598059,2,6,7,12,0,12
598067,2,6,7,1,1,2
598072,2,6,7,8,0,8
729294,2,6,7,11,0,11
729298,2,6,7,13,0,13
729306,2,6,7,13,0,13
729314,2,6,7,5,0,5
734010,2,6,7,8,0,8
734016,2,6,7,11,0,11
734036,2,6,7,7,0,7
829712,2,6,7,7,0,7
829730,2,6,7,5,0,5
829766,2,6,7,2,0,2
829772,2,6,7,9,0,9
829782,2,6,7,3,0,3
829798,2,6,7,7,0,7
829806,2,6,7,20,0,20
980918,2,6,7,5,5,10
980926,2,6,7,11,0,11
980950,2,6,7,6,0,6
980966,2,6,7,2,0,2
980976,2,6,7,10,1,11
980988,2,6,7,7,0,7
980998,2,6,7,7,0,7
981008,2,6,7,8,0,8
1082595,2,6,7,10,0,10
1082611,2,6,7,5,0,5
1082614,2,6,7,4,1,5
1082630,2,6,7,7,1,8
1082632,2,6,7,10,0,10
1082635,2,6,7,2,0,2
1082640,2,6,7,7,0,7
1082646,2,6,7,5,0,5
335990,1,7,7,7,0,7
335999,1,7,7,8,0,8
336009,1,7,7,4,0,4
336029,1,7,7,3,4,7
336037,1,7,7,6,4,10
336041,1,7,7,13,0,13
392186,1,7,7,5,0,5
392202,1,7,7,11,0,11
392208,1,7,7,2,0,2
392213,1,7,7,3,0,3
392220,1,7,7,2,0,2
392223,1,7,7,5,0,5
392232,1,7,7,2,0,2
392240,1,7,7,12,1,13
419112,1,7,7,6,0,6
419119,1,7,7,13,0,13
419124,1,7,7,12,0,12
419135,1,7,7,10,1,11
419143,1,7,7,1,0,1
419151,1,7,7,6,0,6
419155,1,7,7,5,1,6
419157,1,7,7,10,0,10
419162,1,7,7,3,1,4
419166,1,7,7,5,0,5
419167,1,7,7,8,0,8
501215,1,7,7,2,2,4
501226,1,7,7,8,0,8
501229,1,7,7,7,1,8
501236,1,7,7,4,0,4
501242,1,7,7,5,0,5
501246,1,7,7,7,0,7
501251,1,7,7,4,0,4
501268,1,7,7,5,0,5
548322,1,7,7,7,0,7
548330,1,7,7,7,0,7
548339,1,7,7,3,0,3
548356,1,7,7,7,0,7
548365,1,7,7,4,0,4
548368,1,7,7,4,1,5
598007,1,7,7,7,1,8
598011,1,7,7,9,4,13
598016,1,7,7,6,0,6
598029,1,7,7,11,0,11
598038,1,7,7,7,0,7
598042,1,7,7,3,0,3
598044,1,7,7,1,0,1
598051,1,7,7,9,0,9
598055,1,7,7,8,1,9
598068,1,7,7,11,0,11
598078,1,7,7,6,0,6
729292,1,7,7,3,1,4
729308,1,7,7,6,0,6
729314,1,7,7,4,0,4
733988,1,7,7,7,1,8
734000,1,7,7,4,0,4
734014,1,7,7,6,0,6
734022,1,7,7,12,0,12
734036,1,7,7,6,0,6
734050,1,7,7,4,0,4
829710,1,7,7,5,0,5
829726,1,7,7,4,0,4
829734,1,7,7,5,0,5
829742,1,7,7,11,0,11
829756,1,7,7,3,0,3
829774,1,7,7,5,0,5
829780,1,7,7,9,0,9
829810,1,7,7,2,0,2
829822,1,7,7,5,0,5
829828,1,7,7,8,0,8
980906,1,7,7,2,1,3
980922,1,7,7,2,0,2
980928,1,7,7,3,0,3
980946,1,7,7,9,1,10
980990,1,7,7,3,2,5
980998,1,7,7,6,0,6
981012,1,7,7,4,1,5
1082592,1,7,7,2,0,2
1082614,1,7,7,8,0,8
1082635,1,7,7,4,1,5
1082638,1,7,7,6,0,6
1082644,1,7,7,6,0,6
1082650,1,7,7,9,0,9
335994,2,7,7,5,0,5
335996,2,7,7,6,1,7
336002,2,7,7,1,4,5
336013,2,7,7,7,0,7
336017,2,7,7,2,3,5
336023,2,7,7,1,2,3
336033,2,7,7,6,0,6
392197,2,7,7,6,1,7
392202,2,7,7,1,0,1
392205,2,7,7,1,2,3
392217,2,7,7,9,0,9
392227,2,7,7,2,0,2
392230,2,7,7,4,0,4
419119,2,7,7,0,1,1
419127,2,7,7,4,0,4
419130,2,7,7,10,1,11
419137,2,7,7,13,0,13
419147,2,7,7,2,1,3
419170,2,7,7,1,4,5
501206,2,7,7,2,1,3
501210,2,7,7,5,0,5
501223,2,7,7,7,2,9
501256,2,7,7,6,0,6
501261,2,7,7,2,0,2
501272,2,7,7,7,2,9
501274,2,7,7,9,0,9
501275,2,7,7,8,0,8
548311,2,7,7,8,0,8
548313,2,7,7,7,0,7
548319,2,7,7,2,1,3
548344,2,7,7,5,0,5
548347,2,7,7,8,0,8
548351,2,7,7,3,1,4
548360,2,7,7,10,0,10
548372,2,7,7,8,0,8
548375,2,7,7,9,0,9
548382,2,7,7,5,8,13
548384,2,7,7,6,0,6
598004,2,7,7,11,0,11
598024,2,7,7,0,0,0
598034,2,7,7,9,0,9
598060,2,7,7,1,0,1
598065,2,7,7,9,2,11
598071,2,7,7,5,0,5
598075,2,7,7,16,0,16
598077,2,7,7,3,0,3
729284,2,7,7,6,0,6
729322,2,7,7,5,1,6
733978,2,7,7,12,0,12
734006,2,7,7,10,0,10
734030,2,7,7,6,0,6
734046,2,7,7,3,1,4
829722,2,7,7,6,0,6
829752,2,7,7,9,2,11
829788,2,7,7,5,0,5
829794,2,7,7,6,0,6
829800,2,7,7,13,0,13
829820,2,7,7,6,3,9
980914,2,7,7,5,0,5
980932,2,7,7,9,0,9
980938,2,7,7,5,0,5
980952,2,7,7,4,0,4
980962,2,7,7,4,0,4
980978,2,7,7,4,2,6
980986,2,7,7,4,0,4
1082597,2,7,7,9,0,9
1082600,2,7,7,3,0,3
1082602,2,7,7,10,0,10
1082606,2,7,7,7,0,7
1082612,2,7,7,4,1,5
1082618,2,7,7,6,0,6
1082625,2,7,7,7,0,7
1082628,2,7,7,3,0,3
1082641,2,7,7,14,0,14
1082647,2,7,7,6,0,6
1082649,2,7,7,8,0,8
335991,1,8,7,6,0,6
335993,1,8,7,9,0,9
335995,1,8,7,3,0,3
336004,1,8,7,4,0,4
336007,1,8,7,10,0,10
336016,1,8,7,4,0,4
336036,1,8,7,3,0,3
336042,1,8,7,7,4,11
392193,1,8,7,4,0,4
392197,1,8,7,12,0,12
392206,1,8,7,4,0,4
392210,1,8,7,1,0,1
392217,1,8,7,9,0,9
392221,1,8,7,3,0,3
392225,1,8,7,12,0,12
392244,1,8,7,14,0,14
419115,1,8,7,6,0,6
419122,1,8,7,9,0,9
419125,1,8,7,10,0,10
419131,1,8,7,5,0,5
419156,1,8,7,8,0,8
419165,1,8,7,13,1,14
419169,1,8,7,0,0,0
501204,1,8,7,3,4,7
501213,1,8,7,10,1,11
501217,1,8,7,4,0,4
501221,1,8,7,7,0,7
501234,1,8,7,0,0,0
501248,1,8,7,4,1,5
501255,1,8,7,4,0,4
501261,1,8,7,5,0,5
501269,1,8,7,7,2,9
548319,1,8,7,1,0,1
548326,1,8,7,8,1,9
548331,1,8,7,6,0,6
548334,1,8,7,9,0,9
548340,1,8,7,9,0,9
548346,1,8,7,3,0,3
548351,1,8,7,2,0,2
548353,1,8,7,3,0,3
548361,1,8,7,2,0,2
548371,1,8,7,2,0,2
548381,1,8,7,7,0,7
335999,2,8,7,23,0,23
336012,2,8,7,8,0,8
336019,2,8,7,3,0,3
336025,2,8,7,2,0,2
336029,2,8,7,10,0,10
336039,2,8,7,10,0,10
392189,2,8,7,1,0,1
392201,2,8,7,4,0,4
392214,2,8,7,10,0,10
392228,2,8,7,5,0,5
392233,2,8,7,3,0,3
392234,2,8,7,3,0,3
392241,2,8,7,5,0,5
392242,2,8,7,3,0,3
419111,2,8,7,4,1,5
419135,2,8,7,7,0,7
419140,2,8,7,9,1,10
419143,2,8,7,4,0,4
419146,2,8,7,4,1,5
419150,2,8,7,11,0,11
419152,2,8,7,1,0,1
419161,2,8,7,9,5,14
419168,2,8,7,6,1,7
501208,2,8,7,9,0,9
501229,2,8,7,3,0,3
501241,2,8,7,8,0,8
501244,2,8,7,5,0,5
501264,2,8,7,4,0,4
548316,2,8,7,4,0,4
548357,2,8,7,6,0,6
548364,2,8,7,11,0,11
548378,2,8,7,2,0,2
501205,1,9,7,7,0,7
501212,1,9,7,5,0,5
501224,1,9,7,4,0,4
501230,1,9,7,7,1,8
501247,1,9,7,3,0,3
501252,1,9,7,8,1,9
501259,1,9,7,14,0,14
501215,2,9,7,7,0,7
501220,2,9,7,7,0,7
501234,2,9,7,3,0,3
501238,2,9,7,1,0,1
501243,2,9,7,4,0,4
501263,2,9,7,9,1,10
501266,2,9,7,5,2,7
501218,1,10,7,3,0,3
501223,1,10,7,2,0,2
501233,1,10,7,4,0,4
501240,1,10,7,6,0,6
501264,1,10,7,6,0,6
501267,1,10,7,3,0,3
548313,1,10,7,4,0,4
548318,1,10,7,3,2,5
548324,1,10,7,2,1,3
548332,1,10,7,4,1,5
548338,1,10,7,4,0,4
548342,1,10,7,11,0,11
548363,1,10,7,3,0,3
598008,1,10,7,3,0,3
598020,1,10,7,4,1,5
598030,1,10,7,9,0,9
598052,1,10,7,5,0,5
598060,1,10,7,10,0,10
598066,1,10,7,3,0,3
598072,1,10,7,7,1,8
501207,2,10,7,10,0,10
501212,2,10,7,7,0,7
501231,2,10,7,3,0,3
501237,2,10,7,3,0,3
501246,2,10,7,7,0,7
501253,2,10,7,5,0,5
501255,2,10,7,3,0,3
548327,2,10,7,5,0,5
548335,2,10,7,2,0,2
548346,2,10,7,9,0,9
548353,2,10,7,4,2,6
548356,2,10,7,3,0,3
548358,2,10,7,5,0,5
548367,2,10,7,6,0,6
548370,2,10,7,4,0,4
548380,2,10,7,4,2,6
598005,2,10,7,8,1,9
598014,2,10,7,3,0,3
598016,2,10,7,6,0,6
598023,2,10,7,8,0,8
598032,2,10,7,3,0,3
598040,2,10,7,15,0,15
598043,2,10,7,3,1,4
598047,2,10,7,7,0,7
598058,2,10,7,3,2,5
598005,1,11,7,8,0,8
598023,1,11,7,4,1,5
598035,1,11,7,9,0,9
598037,1,11,7,6,3,9
598053,1,11,7,5,0,5
598061,1,11,7,11,0,11
598065,1,11,7,11,0,11
598070,1,11,7,9,0,9
598076,1,11,7,4,0,4
729290,1,11,7,3,0,3
729306,1,11,7,2,0,2
729316,1,11,7,10,0,10
729322,1,11,7,4,0,4
733982,1,11,7,6,0,6
733994,1,11,7,7,0,7
734006,1,11,7,6,0,6
734012,1,11,7,2,0,2
734020,1,11,7,8,1,9
734042,1,11,7,12,1,13
829732,1,11,7,5,0,5
829748,1,11,7,7,0,7
829764,1,11,7,5,0,5
829778,1,11,7,3,1,4
829792,1,11,7,2,0,2
829798,1,11,7,6,0,6
829804,1,11,7,1,1,2
829812,1,11,7,20,1,21
829820,1,11,7,3,0,3
980920,1,11,7,5,0,5
980948,1,11,7,2,0,2
980958,1,11,7,8,0,8
980978,1,11,7,10,0,10
980984,1,11,7,4,2,6
980988,1,11,7,3,0,3
981008,1,11,7,4,0,4
981020,1,11,7,4,0,4
981024,1,11,7,6,0,6
1082591,1,11,7,5,0,5
1082600,1,11,7,15,0,15
1082609,1,11,7,11,0,11
1082611,1,11,7,15,1,16
1082615,1,11,7,8,0,8
1082623,1,11,7,12,0,12
1082627,1,11,7,8,0,8
1082630,1,11,7,1,0,1
1082648,1,11,7,7,0,7
598009,2,11,7,5,1,6
598015,2,11,7,5,0,5
598018,2,11,7,4,2,6
598026,2,11,7,10,0,10
598044,2,11,7,7,0,7
598049,2,11,7,2,0,2
598056,2,11,7,3,0,3
598074,2,11,7,4,0,4
729300,2,11,7,4,0,4
734026,2,11,7,3,1,4
734034,2,11,7,7,0,7
829716,2,11,7,7,5,12
829724,2,11,7,8,0,8
829736,2,11,7,3,0,3
829756,2,11,7,5,0,5
829786,2,11,7,19,0,19
980912,2,11,7,7,1,8
980928,2,11,7,3,1,4
980934,2,11,7,7,0,7
980940,2,11,7,9,1,10
980972,2,11,7,1,0,1
980996,2,11,7,6,0,6
981014,2,11,7,3,0,3
981022,2,11,7,3,0,3
1082596,2,11,7,7,1,8
1082604,2,11,7,2,0,2
1082634,2,11,7,2,0,2
1082638,2,11,7,8,1,9
1082643,2,11,7,5,0,5
980916,1,12,7,9,0,9
980924,1,12,7,4,0,4
980944,1,12,7,12,0,12
980954,1,12,7,5,2,7
980962,1,12,7,19,1,20
980974,1,12,7,7,0,7
980994,1,12,7,8,0,8
1082594,1,12,7,7,0,7
1082603,1,12,7,9,0,9
1082607,1,12,7,5,1,6
1082618,1,12,7,7,0,7
1082620,1,12,7,5,0,5
1082624,1,12,7,8,0,8
1082634,1,12,7,5,0,5
1082647,1,12,7,9,0,9
980906,2,12,7,2,2,4
980936,2,12,7,4,1,5
980948,2,12,7,17,0,17
980970,2,12,7,3,0,3
980984,2,12,7,5,0,5
981002,2,12,7,2,0,2
981010,2,12,7,3,0,3
1082592,2,12,7,4,0,4
1082599,2,12,7,2,0,2
1082615,2,12,7,3,0,3
1082629,2,12,7,4,0,4
1082631,2,12,7,3,0,3
1082642,2,12,7,8,1,9
1082645,2,12,7,6,0,6
1082650,2,12,7,4,1,5
980934,1,13,7,5,0,5
980950,1,13,7,11,0,11
980966,1,13,7,4,0,4
980972,1,13,7,4,2,6
981018,1,13,7,8,2,10
981022,1,13,7,8,0,8
1082593,1,13,7,12,0,12
1082596,1,13,7,6,0,6
1082606,1,13,7,3,0,3
1082625,1,13,7,2,1,3
1082629,1,13,7,10,1,11
1082632,1,13,7,6,0,6
1082640,1,13,7,12,0,12
1082643,1,13,7,10,2,12
980910,2,13,7,11,0,11
980916,2,13,7,13,0,13
980922,2,13,7,9,2,11
980942,2,13,7,5,1,6
980954,2,13,7,12,0,12
980960,2,13,7,2,1,3
980980,2,13,7,17,0,17
980992,2,13,7,3,0,3
981006,2,13,7,9,7,16
981012,2,13,7,10,0,10
1082603,2,13,7,10,0,10
1082610,2,13,7,7,3,10
1082613,2,13,7,7,0,7
1082616,2,13,7,8,0,8
1082621,2,13,7,2,0,2
1082637,2,13,7,11,0,11
335987,1,1,8,5,0,5
335998,1,1,8,2,0,2
336002,1,1,8,2,0,2
336015,1,1,8,4,0,4
336019,1,1,8,9,1,10
336022,1,1,8,6,0,6
336026,1,1,8,0,0,0
336030,1,1,8,6,0,6
336032,1,1,8,6,0,6
392189,1,1,8,1,1,2
392204,1,1,8,5,0,5
392212,1,1,8,6,0,6
392216,1,1,8,3,0,3
392224,1,1,8,3,0,3
392226,1,1,8,1,0,1
392233,1,1,8,5,1,6
419111,1,1,8,3,0,3
419127,1,1,8,10,0,10
419132,1,1,8,1,0,1
419140,1,1,8,9,0,9
419144,1,1,8,3,0,3
419149,1,1,8,8,0,8
419153,1,1,8,4,0,4
419158,1,1,8,4,5,9
501208,1,1,8,2,0,2
501227,1,1,8,4,0,4
501235,1,1,8,5,0,5
501244,1,1,8,9,0,9
501260,1,1,8,2,0,2
501272,1,1,8,8,0,8
501274,1,1,8,10,0,10
548312,1,1,8,6,0,6
548320,1,1,8,13,0,13
548349,1,1,8,10,0,10
548358,1,1,8,6,1,7
548373,1,1,8,15,0,15
548375,1,1,8,5,1,6
548380,1,1,8,5,1,6
548383,1,1,8,4,0,4
598013,1,1,8,7,0,7
598018,1,1,8,5,0,5
598027,1,1,8,6,0,6
598034,1,1,8,3,0,3
598045,1,1,8,7,0,7
598058,1,1,8,2,0,2
598074,1,1,8,5,0,5
729284,1,1,8,7,0,7
729294,1,1,8,6,0,6
729304,1,1,8,9,0,9
734032,1,1,8,7,0,7
734048,1,1,8,9,0,9
829718,1,1,8,4,0,4
829766,1,1,8,11,0,11
829776,1,1,8,13,0,13
829786,1,1,8,8,0,8
980914,1,1,8,6,0,6
980952,1,1,8,4,0,4
980968,1,1,8,8,0,8
980980,1,1,8,7,1,8
981000,1,1,8,7,0,7
981006,1,1,8,2,0,2
981014,1,1,8,9,0,9
1082597,1,1,8,2,0,2
1082604,1,1,8,6,0,6
1082613,1,1,8,5,1,6
1082617,1,1,8,5,0,5
1082631,1,1,8,8,0,8
1082649,1,1,8,5,0,5
335991,2,1,8,1,0,1
336005,2,1,8,15,1,16
336008,2,1,8,7,0,7
336040,2,1,8,5,0,5
392191,2,1,8,10,0,10
392195,2,1,8,13,4,17
392202,2,1,8,3,0,3
392208,2,1,8,5,0,5
392236,2,1,8,4,0,4
392238,2,1,8,5,0,5
419114,2,1,8,2,0,2
419118,2,1,8,3,2,5
419123,2,1,8,7,0,7
419136,2,1,8,5,0,5
419163,2,1,8,8,1,9
419166,2,1,8,7,0,7
501203,2,1,8,4,0,4
501214,2,1,8,9,0,9
501219,2,1,8,4,1,5
501224,2,1,8,7,0,7
501239,2,1,8,4,0,4
501247,2,1,8,5,0,5
501250,2,1,8,5,0,5
501267,2,1,8,9,1,10
548317,2,1,8,7,1,8
548325,2,1,8,3,4,7
548328,2,1,8,7,0,7
548333,2,1,8,4,0,4
548340,2,1,8,6,2,8
548352,2,1,8,9,2,11
548362,2,1,8,3,1,4
548368,2,1,8,9,0,9
548386,2,1,8,8,0,8
598003,2,1,8,6,0,6
598010,2,1,8,2,1,3
598021,2,1,8,6,0,6
598036,2,1,8,3,0,3
598039,2,1,8,5,0,5
598048,2,1,8,10,0,10
598055,2,1,8,6,0,6
598062,2,1,8,8,0,8
598066,2,1,8,9,0,9
729312,2,1,8,3,0,3
729320,2,1,8,8,0,8
733976,2,1,8,8,2,10
733984,2,1,8,5,0,5
733990,2,1,8,8,1,9
734002,2,1,8,4,0,4
734014,2,1,8,2,1,3
734020,2,1,8,9,0,9
734028,2,1,8,4,1,5
734042,2,1,8,4,0,4
734054,2,1,8,6,0,6
829710,2,1,8,13,0,13
829728,2,1,8,9,0,9
829738,2,1,8,0,0,0
829744,2,1,8,10,0,10
829748,2,1,8,14,0,14
829770,2,1,8,3,0,3
829796,2,1,8,5,0,5
829810,2,1,8,2,2,4
829816,2,1,8,11,0,11
980908,2,1,8,4,0,4
980920,2,1,8,8,0,8
980930,2,1,8,7,1,8
980944,2,1,8,6,0,6
980956,2,1,8,8,0,8
980964,2,1,8,5,2,7
981020,2,1,8,3,0,3
1082593,2,1,8,7,0,7
1082601,2,1,8,10,0,10
1082608,2,1,8,9,0,9
1082620,2,1,8,20,0,20
1082622,2,1,8,19,0,19
1082627,2,1,8,6,0,6
1082636,2,1,8,5,0,5
1082639,2,1,8,3,1,4
1082644,2,1,8,17,0,17
335997,1,2,8,4,0,4
336011,1,2,8,8,0,8
336017,1,2,8,1,0,1
336021,1,2,8,6,0,6
336031,1,2,8,18,0,18
336034,1,2,8,4,2,6
336039,1,2,8,6,0,6
392187,1,2,8,7,0,7
392196,1,2,8,9,0,9
392199,1,2,8,13,0,13
392209,1,2,8,8,0,8
392218,1,2,8,2,0,2
392241,1,2,8,12,0,12
419114,1,2,8,7,2,9
419128,1,2,8,5,2,7
419138,1,2,8,4,0,4
419150,1,2,8,4,0,4
501210,1,2,8,6,0,6
501237,1,2,8,9,0,9
501249,1,2,8,22,0,22
501273,1,2,8,8,1,9
501275,1,2,8,14,0,14
548315,1,2,8,4,0,4
548323,1,2,8,5,2,7
548341,1,2,8,10,0,10
548355,1,2,8,7,0,7
548367,1,2,8,8,0,8
548372,1,2,8,4,0,4
548377,1,2,8,13,0,13
598004,1,2,8,7,1,8
598009,1,2,8,1,0,1
598017,1,2,8,11,0,11
598032,1,2,8,29,0,29
598041,1,2,8,5,0,5
598047,1,2,8,6,0,6
598050,1,2,8,3,0,3
598059,1,2,8,7,0,7
598062,1,2,8,14,0,14
598069,1,2,8,5,1,6
598073,1,2,8,16,0,16
729310,1,2,8,0,1,1
729318,1,2,8,6,0,6
734004,1,2,8,7,0,7
734010,1,2,8,6,1,7
734026,1,2,8,7,0,7
734040,1,2,8,2,0,2
829724,1,2,8,2,0,2
829768,1,2,8,2,0,2
829790,1,2,8,8,0,8
829800,1,2,8,15,0,15
829824,1,2,8,2,0,2
829826,1,2,8,2,0,2
980912,1,2,8,9,0,9
980926,1,2,8,7,0,7
980932,1,2,8,7,3,10
980936,1,2,8,4,0,4
980942,1,2,8,5,0,5
980964,1,2,8,9,0,9
980982,1,2,8,3,0,3
980986,1,2,8,4,0,4
980992,1,2,8,9,0,9
981004,1,2,8,11,0,11
1082595,1,2,8,8,0,8
1082598,1,2,8,3,0,3
1082602,1,2,8,3,0,3
1082610,1,2,8,21,0,21
1082621,1,2,8,11,0,11
1082628,1,2,8,6,1,7
1082636,1,2,8,5,0,5
1082646,1,2,8,7,0,7
335987,2,2,8,4,1,5
335990,2,2,8,8,0,8
336001,2,2,8,13,0,13
336003,2,2,8,5,1,6
336007,2,2,8,7,0,7
336015,2,2,8,2,1,3
336028,2,2,8,4,0,4
392190,2,2,8,3,0,3
392193,2,2,8,4,1,5
392204,2,2,8,3,1,4
392213,2,2,8,8,0,8
392223,2,2,8,2,2,4
392226,2,2,8,7,0,7
392229,2,2,8,8,0,8
392237,2,2,8,10,0,10
392243,2,2,8,5,0,5
392244,2,2,8,11,0,11
419117,2,2,8,7,0,7
419120,2,2,8,5,0,5
419124,2,2,8,4,0,4
419133,2,2,8,4,0,4
419141,2,2,8,11,0,11
419145,2,2,8,3,0,3
419153,2,2,8,10,0,10
419156,2,2,8,13,2,15
419159,2,2,8,3,0,3
419162,2,2,8,10,0,10
419167,2,2,8,6,0,6
419169,2,2,8,7,0,7
501205,2,2,8,6,0,6
501213,2,2,8,8,0,8
501216,2,2,8,14,0,14
501227,2,2,8,14,0,14
501232,2,2,8,10,0,10
501252,2,2,8,10,0,10
501257,2,2,8,8,1,9
501260,2,2,8,5,0,5
501265,2,2,8,12,0,12
501271,2,2,8,4,1,5
501276,2,2,8,10,0,10
548320,2,2,8,5,0,5
548329,2,2,8,4,0,4
548332,2,2,8,3,0,3
548336,2,2,8,9,0,9
548349,2,2,8,6,2,8
548361,2,2,8,10,0,10
548365,2,2,8,8,0,8
548381,2,2,8,2,0,2
598013,2,2,8,6,0,6
598022,2,2,8,12,0,12
598028,2,2,8,4,1,5
598038,2,2,8,3,3,6
598053,2,2,8,2,0,2
729286,2,2,8,4,1,5
729292,2,2,8,4,1,5
729304,2,2,8,6,0,6
733982,2,2,8,6,1,7
733988,2,2,8,4,1,5
733996,2,2,8,1,0,1
734018,2,2,8,3,0,3
734032,2,2,8,4,0,4
829718,2,2,8,7,2,9
829742,2,2,8,10,1,11
829750,2,2,8,16,1,17
829754,2,2,8,6,0,6
829762,2,2,8,12,0,12
829776,2,2,8,6,1,7
829784,2,2,8,7,0,7
829808,2,2,8,3,2,5
980958,2,2,8,12,0,12
980974,2,2,8,8,1,9
981000,2,2,8,7,0,7
981016,2,2,8,14,0,14
981018,2,2,8,6,0,6
981024,2,2,8,9,1,10
1082591,2,2,8,13,0,13
1082607,2,2,8,3,1,4
1082617,2,2,8,3,0,3
1082624,2,2,8,2,0,2
1082633,2,2,8,2,0,2
335988,1,3,8,8,0,8
335994,1,3,8,5,0,5
336001,1,3,8,7,0,7
336006,1,3,8,9,2,11
336010,1,3,8,5,0,5
336012,1,3,8,7,0,7
336018,1,3,8,4,0,4
336023,1,3,8,5,1,6
336045,1,3,8,5,1,6
392190,1,3,8,3,5,8
392201,1,3,8,4,0,4
392207,1,3,8,8,0,8
392211,1,3,8,2,0,2
392214,1,3,8,3,4,7
392219,1,3,8,8,0,8
392229,1,3,8,4,1,5
392236,1,3,8,7,0,7
392239,1,3,8,6,1,7
392243,1,3,8,7,0,7
419118,1,3,8,5,2,7
419130,1,3,8,5,1,6
419142,1,3,8,5,0,5
419147,1,3,8,6,1,7
419152,1,3,8,4,0,4
419160,1,3,8,8,0,8
419168,1,3,8,6,1,7
419170,1,3,8,1,0,1
501203,1,3,8,6,0,6
501211,1,3,8,8,0,8
501216,1,3,8,11,1,12
501220,1,3,8,7,0,7
501231,1,3,8,10,0,10
501241,1,3,8,9,0,9
501250,1,3,8,5,0,5
501254,1,3,8,4,0,4
501258,1,3,8,4,0,4
501266,1,3,8,4,0,4
501271,1,3,8,5,0,5
501276,1,3,8,12,0,12
548311,1,3,8,14,0,14
548316,1,3,8,8,0,8
548321,1,3,8,6,0,6
548327,1,3,8,4,2,6
548335,1,3,8,12,0,12
548352,1,3,8,10,0,10
548357,1,3,8,11,0,11
548360,1,3,8,2,1,3
548376,1,3,8,14,0,14
548384,1,3,8,4,1,5
548385,1,3,8,4,0,4
548386,1,3,8,4,2,6
598025,1,3,8,1,1,2
598039,1,3,8,14,0,14
598043,1,3,8,7,0,7
598046,1,3,8,4,1,5
598056,1,3,8,10,0,10
598063,1,3,8,15,0,15
598067,1,3,8,2,0,2
598075,1,3,8,3,0,3
729288,1,3,8,13,0,13
729298,1,3,8,3,0,3
729302,1,3,8,10,0,10
733976,1,3,8,8,0,8
734018,1,3,8,3,0,3
734028,1,3,8,9,0,9
734034,1,3,8,4,0,4
829712,1,3,8,6,0,6
829716,1,3,8,9,1,10
829728,1,3,8,6,1,7
829740,1,3,8,9,0,9
829750,1,3,8,17,0,17
829758,1,3,8,7,0,7
829770,1,3,8,6,0,6
829784,1,3,8,3,1,4
829794,1,3,8,10,0,10
829802,1,3,8,5,0,5
829806,1,3,8,10,0,10
335998,2,3,8,10,1,11
336014,2,3,8,11,2,13
336030,2,3,8,7,1,8
336034,2,3,8,3,0,3
336038,2,3,8,8,1,9
336042,2,3,8,3,3,6
336044,2,3,8,9,0,9
392186,2,3,8,2,0,2
392194,2,3,8,4,1,5
392207,2,3,8,1,0,1
392222,2,3,8,9,0,9
392232,2,3,8,4,0,4
419115,2,3,8,4,0,4
419121,2,3,8,21,0,21
419126,2,3,8,9,0,9
419128,2,3,8,13,0,13
419134,2,3,8,5,0,5
419138,2,3,8,9,0,9
419158,2,3,8,6,1,7
419164,2,3,8,13,1,14
501226,2,3,8,8,0,8
501233,2,3,8,5,1,6
501245,2,3,8,4,0,4
501273,2,3,8,8,0,8
548323,2,3,8,8,0,8
548337,2,3,8,4,0,4
548348,2,3,8,6,0,6
548366,2,3,8,2,0,2
548369,2,3,8,8,0,8
548373,2,3,8,13,4,17
598007,2,3,8,4,0,4
598012,2,3,8,3,0,3
598017,2,3,8,9,0,9
598020,2,3,8,9,0,9
598027,2,3,8,7,0,7
598031,2,3,8,9,0,9
598035,2,3,8,8,0,8
598051,2,3,8,2,0,2
598073,2,3,8,14,0,14
598078,2,3,8,3,0,3
729308,2,3,8,2,0,2
729316,2,3,8,12,0,12
733986,2,3,8,2,4,6
733992,2,3,8,7,1,8
734000,2,3,8,12,2,14
734008,2,3,8,11,1,12
734040,2,3,8,7,0,7
734050,2,3,8,6,2,8
734052,2,3,8,4,0,4
829734,2,3,8,8,0,8
829778,2,3,8,6,1,7
829814,2,3,8,7,1,8
829822,2,3,8,5,0,5
829826,2,3,8,6,0,6
829828,2,3,8,12,0,12
335992,1,4,8,8,3,11
335996,1,4,8,11,0,11
336008,1,4,8,11,0,11
336024,1,4,8,7,0,7
336033,1,4,8,11,0,11
336040,1,4,8,3,0,3
336044,1,4,8,2,0,2
392188,1,4,8,3,0,3
392191,1,4,8,8,0,8
392200,1,4,8,4,0,4
392205,1,4,8,8,0,8
392227,1,4,8,2,0,2
392234,1,4,8,3,0,3
419113,1,4,8,6,0,6
419117,1,4,8,4,1,5
419126,1,4,8,13,0,13
419137,1,4,8,8,0,8
419141,1,4,8,9,5,14
419148,1,4,8,5,0,5
419161,1,4,8,8,0,8
419164,1,4,8,4,0,4
501207,1,4,8,4,0,4
501225,1,4,8,6,0,6
501239,1,4,8,3,0,3
501253,1,4,8,6,0,6
501256,1,4,8,6,0,6
501262,1,4,8,11,1,12
501265,1,4,8,21,0,21
548328,1,4,8,10,0,10
548333,1,4,8,4,0,4
548336,1,4,8,6,0,6
548344,1,4,8,2,0,2
548348,1,4,8,17,0,17
548364,1,4,8,9,3,12
548374,1,4,8,2,0,2
548379,1,4,8,8,0,8
598012,1,4,8,8,2,10
598019,1,4,8,4,0,4
598021,1,4,8,9,1,10
598026,1,4,8,3,0,3
598033,1,4,8,6,1,7
598036,1,4,8,10,0,10
598057,1,4,8,7,0,7
598071,1,4,8,19,1,20
729300,1,4,8,3,2,5
729312,1,4,8,3,0,3
733978,1,4,8,9,0,9
733992,1,4,8,5,1,6
733996,1,4,8,18,1,19
734002,1,4,8,9,0,9
734030,1,4,8,7,5,12
734038,1,4,8,11,0,11
734052,1,4,8,10,1,11
734054,1,4,8,14,0,14
829722,1,4,8,10,0,10
829730,1,4,8,6,1,7
829738,1,4,8,4,0,4
829772,1,4,8,6,0,6
829796,1,4,8,11,0,11
829808,1,4,8,5,0,5
829814,1,4,8,5,0,5
980910,1,4,8,14,0,14
980918,1,4,8,6,1,7
980930,1,4,8,4,0,4
980940,1,4,8,12,0,12
980960,1,4,8,3,0,3
980976,1,4,8,8,0,8
980996,1,4,8,10,0,10
981010,1,4,8,7,0,7
1082601,1,4,8,5,0,5
1082612,1,4,8,6,0,6
1082616,1,4,8,14,0,14
1082633,1,4,8,3,0,3
1082637,1,4,8,9,0,9
1082639,1,4,8,9,0,9
1082641,1,4,8,15,0,15
1082645,1,4,8,5,0,5
335988,2,4,8,15,0,15
336000,2,4,8,6,2,8
336004,2,4,8,9,0,9
336011,2,4,8,4,4,8
336018,2,4,8,8,0,8
336021,2,4,8,9,4,13
336027,2,4,8,8,1,9
336036,2,4,8,6,2,8
392196,2,4,8,4,0,4
392209,2,4,8,7,0,7
392212,2,4,8,9,0,9
392215,2,4,8,7,7,14
392219,2,4,8,11,0,11
392221,2,4,8,4,0,4
392231,2,4,8,3,0,3
392239,2,4,8,3,1,4
419122,2,4,8,9,0,9
419129,2,4,8,6,0,6
419132,2,4,8,6,0,6
419144,2,4,8,11,0,11
419151,2,4,8,7,1,8
419154,2,4,8,6,0,6
501211,2,4,8,5,0,5
501217,2,4,8,5,0,5
501228,2,4,8,16,0,16
501242,2,4,8,6,4,10
501249,2,4,8,3,0,3
501259,2,4,8,7,0,7
501269,2,4,8,13,0,13
548314,2,4,8,7,0,7
548318,2,4,8,7,0,7
548324,2,4,8,5,0,5
548339,2,4,8,7,0,7
548355,2,4,8,9,0,9
548359,2,4,8,6,0,6
548371,2,4,8,3,0,3
548376,2,4,8,4,0,4
598008,2,4,8,4,0,4
598030,2,4,8,6,0,6
598042,2,4,8,7,0,7
598046,2,4,8,10,0,10
598050,2,4,8,9,1,10
598061,2,4,8,5,0,5
598064,2,4,8,3,0,3
598069,2,4,8,7,0,7
729288,2,4,8,11,0,11
729296,2,4,8,4,0,4
729318,2,4,8,6,5,11
734012,2,4,8,18,0,18
734024,2,4,8,10,0,10
734044,2,4,8,6,0,6
734048,2,4,8,1,1,2
829714,2,4,8,8,0,8
829746,2,4,8,6,1,7
829758,2,4,8,2,4,6
829764,2,4,8,6,0,6
829780,2,4,8,8,0,8
829790,2,4,8,9,0,9
829804,2,4,8,6,1,7
980924,2,4,8,4,0,4
980946,2,4,8,7,0,7
980968,2,4,8,5,0,5
980982,2,4,8,8,0,8
980990,2,4,8,5,0,5
981004,2,4,8,2,0,2
1082594,2,4,8,3,0,3
1082598,2,4,8,10,1,11
1082605,2,4,8,1,1,2
1082609,2,4,8,4,0,4
1082623,2,4,8,1,2,3
1082626,2,4,8,9,0,9
335989,1,5,8,3,1,4
336005,1,5,8,7,0,7
336013,1,5,8,12,0,12
336028,1,5,8,16,1,17
336038,1,5,8,13,0,13
336043,1,5,8,6,0,6
392195,1,5,8,9,0,9
392215,1,5,8,9,0,9
392222,1,5,8,5,1,6
392230,1,5,8,10,0,10
392238,1,5,8,4,1,5
419116,1,5,8,0,1,1
419120,1,5,8,6,0,6
419123,1,5,8,8,0,8
419129,1,5,8,3,0,3
419134,1,5,8,5,0,5
419146,1,5,8,12,0,12
419159,1,5,8,11,2,13
419163,1,5,8,6,1,7
501214,1,5,8,8,0,8
501219,1,5,8,4,0,4
501245,1,5,8,12,0,12
501257,1,5,8,13,0,13
501263,1,5,8,18,0,18
548314,1,5,8,2,1,3
548317,1,5,8,10,1,11
548325,1,5,8,1,0,1
548329,1,5,8,5,0,5
548337,1,5,8,7,0,7
548354,1,5,8,8,0,8
548359,1,5,8,10,0,10
548366,1,5,8,4,0,4
548370,1,5,8,5,0,5
548378,1,5,8,7,1,8
548382,1,5,8,8,0,8
598006,1,5,8,5,0,5
598010,1,5,8,4,0,4
598014,1,5,8,5,0,5
598024,1,5,8,7,1,8
598028,1,5,8,13,0,13
598031,1,5,8,3,0,3
598048,1,5,8,8,0,8
598077,1,5,8,10,0,10
729296,1,5,8,5,0,5
729320,1,5,8,4,0,4
733984,1,5,8,4,1,5
734008,1,5,8,8,3,11
734016,1,5,8,8,0,8
734046,1,5,8,5,0,5
829714,1,5,8,8,0,8
829746,1,5,8,8,1,9
829754,1,5,8,9,0,9
829782,1,5,8,8,0,8
829816,1,5,8,4,0,4
335992,2,5,8,4,1,5
335995,2,5,8,16,0,16
335997,2,5,8,9,0,9
336010,2,5,8,3,5,8
336016,2,5,8,8,0,8
336020,2,5,8,10,0,10
336024,2,5,8,3,0,3
336032,2,5,8,3,1,4
336041,2,5,8,1,2,3
336045,2,5,8,7,0,7
392187,2,5,8,9,0,9
392200,2,5,8,3,0,3
392203,2,5,8,9,2,11
392207,2,5,8,3,0,3
392210,2,5,8,9,1,10
392218,2,5,8,8,0,8
392225,2,5,8,8,0,8
392235,2,5,8,11,0,11
419112,2,5,8,15,0,15
419131,2,5,8,4,0,4
419139,2,5,8,11,0,11
419142,2,5,8,12,0,12
419148,2,5,8,9,0,9
419155,2,5,8,7,0,7
501204,2,5,8,8,0,8
501209,2,5,8,7,0,7
501225,2,5,8,1,0,1
501230,2,5,8,2,0,2
501236,2,5,8,4,0,4
501240,2,5,8,3,0,3
501254,2,5,8,7,1,8
501268,2,5,8,14,1,15
548322,2,5,8,11,0,11
548331,2,5,8,4,0,4
548341,2,5,8,1,0,1
548350,2,5,8,8,0,8
548363,2,5,8,3,0,3
598019,2,5,8,0,0,0
598037,2,5,8,2,0,2
598041,2,5,8,15,0,15
598052,2,5,8,9,0,9
598054,2,5,8,6,0,6
598057,2,5,8,8,0,8
598063,2,5,8,4,0,4
598068,2,5,8,15,0,15
598070,2,5,8,2,0,2
598076,2,5,8,5,0,5
729290,2,5,8,6,1,7
729302,2,5,8,3,0,3
729310,2,5,8,6,0,6
733980,2,5,8,5,0,5
733994,2,5,8,3,0,3
734004,2,5,8,6,0,6
734022,2,5,8,2,1,3
734038,2,5,8,2,0,2
829720,2,5,8,7,0,7
829726,2,5,8,8,0,8
829732,2,5,8,3,0,3
829740,2,5,8,6,0,6
829774,2,5,8,8,1,9
829792,2,5,8,4,1,5
829802,2,5,8,2,0,2
829824,2,5,8,5,0,5
336000,1,6,8,4,0,4
336003,1,6,8,4,0,4
336014,1,6,8,8,0,8
336020,1,6,8,7,0,7
336025,1,6,8,3,0,3
336027,1,6,8,13,0,13
392194,1,6,8,9,0,9
392203,1,6,8,8,0,8
392228,1,6,8,8,0,8
392231,1,6,8,3,0,3
392235,1,6,8,8,0,8
392237,1,6,8,5,0,5
392242,1,6,8,8,0,8
419121,1,6,8,10,2,12
419133,1,6,8,4,0,4
419136,1,6,8,9,0,9
419139,1,6,8,7,1,8
419145,1,6,8,8,0,8
419154,1,6,8,3,0,3
501206,1,6,8,1,0,1
501209,1,6,8,2,0,2
501228,1,6,8,12,0,12
501232,1,6,8,11,0,11
501238,1,6,8,2,1,3
501243,1,6,8,2,0,2
501270,1,6,8,4,0,4
548347,1,6,8,7,0,7
548350,1,6,8,5,0,5
548362,1,6,8,2,0,2
548369,1,6,8,5,0,5
598003,1,6,8,6,0,6
598015,1,6,8,3,0,3
598022,1,6,8,3,0,3
598040,1,6,8,14,2,16
598049,1,6,8,2,0,2
598054,1,6,8,2,0,2
598064,1,6,8,5,0,5
729286,1,6,8,1,0,1
733980,1,6,8,7,0,7
733986,1,6,8,4,0,4
733990,1,6,8,13,1,14
733998,1,6,8,7,0,7
734024,1,6,8,5,0,5
734044,1,6,8,8,0,8
829720,1,6,8,3,1,4
829736,1,6,8,11,0,11
829744,1,6,8,11,0,11
829752,1,6,8,7,0,7
829762,1,6,8,3,0,3
829788,1,6,8,5,0,5
829818,1,6,8,4,0,4
980908,1,6,8,7,0,7
980938,1,6,8,6,0,6
980956,1,6,8,7,4,11
980970,1,6,8,5,0,5
981002,1,6,8,2,0,2
981016,1,6,8,14,0,14
1082599,1,6,8,5,0,5
1082605,1,6,8,6,3,9
1082608,1,6,8,4,0,4
1082622,1,6,8,6,0,6
1082626,1,6,8,2,0,2
1082642,1,6,8,10,0,10
335989,2,6,8,11,1,12
335993,2,6,8,5,0,5
336006,2,6,8,9,1,10
336009,2,6,8,11,0,11
336022,2,6,8,10,1,11
336031,2,6,8,5,0,5
336037,2,6,8,5,0,5
336043,2,6,8,3,0,3
392199,2,6,8,8,0,8
392206,2,6,8,6,2,8
392211,2,6,8,7,0,7
392216,2,6,8,2,0,2
392220,2,6,8,4,0,4
392224,2,6,8,5,0,5
392240,2,6,8,9,0,9
419113,2,6,8,4,0,4
419116,2,6,8,4,0,4
419119,2,6,8,9,0,9
419125,2,6,8,8,0,8
419149,2,6,8,9,1,10
419157,2,6,8,5,0,5
419160,2,6,8,6,0,6
419165,2,6,8,6,0,6
501218,2,6,8,10,0,10
501221,2,6,8,11,5,16
501235,2,6,8,4,0,4
501248,2,6,8,23,0,23
501251,2,6,8,6,0,6
501258,2,6,8,2,0,2
501262,2,6,8,3,0,3
548312,2,6,8,3,0,3
548315,2,6,8,5,0,5
548321,2,6,8,11,0,11
548326,2,6,8,16,1,17
548330,2,6,8,7,1,8
548334,2,6,8,12,1,13
548338,2,6,8,18,0,18
548342,2,6,8,4,0,4
548354,2,6,8,11,0,11
548374,2,6,8,2,1,3
548377,2,6,8,9,0,9
548379,2,6,8,11,0,11
548383,2,6,8,5,0,5
548385,2,6,8,7,1,8
598006,2,6,8,7,0,7
598011,2,6,8,4,0,4
598025,2,6,8,8,0,8
598029,2,6,8,9,1,10
598033,2,6,8,5,5,10
598045,2,6,8,11,0,11
598059,2,6,8,3,0,3
598067,2,6,8,5,0,5
598072,2,6,8,2,0,2
729294,2,6,8,4,2,6
729298,2,6,8,5,0,5
729306,2,6,8,12,0,12
729314,2,6,8,9,0,9
734010,2,6,8,11,0,11
734016,2,6,8,3,1,4
734036,2,6,8,3,0,3
829712,2,6,8,4,0,4
829730,2,6,8,3,1,4
829766,2,6,8,13,0,13
829772,2,6,8,5,0,5
829782,2,6,8,1,0,1
829798,2,6,8,4,0,4
829806,2,6,8,4,0,4
980918,2,6,8,12,0,12
980926,2,6,8,4,1,5
980950,2,6,8,9,1,10
980966,2,6,8,6,0,6
980976,2,6,8,9,0,9
980988,2,6,8,12,0,12
980998,2,6,8,4,0,4
981008,2,6,8,7,0,7
1082595,2,6,8,10,2,12
1082611,2,6,8,13,1,14
1082614,2,6,8,6,0,6
1082630,2,6,8,2,1,3
1082632,2,6,8,10,0,10
1082635,2,6,8,3,0,3
1082640,2,6,8,2,0,2
1082646,2,6,8,4,0,4
335990,1,7,8,6,0,6
335999,1,7,8,7,0,7
336009,1,7,8,4,0,4
336029,1,7,8,7,0,7
336037,1,7,8,3,0,3
336041,1,7,8,4,0,4
392186,1,7,8,3,0,3
392202,1,7,8,14,0,14
392208,1,7,8,11,1,12
392213,1,7,8,14,0,14
392220,1,7,8,3,1,4
392223,1,7,8,2,0,2
392232,1,7,8,3,1,4
392240,1,7,8,9,1,10
419112,1,7,8,7,2,9
419119,1,7,8,8,0,8
419124,1,7,8,4,1,5
419135,1,7,8,5,0,5
419143,1,7,8,2,0,2
419151,1,7,8,3,0,3
419155,1,7,8,9,1,10
419157,1,7,8,3,0,3
419162,1,7,8,7,1,8
419166,1,7,8,7,0,7
419167,1,7,8,4,0,4
501215,1,7,8,8,1,9
501226,1,7,8,7,1,8
501229,1,7,8,4,0,4
501236,1,7,8,4,1,5
501242,1,7,8,4,2,6
501246,1,7,8,2,0,2
501251,1,7,8,8,0,8
501268,1,7,8,9,0,9
548322,1,7,8,6,0,6
548330,1,7,8,6,1,7
548339,1,7,8,8,0,8
548356,1,7,8,3,0,3
548365,1,7,8,6,2,8
548368,1,7,8,6,0,6
598007,1,7,8,6,0,6
598011,1,7,8,8,0,8
598016,1,7,8,2,0,2
598029,1,7,8,8,0,8
598038,1,7,8,8,0,8
598042,1,7,8,5,0,5
598044,1,7,8,7,0,7
598051,1,7,8,2,0,2
598055,1,7,8,9,0,9
598068,1,7,8,5,1,6
598078,1,7,8,5,0,5
729292,1,7,8,5,0,5
729308,1,7,8,7,0,7
729314,1,7,8,1,0,1
733988,1,7,8,7,6,13
734000,1,7,8,3,0,3
734014,1,7,8,3,0,3
734022,1,7,8,10,0,10
734036,1,7,8,15,1,16
734050,1,7,8,6,0,6
829710,1,7,8,6,0,6
829726,1,7,8,3,0,3
829734,1,7,8,8,0,8
829742,1,7,8,3,2,5
829756,1,7,8,7,0,7
829774,1,7,8,8,0,8
829780,1,7,8,12,0,12
829810,1,7,8,1,1,2
829822,1,7,8,9,0,9
829828,1,7,8,9,0,9
980906,1,7,8,0,0,0
980922,1,7,8,7,1,8
980928,1,7,8,4,0,4
980946,1,7,8,11,0,11
980990,1,7,8,7,1,8
980998,1,7,8,10,0,10
981012,1,7,8,5,0,5
1082592,1,7,8,3,0,3
1082614,1,7,8,4,0,4
1082635,1,7,8,11,0,11
1082638,1,7,8,3,0,3
1082644,1,7,8,7,4,11
1082650,1,7,8,4,1,5
335994,2,7,8,10,1,11
335996,2,7,8,14,1,15
336002,2,7,8,3,1,4
336013,2,7,8,5,0,5
336017,2,7,8,16,0,16
336023,2,7,8,2,1,3
336033,2,7,8,6,1,7
392197,2,7,8,8,2,10
392202,2,7,8,4,0,4
392205,2,7,8,5,0,5
392217,2,7,8,9,0,9
392227,2,7,8,6,0,6
392230,2,7,8,7,1,8
419119,2,7,8,3,1,4
419127,2,7,8,7,1,8
419130,2,7,8,7,1,8
419137,2,7,8,3,2,5
419147,2,7,8,7,0,7
419170,2,7,8,2,0,2
501206,2,7,8,8,0,8
501210,2,7,8,16,1,17
501223,2,7,8,8,2,10
501256,2,7,8,6,2,8
501261,2,7,8,3,2,5
501272,2,7,8,7,0,7
501274,2,7,8,11,0,11
501275,2,7,8,8,0,8
548311,2,7,8,6,2,8
548313,2,7,8,7,0,7
548319,2,7,8,5,0,5
548344,2,7,8,7,0,7
548347,2,7,8,4,0,4
548351,2,7,8,9,0,9
548360,2,7,8,5,0,5
548372,2,7,8,5,0,5
548375,2,7,8,4,0,4
548382,2,7,8,9,0,9
548384,2,7,8,8,0,8
598004,2,7,8,5,0,5
598024,2,7,8,9,0,9
598034,2,7,8,14,0,14
598060,2,7,8,2,0,2
598065,2,7,8,9,0,9
598071,2,7,8,3,0,3
598075,2,7,8,14,0,14
598077,2,7,8,12,1,13
729284,2,7,8,3,0,3
729322,2,7,8,5,0,5
733978,2,7,8,4,0,4
734006,2,7,8,3,0,3
734030,2,7,8,8,0,8
734046,2,7,8,13,1,14
829722,2,7,8,2,1,3
829752,2,7,8,3,2,5
829788,2,7,8,4,0,4
829794,2,7,8,6,0,6
829800,2,7,8,5,0,5
829820,2,7,8,9,0,9
980914,2,7,8,5,0,5
980932,2,7,8,5,0,5
980938,2,7,8,3,0,3
980952,2,7,8,7,0,7
980962,2,7,8,10,0,10
980978,2,7,8,10,0,10
980986,2,7,8,8,1,9
1082597,2,7,8,13,0,13
1082600,2,7,8,9,0,9
1082602,2,7,8,2,0,2
1082606,2,7,8,6,1,7
1082612,2,7,8,14,0,14
1082618,2,7,8,6,0,6
1082625,2,7,8,3,1,4
1082628,2,7,8,4,0,4
1082641,2,7,8,4,1,5
1082647,2,7,8,3,0,3
1082649,2,7,8,6,0,6
335991,1,8,8,1,1,2
335993,1,8,8,2,0,2
335995,1,8,8,11,0,11
336004,1,8,8,5,0,5
336007,1,8,8,14,0,14
336016,1,8,8,7,0,7
336036,1,8,8,12,0,12
336042,1,8,8,6,1,7
392193,1,8,8,5,1,6
392197,1,8,8,5,0,5
392206,1,8,8,3,4,7
392210,1,8,8,2,1,3
392217,1,8,8,10,0,10
392221,1,8,8,3,0,3
392225,1,8,8,5,0,5
392244,1,8,8,9,0,9
419115,1,8,8,2,1,3
419122,1,8,8,12,0,12
419125,1,8,8,4,0,4
419131,1,8,8,10,0,10
419156,1,8,8,4,0,4
419165,1,8,8,8,0,8
419169,1,8,8,7,0,7
501204,1,8,8,3,0,3
501213,1,8,8,8,0,8
501217,1,8,8,9,0,9
501221,1,8,8,16,0,16
501234,1,8,8,9,0,9
501248,1,8,8,5,0,5
501255,1,8,8,5,0,5
501261,1,8,8,4,1,5
501269,1,8,8,4,5,9
548319,1,8,8,4,0,4
548326,1,8,8,11,0,11
548331,1,8,8,7,0,7
548334,1,8,8,8,0,8
548340,1,8,8,5,0,5
548346,1,8,8,5,0,5
548351,1,8,8,3,0,3
548353,1,8,8,6,0,6
548361,1,8,8,17,0,17
548371,1,8,8,9,0,9
548381,1,8,8,7,0,7
335999,2,8,8,13,1,14
336012,2,8,8,11,2,13
336019,2,8,8,1,4,5
336025,2,8,8,1,0,1
336029,2,8,8,5,1,6
336039,2,8,8,11,0,11
392189,2,8,8,8,0,8
392201,2,8,8,2,0,2
392214,2,8,8,6,1,7
392228,2,8,8,11,0,11
392233,2,8,8,9,0,9
392234,2,8,8,4,1,5
392241,2,8,8,4,1,5
392242,2,8,8,4,0,4
419111,2,8,8,3,1,4
419135,2,8,8,4,0,4
419140,2,8,8,6,0,6
419143,2,8,8,8,0,8
419146,2,8,8,6,0,6
419150,2,8,8,15,0,15
419152,2,8,8,7,0,7
419161,2,8,8,6,0,6
419168,2,8,8,7,0,7
501208,2,8,8,7,1,8
501229,2,8,8,7,6,13
501241,2,8,8,3,0,3
501244,2,8,8,9,1,10
501264,2,8,8,6,0,6
548316,2,8,8,8,0,8
548357,2,8,8,5,0,5
548364,2,8,8,13,0,13
548378,2,8,8,2,0,2
501205,1,9,8,6,0,6
501212,1,9,8,5,2,7
501224,1,9,8,2,0,2
501230,1,9,8,2,0,2
501247,1,9,8,12,1,13
501252,1,9,8,6,0,6
501259,1,9,8,4,6,10
501215,2,9,8,5,0,5
501220,2,9,8,10,0,10
501234,2,9,8,9,0,9
501238,2,9,8,7,0,7
501243,2,9,8,4,3,7
501263,2,9,8,1,0,1
501266,2,9,8,1,0,1
501218,1,10,8,9,1,10
501223,1,10,8,12,1,13
501233,1,10,8,3,0,3
501240,1,10,8,11,0,11
501264,1,10,8,0,0,0
501267,1,10,8,10,0,10
548313,1,10,8,6,0,6
548318,1,10,8,10,0,10
548324,1,10,8,12,0,12
548332,1,10,8,10,1,11
548338,1,10,8,9,0,9
548342,1,10,8,3,0,3
548363,1,10,8,6,1,7
598008,1,10,8,3,0,3
598020,1,10,8,10,0,10
598030,1,10,8,4,0,4
598052,1,10,8,7,1,8
598060,1,10,8,3,1,4
598066,1,10,8,5,0,5
598072,1,10,8,6,0,6
501207,2,10,8,6,0,6
501212,2,10,8,4,0,4
501231,2,10,8,5,0,5
501237,2,10,8,8,0,8
501246,2,10,8,7,0,7
501253,2,10,8,8,2,10
501255,2,10,8,14,0,14
548327,2,10,8,2,0,2
548335,2,10,8,3,1,4
548346,2,10,8,5,0,5
548353,2,10,8,4,0,4
548356,2,10,8,4,0,4
548358,2,10,8,5,0,5
548367,2,10,8,15,0,15
548370,2,10,8,9,1,10
548380,2,10,8,5,1,6
598005,2,10,8,2,0,2
598014,2,10,8,11,1,12
598016,2,10,8,10,1,11
598023,2,10,8,6,0,6
598032,2,10,8,15,0,15
598040,2,10,8,7,0,7
598043,2,10,8,5,0,5
598047,2,10,8,2,1,3
598058,2,10,8,2,0,2
598005,1,11,8,4,0,4
598023,1,11,8,3,0,3
598035,1,11,8,4,0,4
598037,1,11,8,6,2,8
598053,1,11,8,5,0,5
598061,1,11,8,2,1,3
598065,1,11,8,7,0,7
598070,1,11,8,3,1,4
598076,1,11,8,7,0,7
729290,1,11,8,6,0,6
729306,1,11,8,10,0,10
729316,1,11,8,8,0,8
729322,1,11,8,10,5,15
733982,1,11,8,6,0,6
733994,1,11,8,4,0,4
734006,1,11,8,11,0,11
734012,1,11,8,8,0,8
734020,1,11,8,8,0,8
734042,1,11,8,7,0,7
829732,1,11,8,2,1,3
829748,1,11,8,6,0,6
829764,1,11,8,4,0,4
829778,1,11,8,6,0,6
829792,1,11,8,8,1,9
829798,1,11,8,7,0,7
829804,1,11,8,11,0,11
829812,1,11,8,11,0,11
829820,1,11,8,7,0,7
980920,1,11,8,2,0,2
980948,1,11,8,2,1,3
980958,1,11,8,6,0,6
980978,1,11,8,6,0,6
980984,1,11,8,5,0,5
980988,1,11,8,7,0,7
981008,1,11,8,2,1,3
981020,1,11,8,5,1,6
981024,1,11,8,10,0,10
1082591,1,11,8,11,0,11
1082600,1,11,8,2,1,3
1082609,1,11,8,2,0,2
1082611,1,11,8,9,0,9
1082615,1,11,8,2,0,2
1082623,1,11,8,11,0,11
1082627,1,11,8,7,0,7
1082630,1,11,8,8,0,8
1082648,1,11,8,2,0,2
598009,2,11,8,4,0,4
598015,2,11,8,3,0,3
598018,2,11,8,10,0,10
598026,2,11,8,5,0,5
598044,2,11,8,10,0,10
598049,2,11,8,3,0,3
598056,2,11,8,4,0,4
598074,2,11,8,13,0,13
729300,2,11,8,3,2,5
734026,2,11,8,4,0,4
734034,2,11,8,5,0,5
829716,2,11,8,4,0,4
829724,2,11,8,10,0,10
829736,2,11,8,2,0,2
829756,2,11,8,6,1,7
829786,2,11,8,3,0,3
980912,2,11,8,19,0,19
980928,2,11,8,11,1,12
980934,2,11,8,5,1,6
980940,2,11,8,2,1,3
980972,2,11,8,4,0,4
980996,2,11,8,6,1,7
981014,2,11,8,8,0,8
981022,2,11,8,12,0,12
1082596,2,11,8,5,0,5
1082604,2,11,8,1,0,1
1082634,2,11,8,10,0,10
1082638,2,11,8,13,0,13
1082643,2,11,8,6,0,6
980916,1,12,8,10,0,10
980924,1,12,8,7,5,12
980944,1,12,8,4,0,4
980954,1,12,8,8,0,8
980962,1,12,8,9,1,10
980974,1,12,8,8,0,8
980994,1,12,8,8,0,8
1082594,1,12,8,6,0,6
1082603,1,12,8,3,0,3
1082607,1,12,8,7,0,7
1082618,1,12,8,14,0,14
1082620,1,12,8,3,0,3
1082624,1,12,8,6,0,6
1082634,1,12,8,3,0,3
1082647,1,12,8,1,0,1
980906,2,12,8,5,0,5
980936,2,12,8,12,0,12
980948,2,12,8,8,0,8
980970,2,12,8,6,0,6
980984,2,12,8,10,0,10
981002,2,12,8,7,0,7
981010,2,12,8,5,0,5
1082592,2,12,8,10,0,10
1082599,2,12,8,3,0,3
1082615,2,12,8,3,0,3
1082629,2,12,8,4,0,4
1082631,2,12,8,11,0,11
1082642,2,12,8,3,0,3
1082645,2,12,8,6,0,6
1082650,2,12,8,5,0,5
980934,1,13,8,7,0,7
980950,1,13,8,9,0,9
980966,1,13,8,12,1,13
980972,1,13,8,7,0,7
981018,1,13,8,5,0,5
981022,1,13,8,6,0,6
1082593,1,13,8,7,1,8
1082596,1,13,8,8,0,8
1082606,1,13,8,9,0,9
1082625,1,13,8,4,0,4
1082629,1,13,8,5,0,5
1082632,1,13,8,13,0,13
1082640,1,13,8,8,0,8
1082643,1,13,8,3,0,3
980910,2,13,8,15,0,15
980916,2,13,8,10,0,10
980922,2,13,8,10,0,10
980942,2,13,8,5,0,5
980954,2,13,8,9,0,9
980960,2,13,8,3,0,3
980980,2,13,8,4,0,4
980992,2,13,8,3,0,3
981006,2,13,8,12,0,12
981012,2,13,8,10,0,10
1082603,2,13,8,20,0,20
1082610,2,13,8,11,0,11
1082613,2,13,8,4,0,4
1082616,2,13,8,5,0,5
1082621,2,13,8,11,0,11
1082637,2,13,8,12,0,12
335987,1,1,9,4,0,4
335998,1,1,9,3,1,4
336002,1,1,9,6,0,6
336015,1,1,9,14,1,15
336019,1,1,9,4,1,5
336022,1,1,9,10,0,10
336026,1,1,9,5,1,6
336030,1,1,9,7,3,10
336032,1,1,9,1,1,2
392189,1,1,9,2,0,2
392204,1,1,9,3,0,3
392212,1,1,9,7,0,7
392216,1,1,9,4,0,4
392224,1,1,9,5,0,5
392226,1,1,9,10,0,10
392233,1,1,9,7,0,7
419111,1,1,9,6,0,6
419127,1,1,9,4,0,4
419132,1,1,9,8,2,10
419140,1,1,9,2,0,2
419144,1,1,9,4,0,4
419149,1,1,9,4,0,4
419153,1,1,9,6,0,6
419158,1,1,9,7,0,7
501208,1,1,9,4,0,4
501227,1,1,9,5,1,6
501235,1,1,9,3,0,3
501244,1,1,9,10,0,10
501260,1,1,9,7,1,8
501272,1,1,9,8,0,8
501274,1,1,9,3,0,3
548312,1,1,9,13,0,13
548320,1,1,9,8,0,8
548349,1,1,9,8,0,8
548358,1,1,9,7,0,7
548373,1,1,9,6,0,6
548375,1,1,9,3,1,4
548380,1,1,9,2,0,2
548383,1,1,9,6,0,6
598013,1,1,9,14,0,14
598018,1,1,9,6,0,6
598027,1,1,9,2,0,2
598034,1,1,9,6,0,6
598045,1,1,9,1,0,1
598058,1,1,9,6,0,6
598074,1,1,9,5,0,5
729284,1,1,9,10,0,10
729294,1,1,9,6,0,6
729304,1,1,9,10,0,10
734032,1,1,9,10,0,10
734048,1,1,9,0,0,0
829718,1,1,9,7,1,8
829766,1,1,9,1,0,1
829776,1,1,9,16,0,16
829786,1,1,9,5,0,5
980914,1,1,9,11,2,13
980952,1,1,9,7,0,7
980968,1,1,9,11,0,11
980980,1,1,9,2,0,2
981000,1,1,9,6,2,8
981006,1,1,9,4,1,5
981014,1,1,9,14,0,14
1082597,1,1,9,5,0,5
1082604,1,1,9,9,5,14
1082613,1,1,9,10,1,11
1082617,1,1,9,6,0,6
1082631,1,1,9,3,0,3
1082649,1,1,9,3,0,3
335991,2,1,9,0,1,1
336005,2,1,9,4,0,4
336008,2,1,9,3,0,3
336040,2,1,9,7,0,7
392191,2,1,9,2,0,2
392195,2,1,9,3,0,3
392202,2,1,9,6,0,6
392208,2,1,9,10,0,10
392236,2,1,9,10,4,14
392238,2,1,9,2,0,2
419114,2,1,9,9,1,10
419118,2,1,9,6,1,7
419123,2,1,9,9,0,9
419136,2,1,9,2,0,2
419163,2,1,9,7,1,8
419166,2,1,9,3,0,3
501203,2,1,9,4,0,4
501214,2,1,9,8,0,8
501219,2,1,9,2,3,5
501224,2,1,9,3,0,3
501239,2,1,9,4,0,4
501247,2,1,9,7,0,7
501250,2,1,9,8,0,8
501267,2,1,9,9,0,9
548317,2,1,9,10,0,10
548325,2,1,9,9,0,9
548328,2,1,9,5,0,5
548333,2,1,9,11,1,12
548340,2,1,9,6,0,6
548352,2,1,9,5,1,6
548362,2,1,9,4,0,4
548368,2,1,9,3,0,3
548386,2,1,9,14,0,14
598003,2,1,9,9,1,10
598010,2,1,9,4,0,4
598021,2,1,9,9,0,9
598036,2,1,9,7,4,11
598039,2,1,9,4,0,4
598048,2,1,9,10,0,10
598055,2,1,9,3,0,3
598062,2,1,9,5,0,5
598066,2,1,9,12,0,12
729312,2,1,9,6,2,8
729320,2,1,9,4,0,4
733976,2,1,9,5,0,5
733984,2,1,9,9,0,9
733990,2,1,9,5,0,5
734002,2,1,9,7,0,7
734014,2,1,9,8,0,8
734020,2,1,9,8,0,8
734028,2,1,9,9,0,9
734042,2,1,9,14,0,14
734054,2,1,9,14,0,14
829710,2,1,9,12,0,12
829728,2,1,9,4,0,4
829738,2,1,9,3,0,3
829744,2,1,9,9,0,9
829748,2,1,9,7,0,7
829770,2,1,9,3,0,3
829796,2,1,9,3,0,3
829810,2,1,9,9,0,9
829816,2,1,9,10,0,10
980908,2,1,9,6,3,9
980920,2,1,9,10,1,11
980930,2,1,9,3,0,3
980944,2,1,9,4,0,4
980956,2,1,9,7,0,7
980964,2,1,9,6,1,7
981020,2,1,9,5,2,7
1082593,2,1,9,6,0,6
1082601,2,1,9,7,1,8
1082608,2,1,9,13,1,14
1082620,2,1,9,11,0,11
1082622,2,1,9,13,0,13
1082627,2,1,9,14,0,14
1082636,2,1,9,5,0,5
1082639,2,1,9,7,1,8
1082644,2,1,9,4,3,7
335997,1,2,9,8,0,8
336011,1,2,9,5,0,5
336017,1,2,9,4,1,5
336021,1,2,9,5,0,5
336031,1,2,9,3,0,3
336034,1,2,9,5,0,5
336039,1,2,9,14,0,14
392187,1,2,9,6,0,6
392196,1,2,9,3,0,3
392199,1,2,9,4,2,6
392209,1,2,9,2,2,4
392218,1,2,9,4,0,4
392241,1,2,9,9,1,10
419114,1,2,9,9,0,9
419128,1,2,9,1,1,2
419138,1,2,9,8,0,8
419150,1,2,9,3,0,3
501210,1,2,9,6,0,6
501237,1,2,9,6,1,7
501249,1,2,9,12,0,12
501273,1,2,9,4,1,5
501275,1,2,9,9,1,10
548315,1,2,9,4,0,4
548323,1,2,9,20,1,21
548341,1,2,9,6,1,7
548355,1,2,9,4,0,4
548367,1,2,9,8,0,8
548372,1,2,9,9,0,9
548377,1,2,9,2,0,2
598004,1,2,9,12,0,12
598009,1,2,9,4,0,4
598017,1,2,9,8,1,9
598032,1,2,9,14,1,15
598041,1,2,9,4,0,4
598047,1,2,9,13,0,13
598050,1,2,9,9,0,9
598059,1,2,9,9,1,10
598062,1,2,9,5,0,5
598069,1,2,9,3,1,4
729310,1,2,9,6,0,6
729318,1,2,9,10,0,10
734004,1,2,9,6,0,6
734010,1,2,9,5,1,6
734026,1,2,9,7,0,7
734040,1,2,9,5,0,5
829724,1,2,9,6,0,6
829768,1,2,9,7,0,7
829790,1,2,9,9,1,10
829800,1,2,9,12,0,12
829824,1,2,9,1,0,1
829826,1,2,9,3,0,3
980912,1,2,9,12,0,12
980926,1,2,9,8,0,8
980932,1,2,9,12,1,13
980936,1,2,9,11,1,12
980942,1,2,9,8,0,8
980964,1,2,9,4,0,4
980982,1,2,9,3,0,3
980986,1,2,9,12,0,12
980992,1,2,9,4,0,4
981004,1,2,9,15,3,18
1082595,1,2,9,2,0,2
1082598,1,2,9,12,1,13
1082602,1,2,9,9,0,9
1082610,1,2,9,7,1,8
1082621,1,2,9,1,1,2
1082628,1,2,9,12,1,13
1082636,1,2,9,5,0,5
1082646,1,2,9,11,0,11
335987,2,2,9,3,2,5
335990,2,2,9,14,1,15
336001,2,2,9,12,1,13
336003,2,2,9,6,0,6
336007,2,2,9,5,0,5
336015,2,2,9,9,1,10
336028,2,2,9,2,0,2
392190,2,2,9,2,0,2
392193,2,2,9,6,1,7
392204,2,2,9,4,0,4
392213,2,2,9,4,2,6
392223,2,2,9,7,0,7
392226,2,2,9,4,1,5
392229,2,2,9,6,0,6
392237,2,2,9,5,0,5
392243,2,2,9,11,0,11
392244,2,2,9,6,0,6
419117,2,2,9,4,0,4
419120,2,2,9,17,1,18
419124,2,2,9,9,0,9
419133,2,2,9,12,0,12
419141,2,2,9,3,0,3
419145,2,2,9,6,0,6
419153,2,2,9,2,6,8
419156,2,2,9,8,0,8
419159,2,2,9,13,0,13
419162,2,2,9,10,0,10
419167,2,2,9,18,0,18
419169,2,2,9,4,0,4
501205,2,2,9,13,2,15
501213,2,2,9,5,1,6
501216,2,2,9,5,0,5
501227,2,2,9,14,0,14
501232,2,2,9,8,0,8
501252,2,2,9,7,1,8
501257,2,2,9,8,0,8
501260,2,2,9,10,0,10
501265,2,2,9,7,0,7
501271,2,2,9,15,3,18
501276,2,2,9,6,1,7
548320,2,2,9,5,0,5
548329,2,2,9,6,2,8
548332,2,2,9,6,0,6
548336,2,2,9,12,0,12
548349,2,2,9,1,0,1
548361,2,2,9,7,1,8
548365,2,2,9,3,0,3
548381,2,2,9,2,0,2
598013,2,2,9,18,1,19
598022,2,2,9,10,0,10
598028,2,2,9,6,0,6
598038,2,2,9,12,0,12
598053,2,2,9,11,0,11
729286,2,2,9,3,0,3
729292,2,2,9,6,0,6
729304,2,2,9,4,1,5
733982,2,2,9,5,0,5
733988,2,2,9,10,0,10
733996,2,2,9,8,0,8
734018,2,2,9,3,0,3
734032,2,2,9,16,1,17
829718,2,2,9,10,0,10
829742,2,2,9,8,0,8
829750,2,2,9,1,0,1
829754,2,2,9,10,0,10
829762,2,2,9,13,1,14
829776,2,2,9,13,0,13
829784,2,2,9,9,0,9
829808,2,2,9,5,0,5
980958,2,2,9,13,0,13
980974,2,2,9,10,1,11
981000,2,2,9,10,0,10
981016,2,2,9,7,0,7
981018,2,2,9,17,1,18
981024,2,2,9,21,0,21
1082591,2,2,9,10,1,11
1082607,2,2,9,10,0,10
1082617,2,2,9,5,0,5
1082624,2,2,9,3,0,3
1082633,2,2,9,3,0,3
335988,1,3,9,13,0,13
335994,1,3,9,7,1,8
336001,1,3,9,10,0,10
336006,1,3,9,5,0,5
336010,1,3,9,5,0,5
336012,1,3,9,10,0,10
336018,1,3,9,10,0,10
336023,1,3,9,4,0,4
336045,1,3,9,7,0,7
392190,1,3,9,8,4,12
392201,1,3,9,8,0,8
392207,1,3,9,14,0,14
392211,1,3,9,4,0,4
392214,1,3,9,10,0,10
392219,1,3,9,6,0,6
392229,1,3,9,6,2,8
392236,1,3,9,4,0,4
392239,1,3,9,3,1,4
392243,1,3,9,2,0,2
419118,1,3,9,7,0,7
419130,1,3,9,10,0,10
419142,1,3,9,4,3,7
419147,1,3,9,9,1,10
419152,1,3,9,4,0,4
419160,1,3,9,1,0,1
419168,1,3,9,5,0,5
419170,1,3,9,5,0,5
501203,1,3,9,8,1,9
501211,1,3,9,8,0,8
501216,1,3,9,5,0,5
501220,1,3,9,11,0,11
501231,1,3,9,5,0,5
501241,1,3,9,7,0,7
501250,1,3,9,5,0,5
501254,1,3,9,7,0,7
501258,1,3,9,8,0,8
501266,1,3,9,10,0,10
501271,1,3,9,3,0,3
501276,1,3,9,11,0,11
548311,1,3,9,7,0,7
548316,1,3,9,7,1,8
548321,1,3,9,10,0,10
548327,1,3,9,12,0,12
548335,1,3,9,9,0,9
548352,1,3,9,6,1,7
548357,1,3,9,5,1,6
548360,1,3,9,7,1,8
548376,1,3,9,2,0,2
548384,1,3,9,6,0,6
548385,1,3,9,9,0,9
548386,1,3,9,13,0,13
598025,1,3,9,5,1,6
598039,1,3,9,10,0,10
598043,1,3,9,5,0,5
598046,1,3,9,6,0,6
598056,1,3,9,13,1,14
598063,1,3,9,7,0,7
598067,1,3,9,5,1,6
598075,1,3,9,8,0,8
729288,1,3,9,7,0,7
729298,1,3,9,7,2,9
729302,1,3,9,3,0,3
733976,1,3,9,13,0,13
734018,1,3,9,4,0,4
734028,1,3,9,5,0,5
734034,1,3,9,1,4,5
829712,1,3,9,7,0,7
829716,1,3,9,3,0,3
829728,1,3,9,1,0,1
829740,1,3,9,16,0,16
829750,1,3,9,10,0,10
829758,1,3,9,3,1,4
829770,1,3,9,4,0,4
829784,1,3,9,15,0,15
829794,1,3,9,6,0,6
829802,1,3,9,2,0,2
829806,1,3,9,11,0,11
335998,2,3,9,6,0,6
336014,2,3,9,11,0,11
336034,2,3,9,4,0,4
336038,2,3,9,3,0,3
336042,2,3,9,9,0,9
336044,2,3,9,7,0,7
392186,2,3,9,9,0,9
392194,2,3,9,7,0,7
392207,2,3,9,2,1,3
392222,2,3,9,11,1,12
392232,2,3,9,3,4,7
419115,2,3,9,5,0,5
419121,2,3,9,4,0,4
419126,2,3,9,7,0,7
419128,2,3,9,3,4,7
419134,2,3,9,3,0,3
419138,2,3,9,10,0,10
419158,2,3,9,5,0,5
419164,2,3,9,12,0,12
501226,2,3,9,15,0,15
501233,2,3,9,16,0,16
501245,2,3,9,10,0,10
501273,2,3,9,15,1,16
548323,2,3,9,6,0,6
548337,2,3,9,8,1,9
548348,2,3,9,3,0,3
548366,2,3,9,7,0,7
548369,2,3,9,7,0,7
548373,2,3,9,13,0,13
598007,2,3,9,5,0,5
598012,2,3,9,13,0,13
598017,2,3,9,7,1,8
598020,2,3,9,3,0,3
598027,2,3,9,3,0,3
598031,2,3,9,10,1,11
598035,2,3,9,6,1,7
598051,2,3,9,4,0,4
598078,2,3,9,9,0,9
729308,2,3,9,3,0,3
729316,2,3,9,7,0,7
733986,2,3,9,9,0,9
733992,2,3,9,11,0,11
734000,2,3,9,4,0,4
734008,2,3,9,10,0,10
734040,2,3,9,8,0,8
734050,2,3,9,8,0,8
734052,2,3,9,10,0,10
829734,2,3,9,6,0,6
829778,2,3,9,9,1,10
829814,2,3,9,4,0,4
829822,2,3,9,13,0,13
829826,2,3,9,11,0,11
829828,2,3,9,6,1,7
335992,1,4,9,3,0,3
335996,1,4,9,5,0,5
336008,1,4,9,14,0,14
336024,1,4,9,4,0,4
336033,1,4,9,10,0,10
336040,1,4,9,9,1,10
336044,1,4,9,7,0,7
392188,1,4,9,7,0,7
392191,1,4,9,2,0,2
392200,1,4,9,6,0,6
392205,1,4,9,2,0,2
392227,1,4,9,4,0,4
392234,1,4,9,3,0,3
419113,1,4,9,10,1,11
419117,1,4,9,13,0,13
419126,1,4,9,1,0,1
419137,1,4,9,11,2,13
419141,1,4,9,6,0,6
419148,1,4,9,14,2,16
419161,1,4,9,5,0,5
419164,1,4,9,12,0,12
501207,1,4,9,0,0,0
501225,1,4,9,7,0,7
501239,1,4,9,9,0,9
501253,1,4,9,9,0,9
501256,1,4,9,8,0,8
501262,1,4,9,8,0,8
501265,1,4,9,14,1,15
548328,1,4,9,8,0,8
548333,1,4,9,7,0,7
548336,1,4,9,5,2,7
548344,1,4,9,6,1,7
548348,1,4,9,4,0,4
548364,1,4,9,9,0,9
548374,1,4,9,6,0,6
548379,1,4,9,1,0,1
598012,1,4,9,3,1,4
598019,1,4,9,3,0,3
598021,1,4,9,9,0,9
598026,1,4,9,3,0,3
598033,1,4,9,4,1,5
598036,1,4,9,2,2,4
598057,1,4,9,7,0,7
598071,1,4,9,5,0,5
729300,1,4,9,5,0,5
729312,1,4,9,12,0,12
733978,1,4,9,12,0,12
733992,1,4,9,9,0,9
733996,1,4,9,5,0,5
734002,1,4,9,11,0,11
734030,1,4,9,14,0,14
734038,1,4,9,8,0,8
734052,1,4,9,5,1,6
734054,1,4,9,4,0,4
829722,1,4,9,5,0,5
829730,1,4,9,18,0,18
829738,1,4,9,6,4,10
829772,1,4,9,6,0,6
829796,1,4,9,2,3,5
829808,1,4,9,9,1,10
829814,1,4,9,5,1,6
980910,1,4,9,10,1,11
980918,1,4,9,1,1,2
980930,1,4,9,3,1,4
980940,1,4,9,12,0,12
980960,1,4,9,4,0,4
980976,1,4,9,13,0,13
980996,1,4,9,5,0,5
981010,1,4,9,4,0,4
1082601,1,4,9,11,0,11
1082612,1,4,9,4,1,5
1082616,1,4,9,13,0,13
1082633,1,4,9,11,0,11
1082637,1,4,9,8,1,9
1082639,1,4,9,2,1,3
1082641,1,4,9,21,0,21
1082645,1,4,9,11,0,11
335988,2,4,9,12,1,13
336000,2,4,9,5,0,5
336004,2,4,9,12,0,12
336011,2,4,9,4,0,4
336018,2,4,9,15,0,15
336021,2,4,9,8,0,8
336036,2,4,9,11,0,11
392196,2,4,9,6,0,6
392209,2,4,9,10,0,10
392212,2,4,9,9,0,9
392215,2,4,9,4,0,4
392219,2,4,9,16,0,16
392221,2,4,9,19,1,20
392231,2,4,9,7,0,7
392239,2,4,9,2,0,2
419122,2,4,9,3,0,3
419129,2,4,9,4,1,5
419132,2,4,9,7,0,7
419144,2,4,9,7,0,7
419151,2,4,9,13,0,13
419154,2,4,9,4,0,4
501211,2,4,9,9,0,9
501217,2,4,9,16,0,16
501228,2,4,9,16,0,16
501242,2,4,9,12,0,12
501249,2,4,9,6,0,6
501259,2,4,9,11,0,11
501269,2,4,9,6,0,6
548314,2,4,9,7,0,7
548318,2,4,9,13,2,15
548324,2,4,9,5,0,5
548339,2,4,9,2,0,2
548355,2,4,9,3,0,3
548359,2,4,9,1,2,3
548371,2,4,9,7,0,7
548376,2,4,9,1,0,1
598008,2,4,9,8,0,8
598030,2,4,9,7,0,7
598042,2,4,9,10,0,10
598046,2,4,9,4,0,4
598050,2,4,9,14,1,15
598061,2,4,9,1,0,1
598064,2,4,9,4,0,4
598069,2,4,9,6,0,6
729288,2,4,9,7,0,7
729296,2,4,9,4,1,5
729318,2,4,9,5,0,5
734012,2,4,9,11,1,12
734024,2,4,9,5,2,7
734044,2,4,9,3,0,3
734048,2,4,9,4,1,5
829714,2,4,9,2,2,4
829746,2,4,9,7,0,7
829758,2,4,9,7,0,7
829764,2,4,9,8,0,8
829780,2,4,9,10,1,11
829790,2,4,9,2,1,3
829804,2,4,9,3,0,3
980924,2,4,9,6,0,6
980946,2,4,9,11,0,11
980968,2,4,9,5,0,5
980982,2,4,9,9,0,9
980990,2,4,9,5,1,6
981004,2,4,9,6,0,6
1082594,2,4,9,4,0,4
1082598,2,4,9,7,0,7
1082605,2,4,9,4,0,4
1082609,2,4,9,4,0,4
1082623,2,4,9,5,0,5
335989,1,5,9,2,1,3
336005,1,5,9,15,0,15
336013,1,5,9,4,2,6
336028,1,5,9,4,2,6
336038,1,5,9,5,0,5
336043,1,5,9,6,0,6
392195,1,5,9,3,0,3
392215,1,5,9,7,0,7
392222,1,5,9,8,0,8
392230,1,5,9,6,1,7
392238,1,5,9,6,0,6
419116,1,5,9,3,1,4
419120,1,5,9,4,0,4
419123,1,5,9,13,0,13
419129,1,5,9,12,2,14
419134,1,5,9,13,0,13
419146,1,5,9,10,0,10
419159,1,5,9,4,0,4
419163,1,5,9,5,0,5
501214,1,5,9,12,0,12
501219,1,5,9,12,1,13
501245,1,5,9,8,0,8
501257,1,5,9,5,0,5
501263,1,5,9,8,0,8
548314,1,5,9,9,0,9
548317,1,5,9,5,0,5
548325,1,5,9,3,0,3
548329,1,5,9,5,0,5
548337,1,5,9,6,0,6
548354,1,5,9,2,0,2
548359,1,5,9,9,0,9
548366,1,5,9,4,1,5
548370,1,5,9,5,0,5
548378,1,5,9,1,1,2
548382,1,5,9,4,0,4
598006,1,5,9,10,0,10
598010,1,5,9,7,0,7
598014,1,5,9,7,0,7
598024,1,5,9,3,0,3
598028,1,5,9,13,0,13
598031,1,5,9,7,1,8
598048,1,5,9,15,0,15
598077,1,5,9,7,0,7
729296,1,5,9,10,0,10
729320,1,5,9,4,0,4
733984,1,5,9,8,0,8
734008,1,5,9,4,0,4
734016,1,5,9,10,0,10
734046,1,5,9,10,0,10
829714,1,5,9,0,8,8
829746,1,5,9,19,0,19
829754,1,5,9,5,0,5
829782,1,5,9,2,1,3
829816,1,5,9,11,0,11
335992,2,5,9,11,0,11
335995,2,5,9,12,0,12
335997,2,5,9,7,0,7
336010,2,5,9,8,0,8
336016,2,5,9,4,0,4
336020,2,5,9,18,4,22
336024,2,5,9,5,0,5
336032,2,5,9,10,2,12
336041,2,5,9,4,0,4
336045,2,5,9,7,3,10
392187,2,5,9,2,0,2
392200,2,5,9,2,0,2
392203,2,5,9,9,0,9
392207,2,5,9,5,0,5
392210,2,5,9,8,1,9
392218,2,5,9,8,0,8
392225,2,5,9,8,0,8
392235,2,5,9,11,2,13
419112,2,5,9,7,0,7
419131,2,5,9,15,0,15
419139,2,5,9,2,0,2
419142,2,5,9,10,0,10
419148,2,5,9,17,0,17
419155,2,5,9,4,0,4
501204,2,5,9,10,0,10
501209,2,5,9,8,0,8
501225,2,5,9,6,0,6
501230,2,5,9,9,0,9
501236,2,5,9,11,0,11
501240,2,5,9,4,1,5
501254,2,5,9,5,1,6
501268,2,5,9,7,0,7
548322,2,5,9,7,0,7
548331,2,5,9,4,0,4
548341,2,5,9,2,0,2
548350,2,5,9,6,0,6
548363,2,5,9,16,0,16
598019,2,5,9,4,0,4
598037,2,5,9,3,0,3
598041,2,5,9,10,0,10
598052,2,5,9,3,1,4
598054,2,5,9,6,1,7
598057,2,5,9,10,0,10
598063,2,5,9,8,0,8
598068,2,5,9,6,5,11
598070,2,5,9,3,0,3
598076,2,5,9,0,0,0
729290,2,5,9,5,1,6
729302,2,5,9,6,0,6
729310,2,5,9,0,0,0
733980,2,5,9,8,0,8
733994,2,5,9,3,1,4
734004,2,5,9,3,0,3
734022,2,5,9,6,1,7
734038,2,5,9,2,0,2
829720,2,5,9,5,1,6
829726,2,5,9,8,0,8
829732,2,5,9,6,0,6
829740,2,5,9,16,0,16
829774,2,5,9,10,1,11
829792,2,5,9,6,0,6
829802,2,5,9,10,0,10
829824,2,5,9,5,1,6
336000,1,6,9,2,0,2
336003,1,6,9,4,0,4
336014,1,6,9,7,0,7
336020,1,6,9,5,0,5
336025,1,6,9,7,0,7
336027,1,6,9,14,2,16
392194,1,6,9,6,0,6
392203,1,6,9,4,1,5
392228,1,6,9,9,0,9
392231,1,6,9,3,0,3
392235,1,6,9,9,0,9
392237,1,6,9,8,0,8
392242,1,6,9,7,0,7
419121,1,6,9,4,1,5
419133,1,6,9,9,0,9
419136,1,6,9,7,0,7
419139,1,6,9,4,0,4
419145,1,6,9,14,0,14
419154,1,6,9,2,0,2
501206,1,6,9,4,0,4
501209,1,6,9,3,0,3
501228,1,6,9,13,0,13
501232,1,6,9,7,0,7
501238,1,6,9,3,0,3
501243,1,6,9,3,2,5
501270,1,6,9,5,0,5
548347,1,6,9,12,0,12
548350,1,6,9,4,0,4
548362,1,6,9,11,0,11
548369,1,6,9,11,0,11
598003,1,6,9,7,0,7
598015,1,6,9,9,0,9
598022,1,6,9,11,0,11
598040,1,6,9,5,0,5
598049,1,6,9,4,0,4
598054,1,6,9,5,0,5
598064,1,6,9,1,0,1
729286,1,6,9,4,0,4
733980,1,6,9,11,0,11
733986,1,6,9,13,0,13
733990,1,6,9,8,0,8
733998,1,6,9,6,0,6
734024,1,6,9,7,0,7
734044,1,6,9,7,0,7
829720,1,6,9,12,1,13
829736,1,6,9,8,1,9
829744,1,6,9,6,0,6
829752,1,6,9,4,0,4
829762,1,6,9,2,0,2
829788,1,6,9,9,0,9
829818,1,6,9,18,0,18
980908,1,6,9,4,0,4
980938,1,6,9,6,0,6
980956,1,6,9,7,0,7
980970,1,6,9,4,0,4
981002,1,6,9,10,0,10
981016,1,6,9,5,0,5
1082599,1,6,9,5,0,5
1082605,1,6,9,7,0,7
1082608,1,6,9,8,0,8
1082622,1,6,9,5,0,5
1082626,1,6,9,2,0,2
1082642,1,6,9,10,0,10
335989,2,6,9,7,0,7
335993,2,6,9,22,1,23
336006,2,6,9,8,0,8
336009,2,6,9,12,0,12
336022,2,6,9,7,0,7
336031,2,6,9,5,0,5
336037,2,6,9,6,1,7
336043,2,6,9,8,0,8
392199,2,6,9,3,0,3
392206,2,6,9,3,1,4
392211,2,6,9,8,0,8
392216,2,6,9,10,1,11
392220,2,6,9,4,0,4
392224,2,6,9,8,1,9
392240,2,6,9,5,0,5
419113,2,6,9,7,0,7
419116,2,6,9,8,0,8
419119,2,6,9,2,1,3
419125,2,6,9,13,0,13
419149,2,6,9,11,1,12
419157,2,6,9,4,0,4
419160,2,6,9,6,0,6
419165,2,6,9,4,0,4
501218,2,6,9,5,0,5
501221,2,6,9,10,4,14
501235,2,6,9,5,0,5
501248,2,6,9,13,0,13
501251,2,6,9,5,2,7
501258,2,6,9,4,0,4
501262,2,6,9,9,0,9
548312,2,6,9,11,0,11
548315,2,6,9,7,1,8
548321,2,6,9,5,0,5
548326,2,6,9,4,0,4
548330,2,6,9,1,0,1
548334,2,6,9,14,1,15
548338,2,6,9,13,0,13
548342,2,6,9,9,4,13
548354,2,6,9,3,1,4
548374,2,6,9,11,0,11
548377,2,6,9,13,0,13
548379,2,6,9,3,1,4
548383,2,6,9,11,0,11
548385,2,6,9,9,3,12
598006,2,6,9,12,0,12
598011,2,6,9,8,0,8
598025,2,6,9,6,0,6
598029,2,6,9,8,0,8
598033,2,6,9,4,0,4
598045,2,6,9,1,0,1
598059,2,6,9,19,1,20
598067,2,6,9,4,0,4
598072,2,6,9,5,0,5
729294,2,6,9,4,1,5
729298,2,6,9,3,1,4
729306,2,6,9,3,0,3
729314,2,6,9,4,0,4
734010,2,6,9,8,0,8
734016,2,6,9,6,2,8
734036,2,6,9,2,0,2
829712,2,6,9,7,0,7
829730,2,6,9,7,1,8
829766,2,6,9,3,0,3
829772,2,6,9,7,2,9
829782,2,6,9,7,0,7
829798,2,6,9,2,0,2
829806,2,6,9,8,0,8
980918,2,6,9,10,0,10
980926,2,6,9,14,0,14
980950,2,6,9,5,0,5
980966,2,6,9,16,0,16
980976,2,6,9,5,0,5
980988,2,6,9,5,0,5
980998,2,6,9,10,0,10
981008,2,6,9,10,0,10
1082595,2,6,9,4,1,5
1082611,2,6,9,5,0,5
1082614,2,6,9,9,1,10
1082630,2,6,9,7,0,7
1082632,2,6,9,14,0,14
1082635,2,6,9,7,0,7
1082640,2,6,9,9,0,9
1082646,2,6,9,16,0,16
335990,1,7,9,11,1,12
335999,1,7,9,5,0,5
336009,1,7,9,3,1,4
336029,1,7,9,1,2,3
336037,1,7,9,4,2,6
336041,1,7,9,4,1,5
392186,1,7,9,7,0,7
392202,1,7,9,17,0,17
392208,1,7,9,2,0,2
392213,1,7,9,6,0,6
392220,1,7,9,2,1,3
392223,1,7,9,9,0,9
392232,1,7,9,10,0,10
392240,1,7,9,11,2,13
419112,1,7,9,5,0,5
419119,1,7,9,10,0,10
419124,1,7,9,7,0,7
419135,1,7,9,4,0,4
419143,1,7,9,6,0,6
419151,1,7,9,6,0,6
419155,1,7,9,5,0,5
419157,1,7,9,7,0,7
419162,1,7,9,17,5,22
419166,1,7,9,12,0,12
419167,1,7,9,8,0,8
501215,1,7,9,8,0,8
501226,1,7,9,3,0,3
501229,1,7,9,1,0,1
501236,1,7,9,8,0,8
501242,1,7,9,11,0,11
501246,1,7,9,4,0,4
501251,1,7,9,4,1,5
501268,1,7,9,11,0,11
548322,1,7,9,8,0,8
548330,1,7,9,3,0,3
548339,1,7,9,6,0,6
548356,1,7,9,3,1,4
548365,1,7,9,5,0,5
548368,1,7,9,9,0,9
598007,1,7,9,12,0,12
598011,1,7,9,15,1,16
598016,1,7,9,8,0,8
598029,1,7,9,10,0,10
598038,1,7,9,18,1,19
598042,1,7,9,4,0,4
598044,1,7,9,4,0,4
598051,1,7,9,2,0,2
598055,1,7,9,4,0,4
598068,1,7,9,7,0,7
598078,1,7,9,5,0,5
729292,1,7,9,2,0,2
729308,1,7,9,3,0,3
729314,1,7,9,4,0,4
733988,1,7,9,2,4,6
734000,1,7,9,5,0,5
734014,1,7,9,10,0,10
734022,1,7,9,6,0,6
734036,1,7,9,3,0,3
734050,1,7,9,9,0,9
829710,1,7,9,6,0,6
829726,1,7,9,0,1,1
829734,1,7,9,9,0,9
829742,1,7,9,9,0,9
829756,1,7,9,6,0,6
829774,1,7,9,13,0,13
829780,1,7,9,12,0,12
829810,1,7,9,9,0,9
829822,1,7,9,16,0,16
829828,1,7,9,10,0,10
980906,1,7,9,7,0,7
980922,1,7,9,9,1,10
980928,1,7,9,7,0,7
980946,1,7,9,9,0,9
980990,1,7,9,3,0,3
980998,1,7,9,13,0,13
981012,1,7,9,8,0,8
1082592,1,7,9,10,0,10
1082614,1,7,9,0,1,1
1082635,1,7,9,3,0,3
1082638,1,7,9,8,0,8
1082644,1,7,9,2,2,4
1082650,1,7,9,3,1,4
335994,2,7,9,7,0,7
335996,2,7,9,4,0,4
336002,2,7,9,11,5,16
336013,2,7,9,4,1,5
336017,2,7,9,11,0,11
336023,2,7,9,5,1,6
336033,2,7,9,2,0,2
392197,2,7,9,9,0,9
392202,2,7,9,2,0,2
392205,2,7,9,13,0,13
392217,2,7,9,2,0,2
392227,2,7,9,12,0,12
392230,2,7,9,5,6,11
419119,2,7,9,2,0,2
419127,2,7,9,2,0,2
419130,2,7,9,12,0,12
419137,2,7,9,11,0,11
419147,2,7,9,5,1,6
419170,2,7,9,3,0,3
501206,2,7,9,2,0,2
501210,2,7,9,4,0,4
501223,2,7,9,6,0,6
501256,2,7,9,7,1,8
501261,2,7,9,7,1,8
501272,2,7,9,5,0,5
501274,2,7,9,1,0,1
501275,2,7,9,4,0,4
548311,2,7,9,3,0,3
548313,2,7,9,2,1,3
548319,2,7,9,7,0,7
548344,2,7,9,7,0,7
548347,2,7,9,17,0,17
548351,2,7,9,1,2,3
548360,2,7,9,8,1,9
548372,2,7,9,6,0,6
548375,2,7,9,13,0,13
548382,2,7,9,6,0,6
548384,2,7,9,3,1,4
598004,2,7,9,3,1,4
598024,2,7,9,3,1,4
598034,2,7,9,10,0,10
598060,2,7,9,5,0,5
598065,2,7,9,7,1,8
598071,2,7,9,3,0,3
598075,2,7,9,3,0,3
598077,2,7,9,9,0,9
729284,2,7,9,6,0,6
729322,2,7,9,5,0,5
733978,2,7,9,3,1,4
734006,2,7,9,11,0,11
734030,2,7,9,9,0,9
734046,2,7,9,15,0,15
829722,2,7,9,1,0,1
829752,2,7,9,8,0,8
829788,2,7,9,7,0,7
829794,2,7,9,2,0,2
829800,2,7,9,3,0,3
829820,2,7,9,8,1,9
980914,2,7,9,9,0,9
980932,2,7,9,5,0,5
980938,2,7,9,10,0,10
980952,2,7,9,3,0,3
980962,2,7,9,11,0,11
980978,2,7,9,2,0,2
980986,2,7,9,6,0,6
1082597,2,7,9,1,0,1
1082600,2,7,9,3,0,3
1082602,2,7,9,3,1,4
1082606,2,7,9,15,0,15
1082612,2,7,9,15,1,16
1082618,2,7,9,4,0,4
1082625,2,7,9,4,0,4
1082628,2,7,9,8,0,8
1082641,2,7,9,17,0,17
1082647,2,7,9,11,0,11
1082649,2,7,9,11,0,11
335991,1,8,9,1,0,1
335993,1,8,9,7,0,7
335995,1,8,9,6,0,6
336004,1,8,9,8,0,8
336007,1,8,9,11,0,11
336016,1,8,9,5,0,5
336036,1,8,9,9,0,9
336042,1,8,9,5,2,7
392193,1,8,9,5,0,5
392197,1,8,9,4,0,4
392206,1,8,9,4,0,4
392210,1,8,9,9,2,11
392217,1,8,9,3,0,3
392221,1,8,9,12,0,12
392225,1,8,9,10,0,10
392244,1,8,9,3,2,5
419115,1,8,9,3,0,3
419122,1,8,9,7,0,7
419125,1,8,9,10,0,10
419131,1,8,9,2,0,2
419156,1,8,9,11,1,12
419165,1,8,9,6,0,6
419169,1,8,9,7,0,7
501204,1,8,9,10,0,10
501213,1,8,9,10,0,10
501217,1,8,9,9,1,10
501221,1,8,9,11,0,11
501234,1,8,9,4,0,4
501248,1,8,9,5,0,5
501255,1,8,9,6,0,6
501261,1,8,9,10,0,10
501269,1,8,9,6,0,6
548319,1,8,9,5,0,5
548326,1,8,9,10,1,11
548331,1,8,9,7,0,7
548334,1,8,9,10,0,10
548340,1,8,9,7,1,8
548346,1,8,9,6,0,6
548351,1,8,9,3,2,5
548353,1,8,9,4,2,6
548361,1,8,9,4,0,4
548371,1,8,9,7,0,7
548381,1,8,9,4,0,4
335999,2,8,9,7,4,11
336012,2,8,9,6,0,6
336019,2,8,9,7,0,7
336025,2,8,9,4,0,4
336029,2,8,9,8,0,8
336039,2,8,9,2,1,3
392189,2,8,9,6,0,6
392201,2,8,9,4,1,5
392214,2,8,9,6,0,6
392228,2,8,9,14,0,14
392233,2,8,9,6,0,6
392234,2,8,9,7,0,7
392241,2,8,9,3,1,4
392242,2,8,9,7,0,7
419111,2,8,9,5,1,6
419135,2,8,9,6,2,8
419140,2,8,9,3,0,3
419143,2,8,9,7,2,9
419146,2,8,9,12,2,14
419150,2,8,9,9,1,10
419152,2,8,9,7,0,7
419161,2,8,9,9,0,9
419168,2,8,9,3,0,3
501208,2,8,9,6,0,6
501229,2,8,9,8,0,8
501241,2,8,9,6,0,6
501244,2,8,9,8,0,8
501264,2,8,9,4,0,4
548316,2,8,9,6,0,6
548357,2,8,9,11,0,11
548364,2,8,9,4,0,4
548378,2,8,9,3,0,3
501205,1,9,9,6,0,6
501212,1,9,9,4,0,4
501224,1,9,9,4,0,4
501230,1,9,9,5,0,5
501247,1,9,9,9,0,9
501252,1,9,9,1,3,4
501259,1,9,9,8,0,8
501215,2,9,9,11,1,12
501220,2,9,9,14,1,15
501234,2,9,9,1,1,2
501238,2,9,9,3,0,3
501243,2,9,9,4,0,4
501266,2,9,9,11,1,12
501218,1,10,9,8,0,8
501223,1,10,9,6,0,6
501233,1,10,9,6,0,6
501240,1,10,9,6,0,6
501264,1,10,9,8,0,8
501267,1,10,9,4,0,4
548313,1,10,9,8,0,8
548318,1,10,9,5,0,5
548324,1,10,9,11,0,11
548332,1,10,9,10,0,10
548338,1,10,9,14,3,17
548342,1,10,9,4,0,4
548363,1,10,9,5,0,5
598008,1,10,9,3,0,3
598020,1,10,9,7,0,7
598030,1,10,9,7,0,7
598052,1,10,9,6,0,6
598060,1,10,9,4,0,4
598066,1,10,9,7,0,7
598072,1,10,9,17,0,17
501207,2,10,9,11,0,11
501212,2,10,9,3,1,4
501231,2,10,9,4,0,4
501237,2,10,9,7,0,7
501246,2,10,9,2,0,2
501253,2,10,9,6,4,10
501255,2,10,9,4,0,4
548327,2,10,9,3,0,3
548335,2,10,9,2,0,2
548346,2,10,9,11,2,13
548353,2,10,9,10,1,11
548356,2,10,9,1,0,1
548358,2,10,9,0,0,0
548367,2,10,9,2,0,2
548370,2,10,9,4,1,5
548380,2,10,9,2,1,3
598005,2,10,9,6,0,6
598014,2,10,9,3,0,3
598016,2,10,9,11,0,11
598023,2,10,9,4,0,4
598032,2,10,9,7,0,7
598040,2,10,9,5,1,6
598043,2,10,9,6,0,6
598047,2,10,9,19,0,19
598058,2,10,9,3,0,3
598005,1,11,9,8,0,8
598023,1,11,9,8,0,8
598035,1,11,9,4,0,4
598037,1,11,9,9,2,11
598053,1,11,9,6,0,6
598061,1,11,9,1,0,1
598065,1,11,9,7,0,7
598070,1,11,9,6,0,6
598076,1,11,9,4,0,4
729290,1,11,9,12,0,12
729306,1,11,9,5,0,5
729316,1,11,9,7,0,7
729322,1,11,9,2,0,2
733982,1,11,9,2,0,2
733994,1,11,9,6,0,6
734006,1,11,9,8,0,8
734012,1,11,9,2,0,2
734020,1,11,9,7,0,7
734042,1,11,9,3,1,4
829732,1,11,9,7,1,8
829748,1,11,9,11,0,11
829764,1,11,9,5,0,5
829778,1,11,9,13,0,13
829792,1,11,9,9,0,9
829798,1,11,9,3,0,3
829804,1,11,9,4,0,4
829812,1,11,9,17,0,17
829820,1,11,9,9,2,11
980920,1,11,9,5,0,5
980948,1,11,9,4,0,4
980958,1,11,9,10,1,11
980978,1,11,9,8,1,9
980984,1,11,9,6,0,6
980988,1,11,9,7,0,7
981008,1,11,9,10,0,10
981020,1,11,9,9,0,9
981024,1,11,9,12,1,13
1082591,1,11,9,9,0,9
1082600,1,11,9,10,0,10
1082609,1,11,9,8,0,8
1082611,1,11,9,9,0,9
1082615,1,11,9,2,0,2
1082623,1,11,9,16,0,16
1082627,1,11,9,9,2,11
1082630,1,11,9,3,0,3
1082648,1,11,9,9,0,9
598009,2,11,9,2,3,5
598015,2,11,9,3,0,3
598018,2,11,9,2,0,2
598026,2,11,9,2,0,2
598044,2,11,9,3,0,3
598049,2,11,9,6,0,6
598056,2,11,9,8,0,8
598074,2,11,9,12,0,12
729300,2,11,9,9,1,10
734026,2,11,9,9,0,9
734034,2,11,9,13,3,16
829716,2,11,9,7,0,7
829724,2,11,9,3,4,7
829736,2,11,9,4,0,4
829756,2,11,9,4,0,4
829786,2,11,9,3,1,4
980912,2,11,9,3,0,3
980928,2,11,9,7,0,7
980934,2,11,9,9,1,10
980940,2,11,9,8,1,9
980972,2,11,9,9,2,11
980996,2,11,9,6,0,6
981014,2,11,9,10,1,11
981022,2,11,9,1,0,1
1082596,2,11,9,4,0,4
1082604,2,11,9,5,0,5
1082634,2,11,9,10,0,10
1082638,2,11,9,11,0,11
1082643,2,11,9,13,0,13
980916,1,12,9,6,0,6
980924,1,12,9,8,0,8
980944,1,12,9,8,0,8
980954,1,12,9,7,0,7
980962,1,12,9,6,1,7
980974,1,12,9,7,0,7
980994,1,12,9,10,0,10
1082594,1,12,9,3,2,5
1082603,1,12,9,11,0,11
1082607,1,12,9,1,0,1
1082618,1,12,9,5,0,5
1082620,1,12,9,9,0,9
1082624,1,12,9,6,0,6
1082634,1,12,9,4,1,5
1082647,1,12,9,15,0,15
980906,2,12,9,9,1,10
980936,2,12,9,12,0,12
980948,2,12,9,6,3,9
980970,2,12,9,6,0,6
980984,2,12,9,7,0,7
981002,2,12,9,7,0,7
981010,2,12,9,7,0,7
1082592,2,12,9,9,0,9
1082599,2,12,9,3,0,3
1082615,2,12,9,7,0,7
1082629,2,12,9,1,0,1
1082631,2,12,9,1,0,1
1082642,2,12,9,9,0,9
1082645,2,12,9,3,0,3
1082650,2,12,9,2,0,2
980934,1,13,9,4,1,5
980950,1,13,9,8,1,9
980966,1,13,9,5,0,5
980972,1,13,9,5,1,6
981018,1,13,9,4,0,4
981022,1,13,9,11,0,11
1082593,1,13,9,4,0,4
1082596,1,13,9,3,0,3
1082606,1,13,9,9,0,9
1082625,1,13,9,6,1,7
1082629,1,13,9,14,1,15
1082632,1,13,9,6,0,6
1082640,1,13,9,15,0,15
1082643,1,13,9,17,0,17
980910,2,13,9,5,1,6
980916,2,13,9,2,0,2
980922,2,13,9,3,0,3
980942,2,13,9,4,0,4
980954,2,13,9,7,0,7
980960,2,13,9,7,0,7
980980,2,13,9,14,0,14
980992,2,13,9,3,1,4
981006,2,13,9,3,1,4
981012,2,13,9,5,1,6
1082603,2,13,9,2,1,3
1082610,2,13,9,15,2,17
1082613,2,13,9,13,0,13
1082616,2,13,9,7,0,7
1082621,2,13,9,17,2,19
1082637,2,13,9,10,0,10
335987,1,1,10,10,0,10
335998,1,1,10,3,0,3
336002,1,1,10,5,0,5
336015,1,1,10,12,0,12
336019,1,1,10,10,0,10
336022,1,1,10,4,1,5
336026,1,1,10,9,0,9
336030,1,1,10,5,0,5
336032,1,1,10,11,0,11
392189,1,1,10,4,0,4
392204,1,1,10,5,0,5
392212,1,1,10,9,0,9
392216,1,1,10,4,0,4
392224,1,1,10,1,0,1
392226,1,1,10,12,0,12
392233,1,1,10,3,0,3
419111,1,1,10,2,0,2
419127,1,1,10,7,0,7
419132,1,1,10,9,0,9
419140,1,1,10,10,0,10
419144,1,1,10,7,0,7
419149,1,1,10,10,1,11
419153,1,1,10,1,0,1
419158,1,1,10,5,0,5
501208,1,1,10,6,4,10
501227,1,1,10,6,1,7
501235,1,1,10,5,1,6
501244,1,1,10,9,0,9
501260,1,1,10,9,0,9
501272,1,1,10,13,0,13
501274,1,1,10,6,0,6
548312,1,1,10,10,0,10
548320,1,1,10,7,1,8
548349,1,1,10,14,0,14
548358,1,1,10,8,1,9
548373,1,1,10,8,0,8
548375,1,1,10,6,0,6
548380,1,1,10,5,0,5
548383,1,1,10,7,0,7
598013,1,1,10,2,2,4
598018,1,1,10,8,0,8
598027,1,1,10,8,0,8
598034,1,1,10,7,0,7
598045,1,1,10,0,0,0
598058,1,1,10,6,0,6
598074,1,1,10,4,0,4
729284,1,1,10,9,0,9
729294,1,1,10,7,0,7
729304,1,1,10,6,0,6
734032,1,1,10,13,0,13
734048,1,1,10,5,1,6
829718,1,1,10,7,0,7
829766,1,1,10,8,1,9
829776,1,1,10,5,4,9
829786,1,1,10,4,0,4
980914,1,1,10,9,1,10
980952,1,1,10,9,0,9
980968,1,1,10,12,0,12
980980,1,1,10,14,0,14
981000,1,1,10,5,0,5
981006,1,1,10,1,0,1
981014,1,1,10,8,0,8
1082597,1,1,10,7,0,7
1082604,1,1,10,8,0,8
1082613,1,1,10,8,0,8
1082617,1,1,10,7,1,8
1082631,1,1,10,4,0,4
1082649,1,1,10,4,0,4
335991,2,1,10,2,1,3
336005,2,1,10,4,0,4
336008,2,1,10,7,0,7
336040,2,1,10,7,1,8
392191,2,1,10,1,0,1
392195,2,1,10,4,0,4
392202,2,1,10,1,0,1
392208,2,1,10,5,1,6
392236,2,1,10,5,0,5
392238,2,1,10,1,0,1
419114,2,1,10,6,0,6
419118,2,1,10,6,0,6
419123,2,1,10,6,0,6
419136,2,1,10,2,1,3
419163,2,1,10,5,0,5
419166,2,1,10,9,0,9
501203,2,1,10,12,0,12
501214,2,1,10,6,0,6
501219,2,1,10,4,0,4
501224,2,1,10,3,4,7
501239,2,1,10,9,0,9
501247,2,1,10,7,0,7
501250,2,1,10,8,1,9
501267,2,1,10,5,0,5
548317,2,1,10,12,1,13
548325,2,1,10,7,0,7
548328,2,1,10,3,1,4
548333,2,1,10,3,0,3
548340,2,1,10,6,1,7
548352,2,1,10,4,0,4
548362,2,1,10,4,0,4
548368,2,1,10,9,0,9
548386,2,1,10,9,0,9
598003,2,1,10,7,0,7
598010,2,1,10,1,4,5
598021,2,1,10,8,0,8
598036,2,1,10,8,1,9
598039,2,1,10,9,0,9
598048,2,1,10,7,0,7
598055,2,1,10,3,4,7
598062,2,1,10,10,0,10
598066,2,1,10,8,0,8
729312,2,1,10,4,0,4
729320,2,1,10,9,0,9
733976,2,1,10,2,0,2
733984,2,1,10,4,1,5
733990,2,1,10,13,0,13
734002,2,1,10,10,0,10
734014,2,1,10,7,0,7
734020,2,1,10,7,0,7
734028,2,1,10,8,2,10
734042,2,1,10,7,0,7
734054,2,1,10,2,0,2
829710,2,1,10,11,0,11
829728,2,1,10,8,1,9
829738,2,1,10,5,0,5
829744,2,1,10,7,1,8
829748,2,1,10,5,0,5
829770,2,1,10,3,0,3
829796,2,1,10,5,0,5
829810,2,1,10,7,0,7
829816,2,1,10,10,0,10
980908,2,1,10,2,5,7
980920,2,1,10,10,1,11
980930,2,1,10,10,0,10
980944,2,1,10,6,0,6
980956,2,1,10,16,6,22
980964,2,1,10,2,1,3
981020,2,1,10,3,0,3
1082593,2,1,10,7,0,7
1082601,2,1,10,9,0,9
1082608,2,1,10,8,5,13
1082620,2,1,10,13,1,14
1082622,2,1,10,8,0,8
1082627,2,1,10,9,1,10
1082636,2,1,10,9,2,11
1082639,2,1,10,3,0,3
1082644,2,1,10,5,0,5
335997,1,2,10,1,0,1
336011,1,2,10,6,0,6
336017,1,2,10,11,0,11
336021,1,2,10,9,1,10
336031,1,2,10,6,0,6
336034,1,2,10,3,0,3
336039,1,2,10,8,1,9
392187,1,2,10,5,0,5
392196,1,2,10,6,0,6
392199,1,2,10,6,0,6
392209,1,2,10,6,0,6
392218,1,2,10,5,0,5
392241,1,2,10,3,0,3
419114,1,2,10,4,0,4
419128,1,2,10,5,1,6
419138,1,2,10,13,0,13
419150,1,2,10,7,0,7
501210,1,2,10,9,0,9
501237,1,2,10,4,0,4
501249,1,2,10,14,0,14
501273,1,2,10,8,0,8
501275,1,2,10,10,1,11
548315,1,2,10,6,0,6
548323,1,2,10,6,0,6
548341,1,2,10,5,0,5
548355,1,2,10,11,0,11
548367,1,2,10,3,0,3
548372,1,2,10,8,0,8
548377,1,2,10,13,0,13
598004,1,2,10,3,0,3
598009,1,2,10,8,0,8
598017,1,2,10,9,0,9
598032,1,2,10,4,0,4
598041,1,2,10,3,2,5
598047,1,2,10,6,10,16
598050,1,2,10,3,0,3
598059,1,2,10,9,0,9
598062,1,2,10,6,1,7
598069,1,2,10,10,1,11
729310,1,2,10,11,1,12
729318,1,2,10,3,0,3
734004,1,2,10,11,0,11
734010,1,2,10,8,2,10
734026,1,2,10,5,0,5
734040,1,2,10,10,0,10
829724,1,2,10,12,0,12
829768,1,2,10,6,1,7
829790,1,2,10,14,1,15
829800,1,2,10,12,3,15
829824,1,2,10,13,0,13
829826,1,2,10,4,1,5
980912,1,2,10,15,0,15
980926,1,2,10,6,4,10
980932,1,2,10,9,1,10
980936,1,2,10,10,0,10
980942,1,2,10,8,0,8
980964,1,2,10,15,0,15
980982,1,2,10,6,0,6
980986,1,2,10,11,0,11
980992,1,2,10,13,0,13
981004,1,2,10,18,0,18
1082595,1,2,10,6,0,6
1082598,1,2,10,6,0,6
1082602,1,2,10,4,0,4
1082610,1,2,10,9,0,9
1082621,1,2,10,2,1,3
1082628,1,2,10,4,0,4
1082636,1,2,10,3,1,4
1082646,1,2,10,7,0,7
335987,2,2,10,6,2,8
335990,2,2,10,7,0,7
336001,2,2,10,11,0,11
336003,2,2,10,11,1,12
336007,2,2,10,3,0,3
336015,2,2,10,2,0,2
336028,2,2,10,5,0,5
392190,2,2,10,3,0,3
392193,2,2,10,7,0,7
392204,2,2,10,8,0,8
392213,2,2,10,6,0,6
392223,2,2,10,4,0,4
392226,2,2,10,7,0,7
392229,2,2,10,5,0,5
392237,2,2,10,6,0,6
392243,2,2,10,2,1,3
392244,2,2,10,9,1,10
419117,2,2,10,11,0,11
419120,2,2,10,5,0,5
419124,2,2,10,8,0,8
419133,2,2,10,7,0,7
419141,2,2,10,7,2,9
419145,2,2,10,5,0,5
419153,2,2,10,6,1,7
419156,2,2,10,3,0,3
419159,2,2,10,6,0,6
419162,2,2,10,5,1,6
419167,2,2,10,2,1,3
419169,2,2,10,6,1,7
501205,2,2,10,5,0,5
501213,2,2,10,8,0,8
501216,2,2,10,10,0,10
501227,2,2,10,4,0,4
501232,2,2,10,1,0,1
501252,2,2,10,7,0,7
501257,2,2,10,4,0,4
501260,2,2,10,2,2,4
501265,2,2,10,7,0,7
501271,2,2,10,9,0,9
501276,2,2,10,2,0,2
548320,2,2,10,10,0,10
548329,2,2,10,5,0,5
548332,2,2,10,7,0,7
548336,2,2,10,12,0,12
548349,2,2,10,7,2,9
548361,2,2,10,9,0,9
548365,2,2,10,4,0,4
548381,2,2,10,3,0,3
598013,2,2,10,5,0,5
598022,2,2,10,10,0,10
598028,2,2,10,1,2,3
598038,2,2,10,9,1,10
598053,2,2,10,8,0,8
729286,2,2,10,5,1,6
729292,2,2,10,3,0,3
729304,2,2,10,5,0,5
733982,2,2,10,8,1,9
733988,2,2,10,12,4,16
733996,2,2,10,4,0,4
734018,2,2,10,6,0,6
734032,2,2,10,5,0,5
829718,2,2,10,10,1,11
829742,2,2,10,4,0,4
829750,2,2,10,13,0,13
829754,2,2,10,7,0,7
829762,2,2,10,3,0,3
829776,2,2,10,15,0,15
829784,2,2,10,6,0,6
829808,2,2,10,4,1,5
980958,2,2,10,6,0,6
980974,2,2,10,11,0,11
981000,2,2,10,9,0,9
981016,2,2,10,8,0,8
981018,2,2,10,5,0,5
981024,2,2,10,12,0,12
1082591,2,2,10,12,1,13
1082607,2,2,10,3,1,4
1082617,2,2,10,1,0,1
1082624,2,2,10,0,1,1
1082633,2,2,10,13,0,13
335988,1,3,10,5,0,5
335994,1,3,10,9,1,10
336001,1,3,10,5,0,5
336006,1,3,10,12,0,12
336010,1,3,10,7,0,7
336012,1,3,10,6,0,6
336018,1,3,10,6,1,7
336023,1,3,10,9,2,11
336045,1,3,10,11,0,11
392190,1,3,10,9,0,9
392201,1,3,10,10,1,11
392207,1,3,10,12,0,12
392211,1,3,10,13,0,13
392214,1,3,10,6,0,6
392219,1,3,10,4,0,4
392229,1,3,10,5,0,5
392236,1,3,10,5,0,5
392239,1,3,10,5,0,5
392243,1,3,10,4,0,4
419118,1,3,10,4,0,4
419130,1,3,10,14,0,14
419142,1,3,10,2,0,2
419147,1,3,10,14,1,15
419152,1,3,10,5,0,5
419160,1,3,10,2,0,2
419168,1,3,10,7,0,7
419170,1,3,10,8,1,9
501203,1,3,10,6,0,6
501211,1,3,10,12,0,12
501216,1,3,10,9,0,9
501220,1,3,10,7,0,7
501231,1,3,10,3,0,3
501241,1,3,10,5,0,5
501250,1,3,10,10,0,10
501254,1,3,10,7,0,7
501258,1,3,10,12,0,12
501266,1,3,10,3,0,3
501271,1,3,10,1,0,1
501276,1,3,10,10,0,10
548311,1,3,10,6,0,6
548316,1,3,10,4,0,4
548321,1,3,10,3,0,3
548327,1,3,10,4,0,4
548335,1,3,10,4,0,4
548352,1,3,10,6,1,7
548357,1,3,10,7,0,7
548360,1,3,10,4,0,4
548376,1,3,10,1,0,1
548384,1,3,10,14,0,14
548385,1,3,10,6,0,6
548386,1,3,10,4,0,4
598025,1,3,10,3,1,4
598039,1,3,10,7,0,7
598043,1,3,10,9,0,9
598046,1,3,10,14,0,14
598056,1,3,10,12,0,12
598063,1,3,10,8,1,9
598067,1,3,10,2,0,2
598075,1,3,10,6,0,6
729288,1,3,10,6,0,6
729298,1,3,10,10,0,10
729302,1,3,10,5,0,5
733976,1,3,10,13,0,13
734018,1,3,10,3,0,3
734028,1,3,10,4,0,4
734034,1,3,10,4,0,4
829712,1,3,10,4,0,4
829716,1,3,10,11,0,11
829728,1,3,10,7,0,7
829740,1,3,10,3,0,3
829750,1,3,10,7,0,7
829758,1,3,10,11,1,12
829770,1,3,10,2,6,8
829784,1,3,10,3,2,5
829794,1,3,10,2,0,2
829802,1,3,10,10,0,10
829806,1,3,10,1,0,1
335998,2,3,10,5,0,5
336014,2,3,10,3,0,3
336034,2,3,10,1,0,1
336038,2,3,10,13,2,15
336042,2,3,10,4,0,4
336044,2,3,10,2,0,2
392186,2,3,10,3,1,4
392194,2,3,10,9,0,9
392207,2,3,10,3,0,3
392222,2,3,10,5,1,6
392232,2,3,10,5,1,6
419115,2,3,10,11,0,11
419121,2,3,10,13,0,13
419126,2,3,10,6,0,6
419128,2,3,10,8,0,8
419134,2,3,10,4,0,4
419138,2,3,10,8,0,8
419158,2,3,10,14,1,15
419164,2,3,10,8,0,8
501226,2,3,10,8,0,8
501233,2,3,10,10,0,10
501245,2,3,10,6,0,6
501273,2,3,10,10,0,10
548323,2,3,10,14,0,14
548337,2,3,10,4,0,4
548348,2,3,10,3,0,3
548366,2,3,10,4,0,4
548369,2,3,10,5,0,5
548373,2,3,10,8,0,8
598007,2,3,10,9,0,9
598012,2,3,10,6,0,6
598017,2,3,10,10,0,10
598020,2,3,10,6,0,6
598027,2,3,10,8,0,8
598031,2,3,10,11,0,11
598035,2,3,10,1,0,1
598051,2,3,10,8,0,8
598078,2,3,10,3,1,4
729308,2,3,10,10,1,11
729316,2,3,10,3,0,3
733986,2,3,10,2,0,2
733992,2,3,10,13,0,13
734000,2,3,10,15,0,15
734008,2,3,10,2,0,2
734040,2,3,10,3,0,3
734050,2,3,10,9,0,9
734052,2,3,10,3,2,5
829734,2,3,10,7,0,7
829778,2,3,10,6,0,6
829814,2,3,10,9,0,9
829822,2,3,10,6,1,7
829826,2,3,10,4,0,4
829828,2,3,10,9,1,10
335992,1,4,10,9,0,9
335996,1,4,10,8,0,8
336008,1,4,10,3,0,3
336024,1,4,10,9,0,9
336033,1,4,10,10,0,10
336040,1,4,10,11,0,11
336044,1,4,10,1,0,1
392188,1,4,10,12,1,13
392191,1,4,10,9,0,9
392200,1,4,10,8,0,8
392205,1,4,10,6,2,8
392227,1,4,10,3,0,3
392234,1,4,10,3,0,3
419113,1,4,10,10,0,10
419117,1,4,10,14,0,14
419126,1,4,10,4,0,4
419137,1,4,10,9,0,9
419141,1,4,10,8,0,8
419148,1,4,10,7,0,7
419161,1,4,10,9,0,9
419164,1,4,10,12,0,12
501207,1,4,10,1,0,1
501225,1,4,10,8,0,8
501239,1,4,10,2,0,2
501253,1,4,10,11,0,11
501256,1,4,10,13,5,18
501262,1,4,10,6,0,6
501265,1,4,10,21,1,22
548328,1,4,10,11,0,11
548333,1,4,10,2,0,2
548336,1,4,10,6,0,6
548344,1,4,10,3,0,3
548348,1,4,10,4,1,5
548364,1,4,10,9,0,9
548374,1,4,10,2,0,2
548379,1,4,10,14,0,14
598012,1,4,10,8,0,8
598019,1,4,10,10,1,11
598021,1,4,10,7,0,7
598026,1,4,10,7,0,7
598033,1,4,10,6,2,8
598036,1,4,10,8,0,8
598057,1,4,10,7,2,9
598071,1,4,10,12,0,12
729300,1,4,10,14,1,15
729312,1,4,10,5,0,5
733978,1,4,10,6,1,7
733992,1,4,10,9,0,9
733996,1,4,10,14,0,14
734002,1,4,10,12,0,12
734030,1,4,10,5,0,5
734038,1,4,10,6,2,8
734052,1,4,10,10,1,11
734054,1,4,10,4,0,4
829722,1,4,10,9,1,10
829730,1,4,10,3,0,3
829738,1,4,10,11,2,13
829772,1,4,10,3,0,3
829796,1,4,10,11,0,11
829808,1,4,10,6,0,6
829814,1,4,10,2,0,2
980910,1,4,10,5,0,5
980918,1,4,10,4,0,4
980930,1,4,10,4,0,4
980940,1,4,10,2,0,2
980960,1,4,10,4,0,4
980976,1,4,10,7,0,7
980996,1,4,10,11,0,11
981010,1,4,10,9,0,9
1082601,1,4,10,17,0,17
1082612,1,4,10,6,0,6
1082616,1,4,10,7,1,8
1082633,1,4,10,2,0,2
1082637,1,4,10,9,0,9
1082639,1,4,10,5,1,6
1082641,1,4,10,4,1,5
1082645,1,4,10,5,0,5
335988,2,4,10,13,0,13
336000,2,4,10,6,0,6
336004,2,4,10,10,0,10
336011,2,4,10,14,0,14
336018,2,4,10,7,1,8
336021,2,4,10,4,0,4
336036,2,4,10,4,0,4
392196,2,4,10,12,1,13
392209,2,4,10,7,0,7
392212,2,4,10,3,1,4
392215,2,4,10,2,2,4
392219,2,4,10,5,1,6
392221,2,4,10,6,0,6
392231,2,4,10,1,0,1
392239,2,4,10,3,1,4
419122,2,4,10,6,0,6
419129,2,4,10,9,1,10
419132,2,4,10,9,0,9
419144,2,4,10,14,0,14
419151,2,4,10,6,0,6
419154,2,4,10,6,1,7
501211,2,4,10,13,0,13
501217,2,4,10,8,0,8
501228,2,4,10,5,0,5
501242,2,4,10,6,1,7
501249,2,4,10,4,0,4
501259,2,4,10,11,1,12
501269,2,4,10,4,1,5
548314,2,4,10,4,1,5
548318,2,4,10,4,4,8
548324,2,4,10,5,0,5
548339,2,4,10,14,0,14
548355,2,4,10,7,0,7
548359,2,4,10,5,0,5
548371,2,4,10,11,0,11
548376,2,4,10,8,1,9
598008,2,4,10,9,0,9
598030,2,4,10,11,0,11
598042,2,4,10,3,0,3
598046,2,4,10,8,0,8
598050,2,4,10,3,0,3
598061,2,4,10,3,0,3
598064,2,4,10,7,4,11
598069,2,4,10,6,4,10
729288,2,4,10,3,0,3
729296,2,4,10,4,0,4
729318,2,4,10,3,4,7
734012,2,4,10,6,0,6
734024,2,4,10,3,0,3
734044,2,4,10,8,1,9
734048,2,4,10,8,0,8
829714,2,4,10,1,0,1
829746,2,4,10,6,0,6
829758,2,4,10,2,0,2
829764,2,4,10,4,1,5
829780,2,4,10,4,0,4
829790,2,4,10,12,0,12
829804,2,4,10,5,0,5
980924,2,4,10,7,0,7
980946,2,4,10,7,0,7
980968,2,4,10,11,0,11
980982,2,4,10,9,0,9
980990,2,4,10,8,0,8
981004,2,4,10,5,1,6
1082594,2,4,10,7,0,7
1082598,2,4,10,11,1,12
1082605,2,4,10,11,0,11
1082609,2,4,10,1,0,1
1082623,2,4,10,1,0,1
335989,1,5,10,5,1,6
336005,1,5,10,14,0,14
336013,1,5,10,5,0,5
336028,1,5,10,5,3,8
336038,1,5,10,12,0,12
336043,1,5,10,5,1,6
392195,1,5,10,4,1,5
392215,1,5,10,13,1,14
392222,1,5,10,6,0,6
392230,1,5,10,4,0,4
392238,1,5,10,2,1,3
419116,1,5,10,3,0,3
419120,1,5,10,2,0,2
419123,1,5,10,12,0,12
419129,1,5,10,10,0,10
419134,1,5,10,10,0,10
419146,1,5,10,7,0,7
419159,1,5,10,5,0,5
419163,1,5,10,4,0,4
501214,1,5,10,10,0,10
501219,1,5,10,5,0,5
501245,1,5,10,14,0,14
501257,1,5,10,6,0,6
501263,1,5,10,5,0,5
548314,1,5,10,8,1,9
548317,1,5,10,6,0,6
548325,1,5,10,2,5,7
548329,1,5,10,4,0,4
548337,1,5,10,6,0,6
548354,1,5,10,8,0,8
548359,1,5,10,7,0,7
548366,1,5,10,16,2,18
548370,1,5,10,16,0,16
548378,1,5,10,6,0,6
548382,1,5,10,20,2,22
598006,1,5,10,8,0,8
598010,1,5,10,10,0,10
598014,1,5,10,10,1,11
598024,1,5,10,15,1,16
598028,1,5,10,6,0,6
598031,1,5,10,5,1,6
598048,1,5,10,7,2,9
598077,1,5,10,4,0,4
729296,1,5,10,8,0,8
729320,1,5,10,6,0,6
733984,1,5,10,5,0,5
734008,1,5,10,19,0,19
734016,1,5,10,7,2,9
734046,1,5,10,5,1,6
829714,1,5,10,12,0,12
829746,1,5,10,12,0,12
829754,1,5,10,5,0,5
829782,1,5,10,10,0,10
829816,1,5,10,10,2,12
335992,2,5,10,11,0,11
335995,2,5,10,4,0,4
335997,2,5,10,4,1,5
336010,2,5,10,4,0,4
336016,2,5,10,12,0,12
336020,2,5,10,15,0,15
336024,2,5,10,13,0,13
336032,2,5,10,7,0,7
336041,2,5,10,13,0,13
336045,2,5,10,14,0,14
392187,2,5,10,4,0,4
392200,2,5,10,5,0,5
392203,2,5,10,4,0,4
392207,2,5,10,4,0,4
392210,2,5,10,6,0,6
392218,2,5,10,11,0,11
392225,2,5,10,8,0,8
392235,2,5,10,9,1,10
419112,2,5,10,4,0,4
419131,2,5,10,11,0,11
419139,2,5,10,2,0,2
419142,2,5,10,15,0,15
419148,2,5,10,3,0,3
419155,2,5,10,9,0,9
501204,2,5,10,4,0,4
501209,2,5,10,12,0,12
501225,2,5,10,6,0,6
501230,2,5,10,11,0,11
501236,2,5,10,9,0,9
501240,2,5,10,7,1,8
501254,2,5,10,2,0,2
501268,2,5,10,9,0,9
548322,2,5,10,7,0,7
548331,2,5,10,11,0,11
548341,2,5,10,8,0,8
548350,2,5,10,6,0,6
548363,2,5,10,6,0,6
598019,2,5,10,6,0,6
598037,2,5,10,8,0,8
598041,2,5,10,7,0,7
598052,2,5,10,8,0,8
598054,2,5,10,9,0,9
598057,2,5,10,8,0,8
598063,2,5,10,6,0,6
598068,2,5,10,2,0,2
598070,2,5,10,2,0,2
598076,2,5,10,2,0,2
729290,2,5,10,12,0,12
729302,2,5,10,3,0,3
729310,2,5,10,2,0,2
733980,2,5,10,11,0,11
733994,2,5,10,7,4,11
734004,2,5,10,5,0,5
734022,2,5,10,1,0,1
734038,2,5,10,5,1,6
829720,2,5,10,11,0,11
829726,2,5,10,4,0,4
829732,2,5,10,6,0,6
829740,2,5,10,15,0,15
829774,2,5,10,5,0,5
829792,2,5,10,15,0,15
829802,2,5,10,4,0,4
829824,2,5,10,7,0,7
336000,1,6,10,9,0,9
336003,1,6,10,12,0,12
336014,1,6,10,8,1,9
336020,1,6,10,3,1,4
336025,1,6,10,9,1,10
336027,1,6,10,10,1,11
392194,1,6,10,8,0,8
392203,1,6,10,5,0,5
392228,1,6,10,3,1,4
392231,1,6,10,1,0,1
392235,1,6,10,5,0,5
392237,1,6,10,5,0,5
392242,1,6,10,4,4,8
419121,1,6,10,4,1,5
419133,1,6,10,6,1,7
419136,1,6,10,9,0,9
419139,1,6,10,8,1,9
419145,1,6,10,10,0,10
419154,1,6,10,5,0,5
501206,1,6,10,8,0,8
501209,1,6,10,1,1,2
501228,1,6,10,11,0,11
501232,1,6,10,5,0,5
501238,1,6,10,4,0,4
501243,1,6,10,7,0,7
501270,1,6,10,7,1,8
548347,1,6,10,6,0,6
548350,1,6,10,11,0,11
548362,1,6,10,4,0,4
548369,1,6,10,4,0,4
598003,1,6,10,8,0,8
598015,1,6,10,2,0,2
598022,1,6,10,3,1,4
598040,1,6,10,1,0,1
598049,1,6,10,5,0,5
598054,1,6,10,2,0,2
598064,1,6,10,3,0,3
729286,1,6,10,5,4,9
733980,1,6,10,2,1,3
733986,1,6,10,9,0,9
733990,1,6,10,5,0,5
733998,1,6,10,2,0,2
734024,1,6,10,6,0,6
734044,1,6,10,3,1,4
829720,1,6,10,13,0,13
829736,1,6,10,14,0,14
829744,1,6,10,9,0,9
829752,1,6,10,5,0,5
829762,1,6,10,9,0,9
829788,1,6,10,3,0,3
829818,1,6,10,10,2,12
980908,1,6,10,2,0,2
980938,1,6,10,4,1,5
980956,1,6,10,9,0,9
980970,1,6,10,5,1,6
981002,1,6,10,7,0,7
981016,1,6,10,8,0,8
1082599,1,6,10,5,0,5
1082605,1,6,10,12,0,12
1082608,1,6,10,12,0,12
1082622,1,6,10,7,0,7
1082626,1,6,10,4,0,4
1082642,1,6,10,2,0,2
335989,2,6,10,7,1,8
335993,2,6,10,12,0,12
336006,2,6,10,5,0,5
336009,2,6,10,16,0,16
336022,2,6,10,5,0,5
336031,2,6,10,5,0,5
336037,2,6,10,9,0,9
336043,2,6,10,6,2,8
392199,2,6,10,3,0,3
392206,2,6,10,8,0,8
392211,2,6,10,3,0,3
392216,2,6,10,3,0,3
392220,2,6,10,6,0,6
392224,2,6,10,3,0,3
392240,2,6,10,16,0,16
419113,2,6,10,7,0,7
419116,2,6,10,9,0,9
419119,2,6,10,3,0,3
419125,2,6,10,4,0,4
419149,2,6,10,11,0,11
419157,2,6,10,3,2,5
419160,2,6,10,5,1,6
419165,2,6,10,4,0,4
501218,2,6,10,8,0,8
501221,2,6,10,7,0,7
501235,2,6,10,7,0,7
501248,2,6,10,17,0,17
501251,2,6,10,10,0,10
501258,2,6,10,4,1,5
501262,2,6,10,6,0,6
548312,2,6,10,17,0,17
548315,2,6,10,2,0,2
548321,2,6,10,10,0,10
548326,2,6,10,7,1,8
548330,2,6,10,5,0,5
548334,2,6,10,10,0,10
548338,2,6,10,4,1,5
548342,2,6,10,9,0,9
548354,2,6,10,8,0,8
548374,2,6,10,2,0,2
548377,2,6,10,14,0,14
548379,2,6,10,4,1,5
548383,2,6,10,9,1,10
548385,2,6,10,7,0,7
598006,2,6,10,7,1,8
598011,2,6,10,14,1,15
598025,2,6,10,9,0,9
598029,2,6,10,14,0,14
598033,2,6,10,11,4,15
598045,2,6,10,6,0,6
598059,2,6,10,4,0,4
598067,2,6,10,4,1,5
598072,2,6,10,3,0,3
729294,2,6,10,13,0,13
729298,2,6,10,7,0,7
729306,2,6,10,14,0,14
729314,2,6,10,6,0,6
734010,2,6,10,3,0,3
734016,2,6,10,5,0,5
734036,2,6,10,3,0,3
829712,2,6,10,9,0,9
829730,2,6,10,5,0,5
829766,2,6,10,10,0,10
829772,2,6,10,11,0,11
829782,2,6,10,0,1,1
829798,2,6,10,3,0,3
829806,2,6,10,6,0,6
980918,2,6,10,6,2,8
980926,2,6,10,12,0,12
980950,2,6,10,8,0,8
980966,2,6,10,8,0,8
980976,2,6,10,15,0,15
980988,2,6,10,4,0,4
980998,2,6,10,10,1,11
981008,2,6,10,6,0,6
1082595,2,6,10,9,0,9
1082611,2,6,10,6,1,7
1082614,2,6,10,13,0,13
1082630,2,6,10,15,1,16
1082632,2,6,10,16,0,16
1082635,2,6,10,2,1,3
1082640,2,6,10,10,0,10
1082646,2,6,10,8,1,9
335990,1,7,10,1,1,2
335999,1,7,10,7,0,7
336009,1,7,10,8,4,12
336029,1,7,10,4,0,4
336037,1,7,10,2,0,2
336041,1,7,10,9,0,9
392186,1,7,10,9,0,9
392202,1,7,10,8,0,8
392208,1,7,10,5,0,5
392213,1,7,10,5,0,5
392220,1,7,10,4,0,4
392223,1,7,10,5,0,5
392232,1,7,10,5,0,5
392240,1,7,10,4,2,6
419112,1,7,10,11,1,12
419119,1,7,10,7,7,14
419124,1,7,10,5,0,5
419135,1,7,10,5,1,6
419143,1,7,10,8,0,8
419151,1,7,10,8,0,8
419155,1,7,10,5,0,5
419157,1,7,10,2,0,2
419162,1,7,10,5,2,7
419166,1,7,10,3,0,3
419167,1,7,10,6,1,7
501215,1,7,10,6,0,6
501226,1,7,10,6,2,8
501229,1,7,10,2,0,2
501236,1,7,10,2,0,2
501242,1,7,10,10,0,10
501246,1,7,10,3,0,3
501251,1,7,10,9,0,9
501268,1,7,10,4,0,4
548322,1,7,10,4,1,5
548330,1,7,10,3,0,3
548339,1,7,10,2,0,2
548356,1,7,10,11,5,16
548365,1,7,10,6,0,6
548368,1,7,10,6,1,7
598007,1,7,10,5,0,5
598011,1,7,10,5,0,5
598016,1,7,10,8,0,8
598029,1,7,10,4,0,4
598038,1,7,10,11,0,11
598042,1,7,10,11,0,11
598044,1,7,10,7,0,7
598051,1,7,10,2,0,2
598055,1,7,10,6,0,6
598068,1,7,10,8,0,8
598078,1,7,10,7,1,8
729292,1,7,10,3,0,3
729308,1,7,10,10,0,10
729314,1,7,10,3,0,3
733988,1,7,10,8,0,8
734000,1,7,10,3,0,3
734014,1,7,10,6,0,6
734022,1,7,10,6,0,6
734036,1,7,10,10,0,10
734050,1,7,10,10,0,10
829710,1,7,10,3,0,3
829726,1,7,10,6,0,6
829734,1,7,10,9,0,9
829742,1,7,10,10,0,10
829756,1,7,10,10,0,10
829774,1,7,10,7,1,8
829780,1,7,10,12,0,12
829810,1,7,10,8,0,8
829822,1,7,10,8,0,8
829828,1,7,10,10,0,10
980906,1,7,10,1,0,1
980922,1,7,10,8,0,8
980928,1,7,10,4,0,4
980946,1,7,10,8,0,8
980990,1,7,10,8,0,8
980998,1,7,10,10,0,10
981012,1,7,10,5,0,5
1082592,1,7,10,6,0,6
1082614,1,7,10,5,2,7
1082635,1,7,10,5,0,5
1082638,1,7,10,5,1,6
1082644,1,7,10,7,0,7
1082650,1,7,10,6,0,6
335994,2,7,10,8,0,8
335996,2,7,10,2,0,2
336002,2,7,10,5,1,6
336013,2,7,10,12,1,13
336017,2,7,10,8,0,8
336023,2,7,10,14,3,17
336033,2,7,10,7,0,7
392197,2,7,10,8,0,8
392202,2,7,10,4,0,4
392205,2,7,10,3,0,3
392217,2,7,10,10,0,10
392227,2,7,10,12,0,12
392230,2,7,10,5,0,5
419119,2,7,10,1,0,1
419127,2,7,10,5,0,5
419130,2,7,10,4,0,4
419137,2,7,10,8,0,8
419147,2,7,10,5,0,5
419170,2,7,10,14,1,15
501206,2,7,10,3,1,4
501210,2,7,10,12,0,12
501223,2,7,10,6,0,6
501256,2,7,10,8,0,8
501261,2,7,10,4,4,8
501272,2,7,10,8,1,9
501274,2,7,10,4,0,4
501275,2,7,10,8,0,8
548311,2,7,10,4,0,4
548313,2,7,10,4,0,4
548319,2,7,10,5,0,5
548344,2,7,10,5,0,5
548347,2,7,10,9,1,10
548351,2,7,10,5,0,5
548360,2,7,10,4,0,4
548372,2,7,10,5,0,5
548375,2,7,10,7,0,7
548382,2,7,10,7,0,7
548384,2,7,10,4,1,5
598004,2,7,10,2,2,4
598024,2,7,10,3,0,3
598034,2,7,10,4,0,4
598060,2,7,10,5,0,5
598065,2,7,10,6,0,6
598071,2,7,10,7,0,7
598075,2,7,10,3,0,3
598077,2,7,10,3,0,3
729284,2,7,10,7,0,7
729322,2,7,10,12,0,12
733978,2,7,10,1,0,1
734006,2,7,10,13,0,13
734030,2,7,10,11,0,11
734046,2,7,10,15,1,16
829722,2,7,10,5,0,5
829752,2,7,10,9,0,9
829788,2,7,10,4,0,4
829794,2,7,10,9,0,9
829800,2,7,10,17,0,17
829820,2,7,10,7,1,8
980914,2,7,10,10,5,15
980932,2,7,10,11,0,11
980938,2,7,10,8,0,8
980952,2,7,10,7,0,7
980962,2,7,10,4,0,4
980978,2,7,10,4,0,4
980986,2,7,10,2,0,2
1082597,2,7,10,2,0,2
1082600,2,7,10,9,0,9
1082602,2,7,10,11,0,11
1082606,2,7,10,3,1,4
1082612,2,7,10,6,0,6
1082618,2,7,10,8,0,8
1082625,2,7,10,6,0,6
1082628,2,7,10,4,0,4
1082641,2,7,10,4,0,4
1082647,2,7,10,9,0,9
1082649,2,7,10,3,0,3
335991,1,8,10,2,2,4
335993,1,8,10,1,1,2
335995,1,8,10,7,0,7
336004,1,8,10,9,0,9
336007,1,8,10,5,0,5
336016,1,8,10,8,0,8
336036,1,8,10,3,1,4
336042,1,8,10,6,0,6
392193,1,8,10,14,0,14
392197,1,8,10,12,0,12
392206,1,8,10,3,0,3
392210,1,8,10,4,0,4
392217,1,8,10,4,0,4
392221,1,8,10,2,0,2
392225,1,8,10,8,0,8
392244,1,8,10,3,0,3
419115,1,8,10,11,0,11
419122,1,8,10,16,0,16
419125,1,8,10,6,0,6
419131,1,8,10,6,1,7
419156,1,8,10,12,0,12
419165,1,8,10,13,0,13
419169,1,8,10,2,0,2
501204,1,8,10,5,0,5
501213,1,8,10,3,0,3
501217,1,8,10,10,0,10
501221,1,8,10,13,0,13
501234,1,8,10,4,0,4
501248,1,8,10,9,0,9
501255,1,8,10,7,0,7
501261,1,8,10,1,0,1
501269,1,8,10,3,0,3
548319,1,8,10,6,0,6
548326,1,8,10,3,0,3
548331,1,8,10,6,0,6
548334,1,8,10,3,1,4
548340,1,8,10,6,0,6
548346,1,8,10,6,1,7
548351,1,8,10,3,0,3
548353,1,8,10,10,0,10
548361,1,8,10,5,0,5
548371,1,8,10,11,0,11
548381,1,8,10,5,1,6
335999,2,8,10,21,1,22
336012,2,8,10,1,0,1
336019,2,8,10,2,2,4
336025,2,8,10,6,0,6
336029,2,8,10,3,0,3
336039,2,8,10,5,1,6
392189,2,8,10,16,1,17
392201,2,8,10,5,0,5
392214,2,8,10,3,1,4
392228,2,8,10,3,0,3
392233,2,8,10,3,0,3
392234,2,8,10,4,0,4
392241,2,8,10,6,1,7
392242,2,8,10,4,0,4
419111,2,8,10,11,0,11
419135,2,8,10,9,0,9
419140,2,8,10,8,1,9
419143,2,8,10,7,0,7
419146,2,8,10,9,0,9
419150,2,8,10,9,3,12
419152,2,8,10,4,0,4
419161,2,8,10,8,0,8
419168,2,8,10,3,0,3
501208,2,8,10,9,0,9
501229,2,8,10,7,0,7
501241,2,8,10,7,0,7
501244,2,8,10,4,0,4
501264,2,8,10,7,0,7
548316,2,8,10,10,0,10
548357,2,8,10,6,1,7
548364,2,8,10,2,0,2
548378,2,8,10,3,1,4
501205,1,9,10,2,0,2
501212,1,9,10,12,0,12
501224,1,9,10,0,0,0
501230,1,9,10,7,0,7
501247,1,9,10,9,0,9
501252,1,9,10,4,0,4
501259,1,9,10,9,0,9
501215,2,9,10,10,0,10
501220,2,9,10,9,0,9
501234,2,9,10,2,0,2
501238,2,9,10,2,1,3
501243,2,9,10,6,1,7
501266,2,9,10,3,0,3
501218,1,10,10,14,0,14
501223,1,10,10,6,0,6
501233,1,10,10,4,0,4
501240,1,10,10,5,0,5
501264,1,10,10,9,0,9
501267,1,10,10,8,0,8
548313,1,10,10,3,0,3
548318,1,10,10,12,1,13
548324,1,10,10,7,0,7
548332,1,10,10,11,1,12
548338,1,10,10,4,2,6
548342,1,10,10,4,0,4
548363,1,10,10,6,0,6
598008,1,10,10,5,0,5
598020,1,10,10,8,0,8
598030,1,10,10,9,0,9
598052,1,10,10,11,1,12
598060,1,10,10,4,0,4
598066,1,10,10,15,0,15
598072,1,10,10,3,0,3
501207,2,10,10,2,1,3
501212,2,10,10,2,0,2
501231,2,10,10,6,0,6
501237,2,10,10,3,0,3
501246,2,10,10,1,0,1
501253,2,10,10,4,0,4
501255,2,10,10,9,0,9
548327,2,10,10,6,0,6
548335,2,10,10,4,0,4
548346,2,10,10,2,0,2
548353,2,10,10,6,0,6
548356,2,10,10,2,0,2
548358,2,10,10,10,1,11
548367,2,10,10,6,1,7
548370,2,10,10,8,0,8
548380,2,10,10,6,0,6
598005,2,10,10,4,0,4
598014,2,10,10,5,0,5
598016,2,10,10,4,0,4
598023,2,10,10,6,0,6
598032,2,10,10,8,0,8
598040,2,10,10,4,0,4
598043,2,10,10,7,0,7
598047,2,10,10,8,1,9
598058,2,10,10,5,0,5
598005,1,11,10,2,0,2
598023,1,11,10,1,0,1
598035,1,11,10,3,2,5
598037,1,11,10,7,0,7
598053,1,11,10,6,0,6
598061,1,11,10,4,0,4
598065,1,11,10,10,0,10
598070,1,11,10,8,0,8
598076,1,11,10,6,0,6
729290,1,11,10,7,0,7
729306,1,11,10,9,0,9
729316,1,11,10,3,0,3
729322,1,11,10,6,0,6
733982,1,11,10,10,1,11
733994,1,11,10,6,1,7
734006,1,11,10,2,0,2
734012,1,11,10,5,0,5
734020,1,11,10,12,0,12
734042,1,11,10,5,0,5
829732,1,11,10,4,0,4
829748,1,11,10,13,0,13
829764,1,11,10,6,0,6
829778,1,11,10,8,0,8
829792,1,11,10,12,0,12
829798,1,11,10,5,0,5
829804,1,11,10,12,1,13
829812,1,11,10,8,0,8
829820,1,11,10,4,0,4
980920,1,11,10,3,1,4
980948,1,11,10,3,0,3
980958,1,11,10,8,0,8
980978,1,11,10,8,1,9
980984,1,11,10,11,1,12
980988,1,11,10,11,1,12
981008,1,11,10,4,1,5
981020,1,11,10,9,0,9
981024,1,11,10,9,0,9
1082591,1,11,10,4,0,4
1082600,1,11,10,11,2,13
1082609,1,11,10,3,1,4
1082611,1,11,10,7,0,7
1082615,1,11,10,8,0,8
1082623,1,11,10,8,0,8
1082627,1,11,10,18,0,18
1082630,1,11,10,4,1,5
1082648,1,11,10,13,0,13
598009,2,11,10,4,0,4
598015,2,11,10,1,1,2
598018,2,11,10,11,0,11
598026,2,11,10,6,0,6
598044,2,11,10,4,1,5
598049,2,11,10,3,0,3
598056,2,11,10,11,0,11
598074,2,11,10,3,0,3
729300,2,11,10,10,0,10
734026,2,11,10,4,0,4
734034,2,11,10,8,0,8
829716,2,11,10,10,1,11
829724,2,11,10,5,0,5
829736,2,11,10,10,0,10
829756,2,11,10,6,0,6
829786,2,11,10,4,0,4
980912,2,11,10,5,1,6
980928,2,11,10,10,0,10
980934,2,11,10,9,1,10
980940,2,11,10,3,0,3
980972,2,11,10,3,0,3
980996,2,11,10,3,1,4
981014,2,11,10,3,0,3
981022,2,11,10,4,0,4
1082596,2,11,10,12,1,13
1082604,2,11,10,6,0,6
1082634,2,11,10,4,1,5
1082638,2,11,10,7,0,7
1082643,2,11,10,11,0,11
980916,1,12,10,5,0,5
980924,1,12,10,3,0,3
980944,1,12,10,6,0,6
980954,1,12,10,14,1,15
980962,1,12,10,2,0,2
980974,1,12,10,5,2,7
980994,1,12,10,5,2,7
1082594,1,12,10,10,0,10
1082603,1,12,10,5,0,5
1082607,1,12,10,10,0,10
1082618,1,12,10,10,0,10
1082620,1,12,10,9,0,9
1082624,1,12,10,4,0,4
1082634,1,12,10,3,0,3
1082647,1,12,10,5,0,5
980906,2,12,10,3,0,3
980936,2,12,10,8,0,8
980948,2,12,10,8,0,8
980970,2,12,10,9,0,9
980984,2,12,10,5,0,5
981002,2,12,10,3,0,3
981010,2,12,10,3,0,3
1082592,2,12,10,11,0,11
1082599,2,12,10,10,0,10
1082615,2,12,10,15,0,15
1082629,2,12,10,15,0,15
1082631,2,12,10,7,0,7
1082642,2,12,10,4,0,4
1082645,2,12,10,4,0,4
1082650,2,12,10,8,0,8
980934,1,13,10,7,0,7
980950,1,13,10,10,0,10
980966,1,13,10,8,0,8
980972,1,13,10,7,2,9
981018,1,13,10,16,0,16
981022,1,13,10,4,0,4
1082593,1,13,10,15,0,15
1082596,1,13,10,3,0,3
1082606,1,13,10,8,0,8
1082625,1,13,10,8,0,8
1082629,1,13,10,8,0,8
1082632,1,13,10,10,0,10
1082640,1,13,10,5,1,6
1082643,1,13,10,12,0,12
980910,2,13,10,9,0,9
980916,2,13,10,4,2,6
980922,2,13,10,8,0,8
980942,2,13,10,8,0,8
980954,2,13,10,12,0,12
980960,2,13,10,7,1,8
980980,2,13,10,8,0,8
980992,2,13,10,3,0,3
981006,2,13,10,9,1,10
981012,2,13,10,4,0,4
1082603,2,13,10,1,1,2
1082610,2,13,10,7,1,8
1082613,2,13,10,3,0,3
1082616,2,13,10,11,1,12
1082621,2,13,10,6,2,8
1082637,2,13,10,12,0,12
335987,1,1,11,11,4,15
335998,1,1,11,3,0,3
336002,1,1,11,11,0,11
336015,1,1,11,3,0,3
336019,1,1,11,3,0,3
336022,1,1,11,3,0,3
336026,1,1,11,2,0,2
336030,1,1,11,7,1,8
336032,1,1,11,10,0,10
392189,1,1,11,5,0,5
392204,1,1,11,5,0,5
392212,1,1,11,6,0,6
392216,1,1,11,2,0,2
392224,1,1,11,3,0,3
392226,1,1,11,3,4,7
392233,1,1,11,10,0,10
419111,1,1,11,2,2,4
419127,1,1,11,3,0,3
419132,1,1,11,14,0,14
419140,1,1,11,3,0,3
419144,1,1,11,9,0,9
419149,1,1,11,12,0,12
419153,1,1,11,18,0,18
419158,1,1,11,14,0,14
501208,1,1,11,9,0,9
501227,1,1,11,14,0,14
501235,1,1,11,15,0,15
501244,1,1,11,5,1,6
501260,1,1,11,11,0,11
501272,1,1,11,15,0,15
501274,1,1,11,15,0,15
548312,1,1,11,3,0,3
548320,1,1,11,11,0,11
548349,1,1,11,9,0,9
548358,1,1,11,8,0,8
548373,1,1,11,10,0,10
548375,1,1,11,9,1,10
548380,1,1,11,4,0,4
548383,1,1,11,2,1,3
598013,1,1,11,6,0,6
598018,1,1,11,4,1,5
598027,1,1,11,3,0,3
598034,1,1,11,7,0,7
598045,1,1,11,3,1,4
598058,1,1,11,7,0,7
598074,1,1,11,4,0,4
729284,1,1,11,6,0,6
729294,1,1,11,12,0,12
729304,1,1,11,6,1,7
734032,1,1,11,9,0,9
734048,1,1,11,7,1,8
829718,1,1,11,5,0,5
829766,1,1,11,7,0,7
829786,1,1,11,4,0,4
980914,1,1,11,18,0,18
980952,1,1,11,6,0,6
980968,1,1,11,9,0,9
980980,1,1,11,7,0,7
981000,1,1,11,3,1,4
981006,1,1,11,3,1,4
981014,1,1,11,6,0,6
1082597,1,1,11,3,0,3
1082604,1,1,11,12,0,12
1082613,1,1,11,13,0,13
1082617,1,1,11,6,0,6
1082631,1,1,11,15,0,15
1082649,1,1,11,10,0,10
335991,2,1,11,11,0,11
336005,2,1,11,14,1,15
336008,2,1,11,5,0,5
336040,2,1,11,3,1,4
392195,2,1,11,4,2,6
392202,2,1,11,2,0,2
392208,2,1,11,4,1,5
392236,2,1,11,8,0,8
392238,2,1,11,6,0,6
419114,2,1,11,9,0,9
419118,2,1,11,2,2,4
419123,2,1,11,7,0,7
419136,2,1,11,10,1,11
419163,2,1,11,4,0,4
419166,2,1,11,4,0,4
501203,2,1,11,12,0,12
501214,2,1,11,6,0,6
501219,2,1,11,8,0,8
501224,2,1,11,5,0,5
501239,2,1,11,4,5,9
501247,2,1,11,0,0,0
501267,2,1,11,11,0,11
548317,2,1,11,8,0,8
548325,2,1,11,2,0,2
548328,2,1,11,3,0,3
548333,2,1,11,4,1,5
548340,2,1,11,8,0,8
548352,2,1,11,7,0,7
548362,2,1,11,6,0,6
548368,2,1,11,6,0,6
548386,2,1,11,11,0,11
598003,2,1,11,5,0,5
598010,2,1,11,1,0,1
598021,2,1,11,10,0,10
598036,2,1,11,1,0,1
598039,2,1,11,9,0,9
598048,2,1,11,8,0,8
598055,2,1,11,5,1,6
598062,2,1,11,1,0,1
598066,2,1,11,11,0,11
729312,2,1,11,6,1,7
729320,2,1,11,5,1,6
733976,2,1,11,3,0,3
733984,2,1,11,13,0,13
733990,2,1,11,12,0,12
734002,2,1,11,2,0,2
734014,2,1,11,10,0,10
734020,2,1,11,6,0,6
734028,2,1,11,8,0,8
734042,2,1,11,22,0,22
734054,2,1,11,18,0,18
829710,2,1,11,9,0,9
829728,2,1,11,9,0,9
829738,2,1,11,9,0,9
829744,2,1,11,9,0,9
829748,2,1,11,7,0,7
829770,2,1,11,1,0,1
829796,2,1,11,9,1,10
829810,2,1,11,14,0,14
829816,2,1,11,5,1,6
980908,2,1,11,7,0,7
980920,2,1,11,14,0,14
980930,2,1,11,5,0,5
980944,2,1,11,3,0,3
980956,2,1,11,4,1,5
980964,2,1,11,4,0,4
981020,2,1,11,4,0,4
1082593,2,1,11,14,1,15
1082601,2,1,11,5,2,7
1082608,2,1,11,4,1,5
1082620,2,1,11,10,0,10
1082622,2,1,11,3,0,3
1082627,2,1,11,8,0,8
1082636,2,1,11,10,0,10
1082639,2,1,11,3,0,3
1082644,2,1,11,14,0,14
335997,1,2,11,1,0,1
336011,1,2,11,7,0,7
336017,1,2,11,17,1,18
336021,1,2,11,3,0,3
336031,1,2,11,3,0,3
336034,1,2,11,3,0,3
336039,1,2,11,5,0,5
392187,1,2,11,3,0,3
392196,1,2,11,3,0,3
392199,1,2,11,4,0,4
392209,1,2,11,10,0,10
392218,1,2,11,4,0,4
392241,1,2,11,18,0,18
419114,1,2,11,6,1,7
419128,1,2,11,8,0,8
419138,1,2,11,6,0,6
419150,1,2,11,3,0,3
501210,1,2,11,3,2,5
501237,1,2,11,6,0,6
501249,1,2,11,19,0,19
501273,1,2,11,3,0,3
501275,1,2,11,3,0,3
548315,1,2,11,6,0,6
548323,1,2,11,8,0,8
548341,1,2,11,2,0,2
548355,1,2,11,5,0,5
548367,1,2,11,5,0,5
548372,1,2,11,14,2,16
548377,1,2,11,4,0,4
598004,1,2,11,15,0,15
598009,1,2,11,7,0,7
598017,1,2,11,5,0,5
598032,1,2,11,12,0,12
598041,1,2,11,16,0,16
598047,1,2,11,15,0,15
598050,1,2,11,6,0,6
598059,1,2,11,5,0,5
598062,1,2,11,3,0,3
598069,1,2,11,8,0,8
729310,1,2,11,2,0,2
729318,1,2,11,7,0,7
734004,1,2,11,9,0,9
734010,1,2,11,14,0,14
734026,1,2,11,12,0,12
734040,1,2,11,7,0,7
829724,1,2,11,7,0,7
829768,1,2,11,9,1,10
829790,1,2,11,14,1,15
829800,1,2,11,13,0,13
829824,1,2,11,10,0,10
829826,1,2,11,5,1,6
980912,1,2,11,11,0,11
980926,1,2,11,9,0,9
980932,1,2,11,4,0,4
980936,1,2,11,18,0,18
980942,1,2,11,4,1,5
980964,1,2,11,13,0,13
980982,1,2,11,6,0,6
980986,1,2,11,2,0,2
980992,1,2,11,5,0,5
981004,1,2,11,18,0,18
1082595,1,2,11,5,0,5
1082598,1,2,11,6,0,6
1082602,1,2,11,5,0,5
1082610,1,2,11,16,1,17
1082621,1,2,11,12,0,12
1082628,1,2,11,7,0,7
1082636,1,2,11,8,0,8
1082646,1,2,11,5,0,5
335987,2,2,11,5,0,5
335990,2,2,11,4,0,4
336001,2,2,11,9,0,9
336003,2,2,11,14,0,14
336007,2,2,11,18,0,18
336015,2,2,11,15,0,15
336028,2,2,11,4,0,4
392190,2,2,11,9,1,10
392193,2,2,11,8,0,8
392204,2,2,11,4,0,4
392213,2,2,11,6,1,7
392223,2,2,11,10,0,10
392226,2,2,11,4,0,4
392229,2,2,11,6,0,6
392237,2,2,11,10,0,10
392243,2,2,11,6,0,6
392244,2,2,11,9,0,9
419117,2,2,11,11,0,11
419120,2,2,11,1,2,3
419124,2,2,11,7,0,7
419133,2,2,11,8,0,8
419141,2,2,11,8,0,8
419145,2,2,11,15,0,15
419153,2,2,11,6,0,6
419156,2,2,11,5,0,5
419159,2,2,11,12,0,12
419162,2,2,11,10,0,10
419167,2,2,11,11,1,12
419169,2,2,11,7,0,7
501205,2,2,11,1,0,1
501213,2,2,11,3,0,3
501216,2,2,11,9,1,10
501227,2,2,11,14,0,14
501232,2,2,11,5,0,5
501252,2,2,11,6,0,6
501257,2,2,11,4,0,4
501260,2,2,11,7,0,7
501265,2,2,11,3,4,7
501271,2,2,11,1,0,1
501276,2,2,11,4,0,4
548320,2,2,11,14,0,14
548329,2,2,11,3,0,3
548332,2,2,11,4,1,5
548336,2,2,11,4,0,4
548349,2,2,11,3,0,3
548361,2,2,11,9,1,10
548365,2,2,11,21,1,22
548381,2,2,11,3,0,3
598013,2,2,11,13,2,15
598022,2,2,11,12,0,12
598028,2,2,11,6,5,11
598038,2,2,11,3,0,3
598053,2,2,11,12,1,13
729286,2,2,11,10,0,10
729292,2,2,11,7,0,7
729304,2,2,11,13,0,13
733982,2,2,11,2,0,2
733988,2,2,11,11,0,11
733996,2,2,11,21,3,24
734018,2,2,11,12,1,13
734032,2,2,11,6,1,7
829718,2,2,11,16,0,16
829742,2,2,11,15,1,16
829750,2,2,11,9,0,9
829754,2,2,11,5,0,5
829762,2,2,11,9,0,9
829784,2,2,11,2,0,2
980958,2,2,11,6,0,6
980974,2,2,11,13,0,13
981000,2,2,11,5,0,5
981016,2,2,11,2,0,2
981018,2,2,11,10,1,11
981024,2,2,11,8,0,8
1082591,2,2,11,12,1,13
1082607,2,2,11,3,2,5
1082624,2,2,11,4,0,4
1082633,2,2,11,4,0,4
335988,1,3,11,19,0,19
335994,1,3,11,14,0,14
336001,1,3,11,7,0,7
336006,1,3,11,16,0,16
336010,1,3,11,1,0,1
336012,1,3,11,3,1,4
336018,1,3,11,15,0,15
336023,1,3,11,0,0,0
336045,1,3,11,2,0,2
392190,1,3,11,2,0,2
392201,1,3,11,8,0,8
392207,1,3,11,3,0,3
392211,1,3,11,14,0,14
392214,1,3,11,4,0,4
392219,1,3,11,12,0,12
392229,1,3,11,12,0,12
392236,1,3,11,7,0,7
392239,1,3,11,3,1,4
392243,1,3,11,2,1,3
419118,1,3,11,5,0,5
419130,1,3,11,8,2,10
419142,1,3,11,6,0,6
419147,1,3,11,11,0,11
419152,1,3,11,4,1,5
419160,1,3,11,5,0,5
419168,1,3,11,8,0,8
419170,1,3,11,9,0,9
501203,1,3,11,5,0,5
501211,1,3,11,10,1,11
501216,1,3,11,17,0,17
501220,1,3,11,7,0,7
501231,1,3,11,3,0,3
501241,1,3,11,5,0,5
501250,1,3,11,9,0,9
501254,1,3,11,4,1,5
501258,1,3,11,6,0,6
501266,1,3,11,4,1,5
501271,1,3,11,8,0,8
501276,1,3,11,9,0,9
548311,1,3,11,4,1,5
548316,1,3,11,9,1,10
548321,1,3,11,2,0,2
548327,1,3,11,10,3,13
548335,1,3,11,6,0,6
548352,1,3,11,3,0,3
548357,1,3,11,7,2,9
548360,1,3,11,12,1,13
548376,1,3,11,1,0,1
548384,1,3,11,19,0,19
548385,1,3,11,21,0,21
548386,1,3,11,5,0,5
598025,1,3,11,8,1,9
598039,1,3,11,3,0,3
598043,1,3,11,6,0,6
598046,1,3,11,13,0,13
598056,1,3,11,13,0,13
598063,1,3,11,6,1,7
598067,1,3,11,6,0,6
598075,1,3,11,15,0,15
729288,1,3,11,10,0,10
729298,1,3,11,12,0,12
729302,1,3,11,3,0,3
733976,1,3,11,6,1,7
734018,1,3,11,11,1,12
734028,1,3,11,3,0,3
734034,1,3,11,8,0,8
829712,1,3,11,5,1,6
829716,1,3,11,7,0,7
829728,1,3,11,5,4,9
829740,1,3,11,5,0,5
829750,1,3,11,9,0,9
829758,1,3,11,11,0,11
829770,1,3,11,6,0,6
829784,1,3,11,5,0,5
829794,1,3,11,3,0,3
829802,1,3,11,4,1,5
829806,1,3,11,7,0,7
335998,2,3,11,4,0,4
336014,2,3,11,1,1,2
336034,2,3,11,4,0,4
336038,2,3,11,12,1,13
336042,2,3,11,5,0,5
336044,2,3,11,13,0,13
392186,2,3,11,3,0,3
392194,2,3,11,7,0,7
392207,2,3,11,3,0,3
392222,2,3,11,3,0,3
392232,2,3,11,8,0,8
419115,2,3,11,8,0,8
419121,2,3,11,17,0,17
419126,2,3,11,9,1,10
419128,2,3,11,3,0,3
419134,2,3,11,5,0,5
419138,2,3,11,16,0,16
419158,2,3,11,17,1,18
419164,2,3,11,1,0,1
501226,2,3,11,13,0,13
501233,2,3,11,6,0,6
501245,2,3,11,19,0,19
501273,2,3,11,8,0,8
548323,2,3,11,6,0,6
548337,2,3,11,6,0,6
548348,2,3,11,4,0,4
548366,2,3,11,4,0,4
548369,2,3,11,8,0,8
548373,2,3,11,2,0,2
598007,2,3,11,4,0,4
598012,2,3,11,6,0,6
598017,2,3,11,4,0,4
598020,2,3,11,11,0,11
598027,2,3,11,5,0,5
598031,2,3,11,11,0,11
598035,2,3,11,8,0,8
598051,2,3,11,4,0,4
598078,2,3,11,3,0,3
729308,2,3,11,2,0,2
729316,2,3,11,10,0,10
733986,2,3,11,9,0,9
733992,2,3,11,4,1,5
734000,2,3,11,7,0,7
734008,2,3,11,4,0,4
734040,2,3,11,3,0,3
734050,2,3,11,9,0,9
734052,2,3,11,12,0,12
829734,2,3,11,3,1,4
829778,2,3,11,12,0,12
829814,2,3,11,5,0,5
829822,2,3,11,2,0,2
829826,2,3,11,2,0,2
829828,2,3,11,14,0,14
335992,1,4,11,3,0,3
335996,1,4,11,13,0,13
336008,1,4,11,6,0,6
336024,1,4,11,16,0,16
336033,1,4,11,8,1,9
336040,1,4,11,13,0,13
336044,1,4,11,5,0,5
392188,1,4,11,7,0,7
392191,1,4,11,14,0,14
392200,1,4,11,3,0,3
392205,1,4,11,5,0,5
392227,1,4,11,7,2,9
392234,1,4,11,5,0,5
419113,1,4,11,11,0,11
419117,1,4,11,9,0,9
419126,1,4,11,5,0,5
419137,1,4,11,6,0,6
419141,1,4,11,10,0,10
419148,1,4,11,17,0,17
419161,1,4,11,13,1,14
419164,1,4,11,4,0,4
501207,1,4,11,4,0,4
501225,1,4,11,10,1,11
501239,1,4,11,8,1,9
501253,1,4,11,6,0,6
501256,1,4,11,6,4,10
501262,1,4,11,18,0,18
501265,1,4,11,10,2,12
548328,1,4,11,8,0,8
548333,1,4,11,5,0,5
548336,1,4,11,4,1,5
548344,1,4,11,11,0,11
548348,1,4,11,15,0,15
548364,1,4,11,5,0,5
548374,1,4,11,8,0,8
548379,1,4,11,6,0,6
598012,1,4,11,4,2,6
598019,1,4,11,6,0,6
598021,1,4,11,3,0,3
598026,1,4,11,14,0,14
598033,1,4,11,5,0,5
598036,1,4,11,4,0,4
598057,1,4,11,11,0,11
598071,1,4,11,7,0,7
729300,1,4,11,9,0,9
729312,1,4,11,11,0,11
733978,1,4,11,6,3,9
733992,1,4,11,15,2,17
733996,1,4,11,8,0,8
734002,1,4,11,5,0,5
734030,1,4,11,3,0,3
734038,1,4,11,10,1,11
734052,1,4,11,2,0,2
734054,1,4,11,9,0,9
829722,1,4,11,4,0,4
829730,1,4,11,10,0,10
829738,1,4,11,6,0,6
829772,1,4,11,2,0,2
829796,1,4,11,3,0,3
829814,1,4,11,3,0,3
980910,1,4,11,11,0,11
980918,1,4,11,1,0,1
980930,1,4,11,5,1,6
980940,1,4,11,6,0,6
980960,1,4,11,8,0,8
980976,1,4,11,4,0,4
980996,1,4,11,10,0,10
981010,1,4,11,5,0,5
1082601,1,4,11,2,0,2
1082612,1,4,11,10,1,11
1082616,1,4,11,3,0,3
1082633,1,4,11,5,0,5
1082637,1,4,11,8,0,8
1082639,1,4,11,3,1,4
1082641,1,4,11,4,1,5
1082645,1,4,11,4,0,4
335988,2,4,11,5,0,5
336000,2,4,11,7,1,8
336004,2,4,11,13,0,13
336011,2,4,11,0,0,0
336018,2,4,11,10,1,11
336021,2,4,11,20,1,21
336036,2,4,11,2,2,4
392196,2,4,11,4,0,4
392209,2,4,11,3,0,3
392212,2,4,11,4,0,4
392215,2,4,11,12,0,12
392219,2,4,11,10,0,10
392221,2,4,11,6,4,10
392231,2,4,11,9,1,10
392239,2,4,11,2,1,3
419122,2,4,11,7,0,7
419129,2,4,11,5,0,5
419132,2,4,11,5,0,5
419144,2,4,11,16,0,16
419151,2,4,11,2,0,2
419154,2,4,11,6,0,6
501211,2,4,11,11,0,11
501217,2,4,11,3,4,7
501228,2,4,11,7,0,7
501242,2,4,11,11,0,11
501249,2,4,11,5,0,5
501259,2,4,11,12,0,12
501269,2,4,11,7,0,7
548314,2,4,11,11,0,11
548318,2,4,11,5,0,5
548324,2,4,11,8,0,8
548339,2,4,11,5,0,5
548355,2,4,11,10,0,10
548359,2,4,11,3,0,3
548371,2,4,11,7,0,7
548376,2,4,11,6,0,6
598008,2,4,11,7,1,8
598030,2,4,11,7,0,7
598042,2,4,11,7,4,11
598046,2,4,11,8,0,8
598050,2,4,11,9,2,11
598061,2,4,11,6,0,6
598064,2,4,11,8,0,8
598069,2,4,11,11,0,11
729288,2,4,11,11,0,11
729296,2,4,11,15,1,16
729318,2,4,11,7,0,7
734012,2,4,11,9,1,10
734024,2,4,11,5,0,5
734044,2,4,11,13,1,14
734048,2,4,11,9,0,9
829714,2,4,11,11,0,11
829746,2,4,11,17,0,17
829758,2,4,11,9,0,9
829764,2,4,11,4,0,4
829780,2,4,11,9,0,9
829790,2,4,11,2,0,2
829804,2,4,11,4,0,4
980924,2,4,11,15,0,15
980946,2,4,11,13,0,13
980968,2,4,11,12,0,12
980982,2,4,11,5,0,5
980990,2,4,11,5,0,5
981004,2,4,11,6,0,6
1082594,2,4,11,9,3,12
1082598,2,4,11,10,0,10
1082605,2,4,11,8,0,8
1082609,2,4,11,1,0,1
1082623,2,4,11,12,0,12
335989,1,5,11,2,0,2
336005,1,5,11,14,0,14
336013,1,5,11,3,0,3
336028,1,5,11,6,0,6
336038,1,5,11,20,0,20
336043,1,5,11,20,1,21
392195,1,5,11,2,0,2
392215,1,5,11,9,0,9
392222,1,5,11,7,0,7
392230,1,5,11,7,0,7
392238,1,5,11,1,0,1
419116,1,5,11,7,0,7
419120,1,5,11,4,0,4
419123,1,5,11,3,0,3
419129,1,5,11,6,1,7
419134,1,5,11,4,0,4
419146,1,5,11,10,2,12
419159,1,5,11,3,1,4
419163,1,5,11,4,0,4
501214,1,5,11,8,0,8
501219,1,5,11,3,3,6
501245,1,5,11,2,0,2
501257,1,5,11,3,0,3
501263,1,5,11,7,0,7
548314,1,5,11,6,0,6
548317,1,5,11,6,0,6
548325,1,5,11,4,0,4
548329,1,5,11,5,0,5
548337,1,5,11,9,0,9
548354,1,5,11,7,0,7
548359,1,5,11,2,0,2
548366,1,5,11,6,0,6
548370,1,5,11,12,0,12
548378,1,5,11,7,1,8
548382,1,5,11,9,0,9
598006,1,5,11,12,0,12
598010,1,5,11,4,0,4
598014,1,5,11,8,0,8
598024,1,5,11,8,0,8
598028,1,5,11,4,0,4
598031,1,5,11,8,2,10
598048,1,5,11,4,0,4
598077,1,5,11,8,0,8
729296,1,5,11,13,0,13
729320,1,5,11,10,0,10
733984,1,5,11,5,0,5
734008,1,5,11,2,0,2
734016,1,5,11,10,1,11
734046,1,5,11,19,0,19
829714,1,5,11,1,2,3
829746,1,5,11,4,0,4
829754,1,5,11,9,0,9
829782,1,5,11,6,0,6
829816,1,5,11,4,0,4
335992,2,5,11,12,0,12
335995,2,5,11,7,0,7
335997,2,5,11,6,0,6
336010,2,5,11,9,1,10
336016,2,5,11,5,0,5
336020,2,5,11,8,0,8
336024,2,5,11,11,0,11
336032,2,5,11,10,1,11
336041,2,5,11,5,0,5
336045,2,5,11,5,0,5
392187,2,5,11,14,1,15
392200,2,5,11,10,0,10
392203,2,5,11,4,0,4
392207,2,5,11,2,0,2
392210,2,5,11,8,0,8
392218,2,5,11,5,0,5
392225,2,5,11,12,1,13
392235,2,5,11,10,1,11
419112,2,5,11,19,0,19
419131,2,5,11,5,0,5
419139,2,5,11,3,1,4
419142,2,5,11,9,0,9
419148,2,5,11,5,0,5
419155,2,5,11,3,0,3
501204,2,5,11,7,0,7
501209,2,5,11,6,0,6
501225,2,5,11,13,0,13
501230,2,5,11,3,0,3
501236,2,5,11,5,0,5
501240,2,5,11,2,0,2
501254,2,5,11,8,0,8
501268,2,5,11,12,0,12
548322,2,5,11,10,0,10
548331,2,5,11,12,0,12
548341,2,5,11,12,1,13
548350,2,5,11,10,1,11
548363,2,5,11,10,0,10
598019,2,5,11,5,0,5
598037,2,5,11,17,0,17
598041,2,5,11,5,0,5
598052,2,5,11,10,0,10
598054,2,5,11,8,0,8
598057,2,5,11,7,2,9
598063,2,5,11,22,1,23
598068,2,5,11,9,0,9
598070,2,5,11,5,0,5
598076,2,5,11,5,0,5
729290,2,5,11,8,0,8
729302,2,5,11,7,0,7
729310,2,5,11,7,0,7
733980,2,5,11,5,0,5
733994,2,5,11,4,0,4
734004,2,5,11,14,0,14
734022,2,5,11,1,0,1
734038,2,5,11,6,0,6
829720,2,5,11,4,1,5
829726,2,5,11,9,0,9
829732,2,5,11,2,0,2
829740,2,5,11,6,0,6
829774,2,5,11,11,0,11
829792,2,5,11,9,0,9
829802,2,5,11,8,0,8
829824,2,5,11,3,0,3
336000,1,6,11,12,0,12
336003,1,6,11,11,0,11
336014,1,6,11,13,1,14
336020,1,6,11,7,0,7
336025,1,6,11,10,0,10
336027,1,6,11,2,1,3
392194,1,6,11,6,0,6
392203,1,6,11,3,0,3
392228,1,6,11,5,0,5
392231,1,6,11,8,2,10
392235,1,6,11,6,0,6
392237,1,6,11,5,0,5
392242,1,6,11,2,0,2
419121,1,6,11,11,1,12
419133,1,6,11,5,0,5
419136,1,6,11,6,0,6
419139,1,6,11,7,0,7
419145,1,6,11,3,0,3
419154,1,6,11,5,0,5
501206,1,6,11,5,1,6
501209,1,6,11,11,0,11
501228,1,6,11,13,0,13
501232,1,6,11,5,0,5
501238,1,6,11,4,3,7
501243,1,6,11,4,2,6
501270,1,6,11,1,0,1
548347,1,6,11,22,1,23
548350,1,6,11,15,0,15
548362,1,6,11,4,1,5
548369,1,6,11,4,0,4
598003,1,6,11,7,0,7
598015,1,6,11,5,0,5
598022,1,6,11,5,0,5
598040,1,6,11,2,0,2
598049,1,6,11,7,2,9
598054,1,6,11,15,0,15
598064,1,6,11,16,0,16
729286,1,6,11,9,0,9
733980,1,6,11,4,2,6
733986,1,6,11,13,0,13
733990,1,6,11,16,0,16
733998,1,6,11,9,0,9
734024,1,6,11,0,0,0
734044,1,6,11,13,0,13
829720,1,6,11,8,1,9
829736,1,6,11,11,1,12
829744,1,6,11,9,0,9
829752,1,6,11,16,0,16
829762,1,6,11,8,0,8
829788,1,6,11,8,0,8
829818,1,6,11,18,0,18
980908,1,6,11,8,5,13
980938,1,6,11,5,0,5
980956,1,6,11,7,0,7
980970,1,6,11,7,1,8
981002,1,6,11,5,0,5
981016,1,6,11,5,0,5
1082599,1,6,11,7,0,7
1082605,1,6,11,6,1,7
1082608,1,6,11,4,0,4
1082622,1,6,11,4,1,5
1082626,1,6,11,9,0,9
1082642,1,6,11,3,1,4
335989,2,6,11,9,0,9
335993,2,6,11,5,0,5
336006,2,6,11,6,1,7
336009,2,6,11,4,0,4
336022,2,6,11,3,0,3
336031,2,6,11,7,0,7
336037,2,6,11,2,0,2
336043,2,6,11,8,0,8
392199,2,6,11,5,0,5
392206,2,6,11,4,1,5
392211,2,6,11,7,0,7
392216,2,6,11,5,5,10
392220,2,6,11,2,2,4
392224,2,6,11,3,1,4
392240,2,6,11,5,6,11
419113,2,6,11,4,0,4
419116,2,6,11,7,0,7
419119,2,6,11,11,0,11
419125,2,6,11,5,1,6
419149,2,6,11,10,0,10
419157,2,6,11,3,0,3
419160,2,6,11,3,1,4
419165,2,6,11,5,1,6
501218,2,6,11,10,1,11
501221,2,6,11,6,0,6
501235,2,6,11,2,0,2
501248,2,6,11,7,0,7
501251,2,6,11,8,0,8
501258,2,6,11,3,3,6
501262,2,6,11,5,0,5
548312,2,6,11,7,2,9
548315,2,6,11,4,0,4
548321,2,6,11,8,0,8
548326,2,6,11,4,0,4
548330,2,6,11,9,0,9
548334,2,6,11,11,1,12
548338,2,6,11,10,2,12
548342,2,6,11,12,0,12
548354,2,6,11,6,0,6
548374,2,6,11,15,0,15
548377,2,6,11,9,0,9
548379,2,6,11,9,0,9
548383,2,6,11,5,0,5
548385,2,6,11,8,1,9
598006,2,6,11,7,2,9
598011,2,6,11,13,0,13
598025,2,6,11,4,0,4
598029,2,6,11,7,0,7
598033,2,6,11,4,0,4
598045,2,6,11,7,0,7
598059,2,6,11,8,0,8
598067,2,6,11,4,4,8
598072,2,6,11,7,0,7
729294,2,6,11,4,0,4
729298,2,6,11,10,0,10
729306,2,6,11,12,0,12
729314,2,6,11,11,1,12
734010,2,6,11,6,0,6
734016,2,6,11,5,0,5
734036,2,6,11,7,0,7
829712,2,6,11,8,0,8
829730,2,6,11,10,0,10
829766,2,6,11,7,0,7
829772,2,6,11,11,2,13
829782,2,6,11,4,1,5
829798,2,6,11,1,0,1
829806,2,6,11,8,0,8
980918,2,6,11,9,2,11
980926,2,6,11,7,0,7
980950,2,6,11,7,0,7
980966,2,6,11,3,0,3
980976,2,6,11,6,0,6
980988,2,6,11,5,0,5
980998,2,6,11,3,0,3
981008,2,6,11,7,0,7
1082595,2,6,11,6,0,6
1082611,2,6,11,3,0,3
1082614,2,6,11,10,0,10
1082630,2,6,11,5,0,5
1082632,2,6,11,23,1,24
1082635,2,6,11,8,0,8
1082640,2,6,11,6,0,6
1082646,2,6,11,8,0,8
335990,1,7,11,7,0,7
335999,1,7,11,2,0,2
336009,1,7,11,4,0,4
336029,1,7,11,4,1,5
336037,1,7,11,15,0,15
336041,1,7,11,9,2,11
392186,1,7,11,9,0,9
392202,1,7,11,7,0,7
392208,1,7,11,3,1,4
392213,1,7,11,8,0,8
392220,1,7,11,4,0,4
392223,1,7,11,9,0,9
392232,1,7,11,5,0,5
392240,1,7,11,2,1,3
419112,1,7,11,10,0,10
419119,1,7,11,10,0,10
419124,1,7,11,1,1,2
419135,1,7,11,7,0,7
419143,1,7,11,8,1,9
419151,1,7,11,6,0,6
419155,1,7,11,1,3,4
419157,1,7,11,5,0,5
419162,1,7,11,3,0,3
419166,1,7,11,2,0,2
419167,1,7,11,3,0,3
501215,1,7,11,18,0,18
501226,1,7,11,7,0,7
501229,1,7,11,2,0,2
501236,1,7,11,1,0,1
501242,1,7,11,10,0,10
501246,1,7,11,4,0,4
501251,1,7,11,6,0,6
501268,1,7,11,6,0,6
548322,1,7,11,7,0,7
548330,1,7,11,2,0,2
548339,1,7,11,7,0,7
548356,1,7,11,6,0,6
548365,1,7,11,8,0,8
548368,1,7,11,17,1,18
598007,1,7,11,5,2,7
598011,1,7,11,7,0,7
598016,1,7,11,7,0,7
598029,1,7,11,13,0,13
598038,1,7,11,9,0,9
598042,1,7,11,5,1,6
598044,1,7,11,9,0,9
598051,1,7,11,5,0,5
598055,1,7,11,8,0,8
598068,1,7,11,13,0,13
598078,1,7,11,7,0,7
729292,1,7,11,6,0,6
729308,1,7,11,12,0,12
729314,1,7,11,2,0,2
733988,1,7,11,3,0,3
734000,1,7,11,12,0,12
734014,1,7,11,2,0,2
734022,1,7,11,9,1,10
734036,1,7,11,12,0,12
734050,1,7,11,4,0,4
829710,1,7,11,9,0,9
829726,1,7,11,1,0,1
829734,1,7,11,9,0,9
829742,1,7,11,14,0,14
829756,1,7,11,11,0,11
829774,1,7,11,7,0,7
829780,1,7,11,6,0,6
829810,1,7,11,6,0,6
829822,1,7,11,5,0,5
829828,1,7,11,12,0,12
980906,1,7,11,3,0,3
980922,1,7,11,3,0,3
980928,1,7,11,2,1,3
980946,1,7,11,10,0,10
980990,1,7,11,2,0,2
980998,1,7,11,6,0,6
981012,1,7,11,15,0,15
1082592,1,7,11,8,2,10
1082614,1,7,11,6,0,6
1082635,1,7,11,13,0,13
1082638,1,7,11,8,0,8
1082644,1,7,11,7,0,7
1082650,1,7,11,9,0,9
335994,2,7,11,4,3,7
335996,2,7,11,1,0,1
336002,2,7,11,6,0,6
336013,2,7,11,7,1,8
336017,2,7,11,16,0,16
336023,2,7,11,7,1,8
336033,2,7,11,9,0,9
392197,2,7,11,2,0,2
392202,2,7,11,2,0,2
392205,2,7,11,5,1,6
392217,2,7,11,4,0,4
392227,2,7,11,10,2,12
392230,2,7,11,2,0,2
419119,2,7,11,7,0,7
419127,2,7,11,4,0,4
419130,2,7,11,2,1,3
419137,2,7,11,7,0,7
419147,2,7,11,5,1,6
419170,2,7,11,8,1,9
501206,2,7,11,3,0,3
501210,2,7,11,3,0,3
501223,2,7,11,5,0,5
501256,2,7,11,8,0,8
501261,2,7,11,3,1,4
501272,2,7,11,6,1,7
501274,2,7,11,6,0,6
501275,2,7,11,3,0,3
548311,2,7,11,8,0,8
548313,2,7,11,6,0,6
548319,2,7,11,7,1,8
548344,2,7,11,2,0,2
548347,2,7,11,9,0,9
548351,2,7,11,5,0,5
548360,2,7,11,14,0,14
548372,2,7,11,19,0,19
548375,2,7,11,1,0,1
548382,2,7,11,16,0,16
548384,2,7,11,12,1,13
598004,2,7,11,7,0,7
598024,2,7,11,7,0,7
598034,2,7,11,3,0,3
598060,2,7,11,5,0,5
598065,2,7,11,8,1,9
598071,2,7,11,7,0,7
598075,2,7,11,6,0,6
598077,2,7,11,8,2,10
729284,2,7,11,11,0,11
729322,2,7,11,3,0,3
733978,2,7,11,5,0,5
734006,2,7,11,5,0,5
734030,2,7,11,8,0,8
734046,2,7,11,18,1,19
829722,2,7,11,8,1,9
829752,2,7,11,3,0,3
829788,2,7,11,4,0,4
829794,2,7,11,1,0,1
829800,2,7,11,13,1,14
829820,2,7,11,6,1,7
980914,2,7,11,14,0,14
980932,2,7,11,8,0,8
980938,2,7,11,6,0,6
980952,2,7,11,6,0,6
980962,2,7,11,10,0,10
980978,2,7,11,4,0,4
980986,2,7,11,3,0,3
1082597,2,7,11,9,0,9
1082600,2,7,11,4,1,5
1082602,2,7,11,6,0,6
1082606,2,7,11,3,0,3
1082612,2,7,11,11,0,11
1082618,2,7,11,9,0,9
1082625,2,7,11,8,0,8
1082628,2,7,11,12,0,12
1082641,2,7,11,8,1,9
1082647,2,7,11,4,0,4
1082649,2,7,11,16,0,16
335991,1,8,11,5,0,5
335993,1,8,11,9,0,9
335995,1,8,11,13,1,14
336004,1,8,11,7,0,7
336007,1,8,11,20,0,20
336016,1,8,11,10,0,10
336036,1,8,11,8,1,9
336042,1,8,11,2,0,2
392193,1,8,11,10,0,10
392197,1,8,11,6,1,7
392206,1,8,11,4,2,6
392210,1,8,11,7,0,7
392217,1,8,11,6,0,6
392221,1,8,11,1,0,1
392225,1,8,11,5,0,5
392244,1,8,11,3,0,3
419115,1,8,11,8,0,8
419122,1,8,11,3,0,3
419125,1,8,11,6,0,6
419131,1,8,11,5,0,5
419156,1,8,11,10,0,10
419165,1,8,11,6,0,6
419169,1,8,11,5,0,5
501204,1,8,11,2,0,2
501213,1,8,11,8,0,8
501217,1,8,11,7,0,7
501221,1,8,11,13,0,13
501234,1,8,11,11,0,11
501248,1,8,11,12,0,12
501255,1,8,11,4,0,4
501261,1,8,11,6,0,6
501269,1,8,11,15,2,17
548319,1,8,11,4,0,4
548326,1,8,11,15,2,17
548331,1,8,11,13,0,13
548334,1,8,11,6,0,6
548340,1,8,11,9,0,9
548346,1,8,11,12,0,12
548351,1,8,11,8,0,8
548353,1,8,11,5,0,5
548361,1,8,11,3,0,3
548371,1,8,11,11,0,11
548381,1,8,11,4,0,4
335999,2,8,11,16,1,17
336012,2,8,11,10,0,10
336019,2,8,11,11,1,12
336025,2,8,11,9,0,9
336029,2,8,11,3,0,3
336039,2,8,11,12,0,12
392189,2,8,11,8,0,8
392201,2,8,11,14,0,14
392214,2,8,11,4,1,5
392228,2,8,11,3,1,4
392233,2,8,11,2,0,2
392234,2,8,11,5,0,5
392241,2,8,11,6,0,6
392242,2,8,11,13,0,13
419111,2,8,11,11,0,11
419135,2,8,11,7,0,7
419140,2,8,11,6,0,6
419143,2,8,11,5,2,7
419146,2,8,11,6,0,6
419150,2,8,11,9,0,9
419152,2,8,11,5,0,5
419161,2,8,11,16,0,16
419168,2,8,11,6,0,6
501208,2,8,11,6,1,7
501229,2,8,11,4,0,4
501241,2,8,11,2,0,2
501244,2,8,11,2,0,2
501264,2,8,11,2,0,2
548316,2,8,11,5,0,5
548357,2,8,11,3,0,3
548364,2,8,11,2,0,2
548378,2,8,11,7,0,7
501205,1,9,11,8,1,9
501212,1,9,11,9,0,9
501224,1,9,11,2,1,3
501230,1,9,11,9,0,9
501247,1,9,11,5,0,5
501252,1,9,11,3,0,3
501259,1,9,11,6,0,6
501215,2,9,11,11,0,11
501220,2,9,11,2,0,2
501234,2,9,11,3,0,3
501238,2,9,11,6,0,6
501243,2,9,11,10,0,10
501266,2,9,11,4,1,5
501218,1,10,11,4,0,4
501223,1,10,11,8,0,8
501233,1,10,11,9,0,9
501240,1,10,11,8,0,8
501264,1,10,11,11,0,11
501267,1,10,11,5,0,5
548313,1,10,11,6,1,7
548318,1,10,11,9,0,9
548324,1,10,11,8,1,9
548332,1,10,11,5,0,5
548338,1,10,11,2,1,3
548342,1,10,11,3,0,3
548363,1,10,11,16,0,16
598008,1,10,11,2,0,2
598020,1,10,11,5,1,6
598030,1,10,11,6,0,6
598052,1,10,11,4,1,5
598060,1,10,11,14,0,14
598066,1,10,11,17,0,17
598072,1,10,11,12,0,12
501207,2,10,11,6,0,6
501212,2,10,11,10,0,10
501231,2,10,11,8,0,8
501237,2,10,11,12,1,13
501246,2,10,11,13,0,13
501253,2,10,11,6,0,6
501255,2,10,11,5,0,5
548327,2,10,11,7,2,9
548335,2,10,11,5,2,7
548346,2,10,11,4,1,5
548353,2,10,11,5,0,5
548356,2,10,11,2,0,2
548358,2,10,11,5,4,9
548367,2,10,11,4,0,4
548370,2,10,11,8,0,8
548380,2,10,11,3,0,3
598005,2,10,11,2,0,2
598014,2,10,11,9,0,9
598016,2,10,11,5,0,5
598023,2,10,11,6,0,6
598032,2,10,11,7,2,9
598040,2,10,11,3,0,3
598043,2,10,11,4,0,4
598047,2,10,11,5,0,5
598058,2,10,11,4,0,4
598005,1,11,11,7,0,7
598023,1,11,11,7,0,7
598035,1,11,11,5,0,5
598037,1,11,11,6,0,6
598053,1,11,11,2,0,2
598061,1,11,11,8,0,8
598065,1,11,11,11,0,11
598070,1,11,11,3,0,3
598076,1,11,11,5,2,7
729290,1,11,11,6,0,6
729306,1,11,11,4,0,4
729316,1,11,11,3,4,7
729322,1,11,11,5,0,5
733982,1,11,11,9,0,9
733994,1,11,11,5,0,5
734006,1,11,11,3,0,3
734012,1,11,11,11,0,11
734020,1,11,11,7,0,7
734042,1,11,11,4,1,5
829732,1,11,11,11,1,12
829748,1,11,11,14,0,14
829764,1,11,11,6,0,6
829778,1,11,11,8,1,9
829792,1,11,11,3,0,3
829798,1,11,11,2,0,2
829804,1,11,11,4,0,4
829812,1,11,11,10,0,10
829820,1,11,11,4,0,4
980920,1,11,11,3,0,3
980948,1,11,11,3,0,3
980958,1,11,11,5,0,5
980978,1,11,11,5,0,5
980984,1,11,11,3,0,3
980988,1,11,11,8,0,8
981008,1,11,11,10,0,10
981020,1,11,11,2,0,2
981024,1,11,11,6,0,6
1082591,1,11,11,10,0,10
1082600,1,11,11,9,0,9
1082609,1,11,11,12,0,12
1082611,1,11,11,10,1,11
1082615,1,11,11,5,0,5
1082623,1,11,11,6,0,6
1082627,1,11,11,3,0,3
1082630,1,11,11,7,0,7
1082648,1,11,11,10,0,10
598009,2,11,11,3,0,3
598015,2,11,11,3,0,3
598018,2,11,11,2,1,3
598026,2,11,11,10,0,10
598044,2,11,11,3,0,3
598049,2,11,11,4,0,4
598056,2,11,11,12,0,12
598074,2,11,11,7,0,7
729300,2,11,11,5,0,5
734026,2,11,11,11,0,11
734034,2,11,11,14,0,14
829716,2,11,11,7,1,8
829724,2,11,11,10,0,10
829736,2,11,11,10,0,10
829756,2,11,11,3,0,3
829786,2,11,11,3,0,3
980912,2,11,11,7,0,7
980928,2,11,11,4,0,4
980934,2,11,11,4,0,4
980940,2,11,11,5,0,5
980972,2,11,11,8,0,8
980996,2,11,11,7,1,8
981014,2,11,11,12,0,12
981022,2,11,11,9,0,9
1082596,2,11,11,12,0,12
1082604,2,11,11,11,0,11
1082634,2,11,11,2,0,2
1082638,2,11,11,11,0,11
1082643,2,11,11,4,0,4
980916,1,12,11,6,0,6
980924,1,12,11,5,1,6
980944,1,12,11,10,0,10
980954,1,12,11,8,0,8
980962,1,12,11,9,0,9
980974,1,12,11,8,0,8
980994,1,12,11,4,0,4
1082594,1,12,11,7,1,8
1082603,1,12,11,9,0,9
1082607,1,12,11,5,1,6
1082618,1,12,11,4,0,4
1082620,1,12,11,6,0,6
1082624,1,12,11,2,0,2
1082634,1,12,11,17,0,17
1082647,1,12,11,9,0,9
980906,2,12,11,6,0,6
980936,2,12,11,7,0,7
980948,2,12,11,5,1,6
980970,2,12,11,10,3,13
980984,2,12,11,8,0,8
981002,2,12,11,12,1,13
981010,2,12,11,8,1,9
1082592,2,12,11,4,0,4
1082599,2,12,11,8,0,8
1082615,2,12,11,4,0,4
1082629,2,12,11,4,1,5
1082631,2,12,11,5,0,5
1082642,2,12,11,6,0,6
1082645,2,12,11,5,0,5
1082650,2,12,11,7,0,7
980934,1,13,11,3,0,3
980950,1,13,11,5,0,5
980966,1,13,11,10,0,10
980972,1,13,11,7,0,7
981018,1,13,11,6,0,6
981022,1,13,11,10,0,10
1082593,1,13,11,4,0,4
1082596,1,13,11,8,0,8
1082606,1,13,11,6,0,6
1082625,1,13,11,12,1,13
1082629,1,13,11,6,1,7
1082632,1,13,11,16,0,16
1082640,1,13,11,7,0,7
1082643,1,13,11,6,0,6
980910,2,13,11,9,0,9
980916,2,13,11,6,2,8
980922,2,13,11,5,1,6
980942,2,13,11,6,1,7
980954,2,13,11,4,0,4
980960,2,13,11,4,0,4
980980,2,13,11,4,0,4
980992,2,13,11,12,1,13
981006,2,13,11,10,0,10
981012,2,13,11,10,1,11
1082603,2,13,11,6,0,6
1082610,2,13,11,3,0,3
1082613,2,13,11,11,0,11
1082616,2,13,11,7,1,8
1082621,2,13,11,15,0,15
1082637,2,13,11,10,1,11
335987,1,1,12,10,0,10
335998,1,1,12,3,1,4
336002,1,1,12,3,0,3
336015,1,1,12,9,1,10
336019,1,1,12,6,1,7
336022,1,1,12,7,0,7
336026,1,1,12,7,0,7
336030,1,1,12,16,0,16
336032,1,1,12,3,0,3
392189,1,1,12,11,0,11
392204,1,1,12,8,0,8
392212,1,1,12,13,0,13
392216,1,1,12,12,0,12
392224,1,1,12,1,2,3
392226,1,1,12,4,1,5
392233,1,1,12,7,0,7
419111,1,1,12,10,0,10
419127,1,1,12,3,1,4
419132,1,1,12,11,1,12
419140,1,1,12,2,1,3
419144,1,1,12,10,1,11
419149,1,1,12,3,1,4
419153,1,1,12,2,0,2
419158,1,1,12,6,1,7
501208,1,1,12,9,0,9
501227,1,1,12,3,0,3
501235,1,1,12,3,1,4
501244,1,1,12,5,0,5
501260,1,1,12,14,0,14
501272,1,1,12,4,0,4
501274,1,1,12,8,0,8
548312,1,1,12,9,0,9
548320,1,1,12,12,0,12
548349,1,1,12,11,0,11
548358,1,1,12,5,0,5
548373,1,1,12,4,0,4
548375,1,1,12,13,1,14
548380,1,1,12,11,0,11
548383,1,1,12,10,0,10
598013,1,1,12,10,0,10
598018,1,1,12,7,0,7
598027,1,1,12,5,0,5
598034,1,1,12,4,1,5
598045,1,1,12,6,0,6
598058,1,1,12,2,0,2
598074,1,1,12,6,0,6
729284,1,1,12,9,0,9
729294,1,1,12,7,0,7
729304,1,1,12,2,0,2
734032,1,1,12,10,0,10
734048,1,1,12,9,0,9
829718,1,1,12,5,0,5
829766,1,1,12,4,0,4
829786,1,1,12,5,0,5
980914,1,1,12,8,1,9
980952,1,1,12,8,0,8
980968,1,1,12,5,1,6
980980,1,1,12,10,0,10
981000,1,1,12,9,0,9
981006,1,1,12,2,0,2
981014,1,1,12,6,0,6
1082597,1,1,12,7,0,7
1082604,1,1,12,7,0,7
1082613,1,1,12,7,0,7
1082617,1,1,12,1,0,1
1082631,1,1,12,15,0,15
1082649,1,1,12,8,0,8
335991,2,1,12,4,11,15
336005,2,1,12,6,1,7
336008,2,1,12,6,0,6
336040,2,1,12,6,1,7
392195,2,1,12,5,1,6
392202,2,1,12,5,0,5
392208,2,1,12,10,0,10
392236,2,1,12,12,0,12
392238,2,1,12,3,0,3
419114,2,1,12,8,0,8
419118,2,1,12,7,0,7
419123,2,1,12,6,1,7
419136,2,1,12,6,1,7
419163,2,1,12,12,0,12
419166,2,1,12,3,0,3
501203,2,1,12,3,0,3
501214,2,1,12,6,0,6
501219,2,1,12,4,0,4
501224,2,1,12,9,0,9
501239,2,1,12,4,1,5
501247,2,1,12,14,1,15
501267,2,1,12,7,0,7
548317,2,1,12,4,0,4
548325,2,1,12,3,1,4
548328,2,1,12,2,4,6
548333,2,1,12,3,0,3
548340,2,1,12,4,1,5
548352,2,1,12,7,0,7
548362,2,1,12,8,0,8
548368,2,1,12,15,0,15
548386,2,1,12,10,0,10
598003,2,1,12,7,0,7
598010,2,1,12,6,0,6
598021,2,1,12,5,0,5
598036,2,1,12,7,4,11
598039,2,1,12,5,0,5
598048,2,1,12,10,0,10
598055,2,1,12,9,0,9
598062,2,1,12,6,0,6
598066,2,1,12,11,0,11
729312,2,1,12,6,1,7
729320,2,1,12,8,0,8
733976,2,1,12,5,0,5
733984,2,1,12,5,0,5
733990,2,1,12,5,0,5
734002,2,1,12,10,1,11
734014,2,1,12,7,0,7
734020,2,1,12,15,0,15
734028,2,1,12,3,0,3
734042,2,1,12,15,1,16
734054,2,1,12,3,0,3
829710,2,1,12,4,0,4
829728,2,1,12,11,0,11
829738,2,1,12,6,1,7
829744,2,1,12,8,0,8
829748,2,1,12,8,0,8
829770,2,1,12,5,0,5
829796,2,1,12,2,0,2
829810,2,1,12,8,0,8
829816,2,1,12,13,0,13
980908,2,1,12,6,0,6
980920,2,1,12,4,1,5
980930,2,1,12,9,0,9
980944,2,1,12,8,0,8
980956,2,1,12,6,0,6
980964,2,1,12,10,1,11
981020,2,1,12,11,0,11
1082593,2,1,12,10,6,16
1082601,2,1,12,5,0,5
1082608,2,1,12,5,1,6
1082620,2,1,12,12,0,12
1082622,2,1,12,9,0,9
1082627,2,1,12,17,0,17
1082636,2,1,12,4,1,5
1082639,2,1,12,3,1,4
1082644,2,1,12,9,0,9
335997,1,2,12,0,0,0
336011,1,2,12,10,1,11
336017,1,2,12,1,0,1
336021,1,2,12,4,0,4
336031,1,2,12,6,0,6
336034,1,2,12,8,0,8
336039,1,2,12,7,1,8
392187,1,2,12,3,0,3
392196,1,2,12,13,0,13
392199,1,2,12,3,0,3
392209,1,2,12,7,1,8
392218,1,2,12,7,0,7
392241,1,2,12,8,0,8
419114,1,2,12,9,0,9
419128,1,2,12,8,3,11
419138,1,2,12,8,0,8
419150,1,2,12,6,0,6
501210,1,2,12,8,1,9
501237,1,2,12,10,0,10
501249,1,2,12,4,0,4
501273,1,2,12,10,0,10
501275,1,2,12,5,0,5
548315,1,2,12,10,0,10
548323,1,2,12,9,5,14
548341,1,2,12,6,5,11
548355,1,2,12,16,2,18
548367,1,2,12,3,1,4
548372,1,2,12,3,0,3
548377,1,2,12,13,0,13
598004,1,2,12,1,0,1
598009,1,2,12,4,0,4
598017,1,2,12,5,0,5
598032,1,2,12,8,3,11
598041,1,2,12,8,0,8
598047,1,2,12,6,0,6
598050,1,2,12,11,0,11
598059,1,2,12,2,2,4
598062,1,2,12,6,0,6
598069,1,2,12,12,0,12
729310,1,2,12,4,0,4
729318,1,2,12,4,0,4
734004,1,2,12,4,0,4
734010,1,2,12,18,0,18
734026,1,2,12,19,0,19
734040,1,2,12,10,0,10
829724,1,2,12,9,0,9
829768,1,2,12,10,0,10
829790,1,2,12,4,0,4
829800,1,2,12,13,0,13
829824,1,2,12,11,1,12
829826,1,2,12,13,0,13
980912,1,2,12,12,0,12
980926,1,2,12,3,0,3
980932,1,2,12,3,0,3
980936,1,2,12,9,0,9
980942,1,2,12,4,0,4
980964,1,2,12,5,0,5
980982,1,2,12,6,0,6
980986,1,2,12,4,0,4
980992,1,2,12,22,0,22
981004,1,2,12,16,3,19
1082595,1,2,12,7,1,8
1082598,1,2,12,6,0,6
1082602,1,2,12,5,0,5
1082610,1,2,12,9,1,10
1082621,1,2,12,4,0,4
1082628,1,2,12,9,0,9
1082636,1,2,12,7,0,7
1082646,1,2,12,19,0,19
335987,2,2,12,3,0,3
335990,2,2,12,14,0,14
336001,2,2,12,9,0,9
336003,2,2,12,8,2,10
336007,2,2,12,4,0,4
336015,2,2,12,8,0,8
336028,2,2,12,8,0,8
392190,2,2,12,5,0,5
392193,2,2,12,9,1,10
392204,2,2,12,6,0,6
392213,2,2,12,6,0,6
392223,2,2,12,5,1,6
392226,2,2,12,6,0,6
392229,2,2,12,3,0,3
392237,2,2,12,6,0,6
392243,2,2,12,3,1,4
392244,2,2,12,1,0,1
419117,2,2,12,14,0,14
419124,2,2,12,8,0,8
419133,2,2,12,4,0,4
419141,2,2,12,7,1,8
419145,2,2,12,6,0,6
419153,2,2,12,3,0,3
419156,2,2,12,5,0,5
419159,2,2,12,11,0,11
419162,2,2,12,4,0,4
419167,2,2,12,4,1,5
419169,2,2,12,11,0,11
501205,2,2,12,4,1,5
501213,2,2,12,6,1,7
501216,2,2,12,7,1,8
501227,2,2,12,17,0,17
501232,2,2,12,3,0,3
501252,2,2,12,3,0,3
501257,2,2,12,7,0,7
501260,2,2,12,3,0,3
501265,2,2,12,8,0,8
501271,2,2,12,5,2,7
501276,2,2,12,13,2,15
548320,2,2,12,2,2,4
548329,2,2,12,3,0,3
548332,2,2,12,7,1,8
548336,2,2,12,10,0,10
548349,2,2,12,4,0,4
548361,2,2,12,4,0,4
548365,2,2,12,3,0,3
548381,2,2,12,8,0,8
598013,2,2,12,8,1,9
598022,2,2,12,7,0,7
598028,2,2,12,3,1,4
598038,2,2,12,9,0,9
598053,2,2,12,14,0,14
729286,2,2,12,7,0,7
729292,2,2,12,8,0,8
729304,2,2,12,3,0,3
733982,2,2,12,12,0,12
733988,2,2,12,7,0,7
733996,2,2,12,9,0,9
734018,2,2,12,8,0,8
734032,2,2,12,11,0,11
829718,2,2,12,10,0,10
829742,2,2,12,18,1,19
829750,2,2,12,2,0,2
829754,2,2,12,5,0,5
829784,2,2,12,13,0,13
980958,2,2,12,3,0,3
980974,2,2,12,3,0,3
981000,2,2,12,5,0,5
981016,2,2,12,3,0,3
981018,2,2,12,8,0,8
981024,2,2,12,9,0,9
1082591,2,2,12,7,0,7
1082607,2,2,12,5,1,6
1082624,2,2,12,7,0,7
1082633,2,2,12,3,0,3
335988,1,3,12,20,0,20
335994,1,3,12,11,5,16
336001,1,3,12,11,0,11
336006,1,3,12,8,0,8
336010,1,3,12,17,0,17
336012,1,3,12,7,0,7
336018,1,3,12,8,1,9
336023,1,3,12,9,0,9
336045,1,3,12,9,1,10
392190,1,3,12,3,0,3
392201,1,3,12,3,1,4
392207,1,3,12,1,1,2
392211,1,3,12,15,0,15
392214,1,3,12,9,2,11
392219,1,3,12,8,0,8
392229,1,3,12,9,0,9
392236,1,3,12,7,1,8
392239,1,3,12,5,0,5
392243,1,3,12,6,1,7
419118,1,3,12,4,0,4
419130,1,3,12,5,1,6
419142,1,3,12,16,0,16
419147,1,3,12,9,0,9
419152,1,3,12,4,0,4
419160,1,3,12,2,0,2
419168,1,3,12,4,0,4
419170,1,3,12,1,0,1
501203,1,3,12,7,0,7
501211,1,3,12,16,0,16
501216,1,3,12,7,0,7
501220,1,3,12,8,0,8
501231,1,3,12,5,0,5
501241,1,3,12,14,0,14
501250,1,3,12,5,1,6
501254,1,3,12,13,0,13
501258,1,3,12,12,0,12
501266,1,3,12,9,0,9
501271,1,3,12,4,0,4
501276,1,3,12,17,1,18
548311,1,3,12,3,1,4
548316,1,3,12,7,1,8
548321,1,3,12,4,0,4
548327,1,3,12,4,0,4
548335,1,3,12,9,0,9
548352,1,3,12,7,0,7
548357,1,3,12,10,0,10
548360,1,3,12,6,1,7
548376,1,3,12,11,0,11
548384,1,3,12,1,1,2
548385,1,3,12,11,0,11
548386,1,3,12,13,0,13
598025,1,3,12,14,0,14
598039,1,3,12,8,0,8
598043,1,3,12,7,0,7
598046,1,3,12,9,0,9
598056,1,3,12,7,0,7
598063,1,3,12,4,0,4
598067,1,3,12,11,0,11
598075,1,3,12,10,0,10
729288,1,3,12,4,0,4
729298,1,3,12,13,0,13
729302,1,3,12,7,0,7
733976,1,3,12,10,0,10
734018,1,3,12,10,0,10
734028,1,3,12,9,0,9
734034,1,3,12,6,0,6
829712,1,3,12,8,0,8
829716,1,3,12,22,1,23
829728,1,3,12,4,0,4
829740,1,3,12,10,2,12
829750,1,3,12,14,1,15
829758,1,3,12,8,0,8
829770,1,3,12,6,0,6
829784,1,3,12,6,0,6
829794,1,3,12,10,0,10
829802,1,3,12,9,0,9
829806,1,3,12,7,0,7
335998,2,3,12,9,0,9
336014,2,3,12,7,0,7
336034,2,3,12,4,0,4
336038,2,3,12,17,0,17
336042,2,3,12,8,3,11
336044,2,3,12,5,0,5
392186,2,3,12,10,0,10
392194,2,3,12,11,0,11
392207,2,3,12,12,0,12
392222,2,3,12,7,0,7
392232,2,3,12,5,1,6
419115,2,3,12,4,0,4
419121,2,3,12,9,1,10
419126,2,3,12,10,1,11
419128,2,3,12,8,1,9
419134,2,3,12,5,0,5
419138,2,3,12,1,1,2
419158,2,3,12,5,0,5
419164,2,3,12,13,1,14
501226,2,3,12,4,0,4
501233,2,3,12,8,1,9
501245,2,3,12,5,0,5
501273,2,3,12,1,0,1
548323,2,3,12,6,0,6
548337,2,3,12,7,0,7
548348,2,3,12,9,1,10
548366,2,3,12,2,1,3
548369,2,3,12,4,0,4
548373,2,3,12,6,0,6
598007,2,3,12,3,1,4
598012,2,3,12,3,0,3
598017,2,3,12,10,0,10
598020,2,3,12,4,0,4
598027,2,3,12,3,0,3
598031,2,3,12,6,0,6
598035,2,3,12,2,0,2
598051,2,3,12,1,1,2
598078,2,3,12,2,0,2
729308,2,3,12,7,0,7
729316,2,3,12,9,0,9
733986,2,3,12,13,1,14
733992,2,3,12,8,0,8
734000,2,3,12,3,0,3
734008,2,3,12,6,1,7
734040,2,3,12,5,0,5
734050,2,3,12,5,0,5
734052,2,3,12,6,0,6
829734,2,3,12,11,0,11
829778,2,3,12,10,1,11
829814,2,3,12,11,0,11
829822,2,3,12,7,0,7
829826,2,3,12,8,0,8
829828,2,3,12,8,0,8
335992,1,4,12,12,0,12
335996,1,4,12,3,0,3
336008,1,4,12,11,0,11
336024,1,4,12,11,0,11
336033,1,4,12,7,1,8
336040,1,4,12,9,0,9
336044,1,4,12,6,0,6
392188,1,4,12,6,0,6
392191,1,4,12,7,7,14
392200,1,4,12,8,0,8
392205,1,4,12,5,0,5
392227,1,4,12,1,0,1
392234,1,4,12,8,0,8
419113,1,4,12,4,0,4
419117,1,4,12,8,0,8
419126,1,4,12,14,0,14
419137,1,4,12,4,0,4
419141,1,4,12,3,1,4
419148,1,4,12,6,0,6
419161,1,4,12,1,0,1
419164,1,4,12,3,0,3
501207,1,4,12,2,0,2
501225,1,4,12,7,0,7
501239,1,4,12,0,2,2
501253,1,4,12,2,0,2
501256,1,4,12,4,0,4
501262,1,4,12,2,0,2
501265,1,4,12,12,2,14
548328,1,4,12,5,0,5
548333,1,4,12,7,0,7
548336,1,4,12,4,2,6
548344,1,4,12,8,0,8
548348,1,4,12,5,0,5
548364,1,4,12,6,0,6
548374,1,4,12,8,0,8
548379,1,4,12,6,1,7
598012,1,4,12,10,0,10
598019,1,4,12,9,0,9
598021,1,4,12,5,0,5
598026,1,4,12,7,0,7
598033,1,4,12,5,0,5
598036,1,4,12,9,0,9
598057,1,4,12,4,4,8
598071,1,4,12,3,0,3
729300,1,4,12,12,0,12
729312,1,4,12,7,0,7
733978,1,4,12,14,0,14
733992,1,4,12,14,0,14
733996,1,4,12,1,0,1
734002,1,4,12,6,0,6
734030,1,4,12,3,1,4
734038,1,4,12,9,0,9
734052,1,4,12,19,1,20
734054,1,4,12,15,0,15
829722,1,4,12,8,0,8
829730,1,4,12,8,1,9
829738,1,4,12,7,1,8
829772,1,4,12,4,0,4
829796,1,4,12,10,0,10
829814,1,4,12,9,0,9
980910,1,4,12,3,1,4
980918,1,4,12,4,0,4
980930,1,4,12,9,1,10
980940,1,4,12,6,0,6
980960,1,4,12,7,1,8
980976,1,4,12,13,0,13
980996,1,4,12,6,0,6
981010,1,4,12,7,0,7
1082601,1,4,12,1,0,1
1082612,1,4,12,11,0,11
1082616,1,4,12,13,0,13
1082633,1,4,12,3,0,3
1082637,1,4,12,10,0,10
1082639,1,4,12,18,1,19
1082641,1,4,12,10,0,10
1082645,1,4,12,5,0,5
335988,2,4,12,12,0,12
336000,2,4,12,13,1,14
336004,2,4,12,10,1,11
336011,2,4,12,11,1,12
336018,2,4,12,8,0,8
336021,2,4,12,10,0,10
336036,2,4,12,10,0,10
392196,2,4,12,7,0,7
392209,2,4,12,3,4,7
392212,2,4,12,9,0,9
392215,2,4,12,8,1,9
392219,2,4,12,15,0,15
392221,2,4,12,5,0,5
392231,2,4,12,4,0,4
392239,2,4,12,2,0,2
419122,2,4,12,4,0,4
419129,2,4,12,5,0,5
419132,2,4,12,3,0,3
419144,2,4,12,13,0,13
419151,2,4,12,3,1,4
419154,2,4,12,3,0,3
501211,2,4,12,9,0,9
501217,2,4,12,4,1,5
501228,2,4,12,13,1,14
501242,2,4,12,4,1,5
501249,2,4,12,3,0,3
501259,2,4,12,19,0,19
501269,2,4,12,2,0,2
548314,2,4,12,3,0,3
548318,2,4,12,12,2,14
548324,2,4,12,3,0,3
548339,2,4,12,6,0,6
548355,2,4,12,8,0,8
548359,2,4,12,10,0,10
548371,2,4,12,16,0,16
548376,2,4,12,5,0,5
598008,2,4,12,7,0,7
598030,2,4,12,12,0,12
598042,2,4,12,3,1,4
598046,2,4,12,19,0,19
598050,2,4,12,9,0,9
598061,2,4,12,2,0,2
598064,2,4,12,8,0,8
598069,2,4,12,10,1,11
729288,2,4,12,11,1,12
729296,2,4,12,16,1,17
729318,2,4,12,14,0,14
734012,2,4,12,15,0,15
734024,2,4,12,6,1,7
734044,2,4,12,8,1,9
734048,2,4,12,3,0,3
829714,2,4,12,4,0,4
829746,2,4,12,2,1,3
829758,2,4,12,2,0,2
829764,2,4,12,6,0,6
829780,2,4,12,7,1,8
829790,2,4,12,13,0,13
829804,2,4,12,4,1,5
980924,2,4,12,10,0,10
980946,2,4,12,7,0,7
980968,2,4,12,17,0,17
980982,2,4,12,5,0,5
980990,2,4,12,7,1,8
981004,2,4,12,9,0,9
1082594,2,4,12,3,0,3
1082598,2,4,12,11,1,12
1082605,2,4,12,9,0,9
1082609,2,4,12,4,0,4
1082623,2,4,12,8,0,8
335989,1,5,12,12,0,12
336005,1,5,12,7,1,8
336013,1,5,12,3,0,3
336028,1,5,12,9,0,9
336038,1,5,12,10,0,10
336043,1,5,12,9,0,9
392195,1,5,12,5,0,5
392215,1,5,12,11,0,11
392222,1,5,12,6,0,6
392230,1,5,12,11,0,11
392238,1,5,12,1,0,1
419116,1,5,12,9,0,9
419120,1,5,12,13,0,13
419123,1,5,12,8,0,8
419129,1,5,12,6,0,6
419134,1,5,12,11,0,11
419146,1,5,12,7,0,7
419159,1,5,12,9,0,9
419163,1,5,12,7,0,7
501214,1,5,12,4,0,4
501219,1,5,12,6,0,6
501245,1,5,12,4,0,4
501257,1,5,12,9,0,9
501263,1,5,12,4,0,4
548314,1,5,12,6,1,7
548317,1,5,12,7,0,7
548325,1,5,12,11,0,11
548329,1,5,12,9,0,9
548337,1,5,12,5,0,5
548354,1,5,12,5,0,5
548359,1,5,12,14,0,14
548366,1,5,12,4,0,4
548370,1,5,12,5,0,5
548378,1,5,12,4,0,4
548382,1,5,12,2,0,2
598006,1,5,12,6,0,6
598010,1,5,12,2,0,2
598014,1,5,12,3,0,3
598024,1,5,12,10,3,13
598028,1,5,12,4,0,4
598031,1,5,12,5,0,5
598048,1,5,12,4,0,4
598077,1,5,12,14,0,14
729296,1,5,12,20,1,21
729320,1,5,12,4,0,4
733984,1,5,12,11,0,11
734008,1,5,12,7,0,7
734016,1,5,12,11,0,11
734046,1,5,12,12,0,12
829714,1,5,12,7,0,7
829746,1,5,12,5,0,5
829754,1,5,12,4,1,5
829782,1,5,12,8,0,8
829816,1,5,12,4,0,4
335992,2,5,12,2,1,3
335995,2,5,12,5,0,5
335997,2,5,12,4,0,4
336010,2,5,12,3,1,4
336016,2,5,12,13,2,15
336020,2,5,12,8,2,10
336024,2,5,12,20,0,20
336032,2,5,12,17,0,17
336041,2,5,12,1,4,5
336045,2,5,12,6,1,7
392187,2,5,12,0,0,0
392200,2,5,12,4,4,8
392203,2,5,12,3,0,3
392207,2,5,12,1,0,1
392210,2,5,12,17,0,17
392218,2,5,12,8,1,9
392225,2,5,12,6,0,6
392235,2,5,12,8,0,8
419112,2,5,12,25,1,26
419131,2,5,12,5,0,5
419139,2,5,12,11,1,12
419142,2,5,12,10,0,10
419148,2,5,12,13,3,16
419155,2,5,12,6,0,6
501204,2,5,12,10,0,10
501209,2,5,12,6,0,6
501225,2,5,12,12,0,12
501230,2,5,12,9,0,9
501236,2,5,12,5,0,5
501240,2,5,12,7,0,7
501254,2,5,12,7,0,7
501268,2,5,12,11,0,11
548322,2,5,12,10,0,10
548331,2,5,12,9,0,9
548341,2,5,12,6,2,8
548350,2,5,12,7,0,7
548363,2,5,12,6,0,6
598019,2,5,12,3,0,3
598037,2,5,12,8,0,8
598041,2,5,12,10,0,10
598052,2,5,12,5,0,5
598054,2,5,12,11,1,12
598057,2,5,12,10,0,10
598063,2,5,12,10,0,10
598068,2,5,12,12,1,13
598070,2,5,12,2,0,2
598076,2,5,12,8,0,8
729290,2,5,12,6,0,6
729302,2,5,12,3,0,3
729310,2,5,12,6,0,6
733980,2,5,12,10,0,10
733994,2,5,12,6,0,6
734004,2,5,12,9,0,9
734022,2,5,12,5,0,5
734038,2,5,12,7,0,7
829720,2,5,12,5,1,6
829726,2,5,12,7,0,7
829732,2,5,12,11,1,12
829740,2,5,12,16,0,16
829774,2,5,12,11,0,11
829792,2,5,12,15,1,16
829802,2,5,12,2,2,4
829824,2,5,12,8,0,8
336000,1,6,12,7,0,7
336003,1,6,12,11,0,11
336014,1,6,12,3,0,3
336020,1,6,12,5,1,6
336025,1,6,12,13,0,13
392194,1,6,12,9,0,9
392203,1,6,12,13,0,13
392228,1,6,12,4,0,4
392231,1,6,12,5,0,5
392235,1,6,12,5,0,5
392237,1,6,12,5,0,5
392242,1,6,12,1,0,1
419121,1,6,12,3,1,4
419133,1,6,12,3,0,3
419136,1,6,12,8,0,8
419139,1,6,12,5,0,5
419145,1,6,12,18,1,19
419154,1,6,12,2,0,2
501206,1,6,12,9,0,9
501209,1,6,12,8,0,8
501228,1,6,12,19,0,19
501232,1,6,12,10,1,11
501238,1,6,12,7,0,7
501243,1,6,12,8,0,8
548347,1,6,12,11,0,11
548350,1,6,12,7,0,7
548362,1,6,12,5,0,5
548369,1,6,12,4,0,4
598003,1,6,12,4,0,4
598015,1,6,12,7,0,7
598022,1,6,12,3,1,4
598040,1,6,12,9,1,10
598049,1,6,12,4,0,4
598054,1,6,12,8,0,8
598064,1,6,12,5,0,5
729286,1,6,12,5,0,5
733980,1,6,12,3,0,3
733986,1,6,12,6,2,8
733990,1,6,12,3,0,3
733998,1,6,12,7,0,7
734024,1,6,12,8,0,8
734044,1,6,12,4,0,4
829720,1,6,12,3,2,5
829736,1,6,12,3,0,3
829744,1,6,12,3,0,3
829752,1,6,12,19,1,20
829762,1,6,12,5,0,5
829788,1,6,12,3,0,3
829818,1,6,12,3,0,3
980908,1,6,12,7,5,12
980938,1,6,12,14,0,14
980956,1,6,12,14,1,15
980970,1,6,12,5,1,6
981002,1,6,12,3,0,3
981016,1,6,12,2,0,2
1082599,1,6,12,16,0,16
1082605,1,6,12,7,0,7
1082608,1,6,12,11,0,11
1082622,1,6,12,10,0,10
1082626,1,6,12,5,0,5
1082642,1,6,12,16,0,16
335989,2,6,12,5,0,5
335993,2,6,12,3,9,12
336006,2,6,12,5,0,5
336009,2,6,12,4,1,5
336022,2,6,12,6,0,6
336031,2,6,12,2,0,2
336037,2,6,12,8,0,8
336043,2,6,12,11,0,11
392199,2,6,12,8,0,8
392206,2,6,12,10,0,10
392211,2,6,12,7,0,7
392216,2,6,12,6,0,6
392220,2,6,12,4,0,4
392224,2,6,12,7,0,7
392240,2,6,12,9,1,10
419113,2,6,12,13,0,13
419116,2,6,12,7,0,7
419119,2,6,12,0,0,0
419125,2,6,12,6,0,6
419149,2,6,12,2,1,3
419157,2,6,12,4,0,4
419160,2,6,12,1,0,1
419165,2,6,12,4,0,4
501218,2,6,12,6,0,6
501221,2,6,12,2,0,2
501235,2,6,12,4,0,4
501248,2,6,12,15,0,15
501251,2,6,12,12,0,12
501258,2,6,12,9,1,10
501262,2,6,12,2,0,2
548312,2,6,12,4,0,4
548315,2,6,12,4,0,4
548321,2,6,12,11,0,11
548326,2,6,12,7,1,8
548330,2,6,12,7,0,7
548334,2,6,12,5,0,5
548338,2,6,12,10,0,10
548342,2,6,12,4,0,4
548354,2,6,12,7,1,8
548374,2,6,12,12,0,12
548377,2,6,12,10,1,11
548379,2,6,12,10,0,10
548383,2,6,12,6,1,7
548385,2,6,12,7,2,9
598006,2,6,12,8,0,8
598011,2,6,12,4,1,5
598025,2,6,12,5,0,5
598029,2,6,12,5,0,5
598033,2,6,12,5,0,5
598045,2,6,12,15,0,15
598059,2,6,12,8,1,9
598067,2,6,12,10,0,10
598072,2,6,12,10,1,11
729294,2,6,12,9,0,9
729298,2,6,12,11,0,11
729306,2,6,12,1,0,1
729314,2,6,12,11,0,11
734010,2,6,12,15,0,15
734016,2,6,12,9,0,9
734036,2,6,12,13,0,13
829712,2,6,12,7,0,7
829730,2,6,12,10,0,10
829766,2,6,12,14,0,14
829772,2,6,12,13,0,13
829782,2,6,12,15,0,15
829798,2,6,12,7,0,7
829806,2,6,12,8,0,8
980918,2,6,12,17,0,17
980926,2,6,12,5,0,5
980950,2,6,12,14,0,14
980966,2,6,12,9,0,9
980976,2,6,12,7,1,8
980988,2,6,12,8,0,8
980998,2,6,12,5,1,6
981008,2,6,12,8,0,8
1082595,2,6,12,9,0,9
1082611,2,6,12,5,0,5
1082614,2,6,12,2,0,2
1082630,2,6,12,8,0,8
1082632,2,6,12,16,0,16
1082635,2,6,12,5,1,6
1082640,2,6,12,11,1,12
1082646,2,6,12,3,0,3
335990,1,7,12,13,0,13
335999,1,7,12,3,2,5
336009,1,7,12,14,0,14
336029,1,7,12,5,3,8
336037,1,7,12,11,0,11
336041,1,7,12,4,0,4
392186,1,7,12,10,1,11
392202,1,7,12,5,0,5
392208,1,7,12,8,0,8
392213,1,7,12,6,0,6
392220,1,7,12,3,1,4
392223,1,7,12,6,0,6
392232,1,7,12,4,0,4
392240,1,7,12,15,0,15
419112,1,7,12,10,0,10
419119,1,7,12,2,1,3
419124,1,7,12,4,0,4
419135,1,7,12,6,1,7
419143,1,7,12,5,0,5
419151,1,7,12,7,0,7
419155,1,7,12,14,0,14
419157,1,7,12,10,0,10
419162,1,7,12,16,0,16
419166,1,7,12,3,0,3
419167,1,7,12,4,0,4
501215,1,7,12,2,0,2
501226,1,7,12,11,1,12
501229,1,7,12,4,0,4
501236,1,7,12,4,0,4
501242,1,7,12,15,0,15
501246,1,7,12,11,0,11
501251,1,7,12,14,0,14
501268,1,7,12,5,0,5
548322,1,7,12,9,0,9
548330,1,7,12,17,0,17
548339,1,7,12,19,0,19
548356,1,7,12,2,1,3
548365,1,7,12,4,0,4
548368,1,7,12,10,0,10
598007,1,7,12,4,0,4
598011,1,7,12,13,0,13
598016,1,7,12,11,0,11
598029,1,7,12,4,0,4
598038,1,7,12,4,0,4
598042,1,7,12,15,0,15
598044,1,7,12,5,0,5
598051,1,7,12,14,0,14
598055,1,7,12,7,0,7
598068,1,7,12,11,0,11
598078,1,7,12,9,0,9
729292,1,7,12,3,0,3
729308,1,7,12,4,0,4
729314,1,7,12,2,1,3
733988,1,7,12,7,0,7
734000,1,7,12,9,0,9
734014,1,7,12,6,0,6
734022,1,7,12,10,0,10
734036,1,7,12,8,0,8
734050,1,7,12,13,0,13
829710,1,7,12,3,0,3
829726,1,7,12,6,0,6
829734,1,7,12,13,0,13
829742,1,7,12,4,0,4
829756,1,7,12,9,0,9
829774,1,7,12,7,0,7
829780,1,7,12,8,0,8
829810,1,7,12,6,1,7
829822,1,7,12,10,0,10
829828,1,7,12,10,0,10
980906,1,7,12,6,0,6
980922,1,7,12,6,0,6
980928,1,7,12,6,0,6
980946,1,7,12,13,1,14
980990,1,7,12,6,0,6
980998,1,7,12,7,0,7
981012,1,7,12,14,2,16
1082592,1,7,12,3,0,3
1082614,1,7,12,8,0,8
1082635,1,7,12,11,1,12
1082638,1,7,12,5,0,5
1082644,1,7,12,8,0,8
1082650,1,7,12,1,0,1
335994,2,7,12,9,0,9
335996,2,7,12,22,0,22
336002,2,7,12,15,0,15
336013,2,7,12,1,0,1
336017,2,7,12,1,0,1
336023,2,7,12,5,0,5
336033,2,7,12,8,1,9
392197,2,7,12,4,0,4
392202,2,7,12,1,0,1
392205,2,7,12,3,0,3
392217,2,7,12,12,0,12
392227,2,7,12,7,0,7
392230,2,7,12,7,1,8
419119,2,7,12,5,5,10
419127,2,7,12,12,0,12
419130,2,7,12,5,0,5
419137,2,7,12,3,0,3
419147,2,7,12,8,1,9
419170,2,7,12,6,0,6
501206,2,7,12,14,1,15
501210,2,7,12,8,0,8
501223,2,7,12,9,1,10
501256,2,7,12,9,0,9
501261,2,7,12,3,0,3
501272,2,7,12,3,0,3
501274,2,7,12,6,0,6
501275,2,7,12,3,1,4
548311,2,7,12,3,0,3
548313,2,7,12,3,0,3
548319,2,7,12,3,0,3
548344,2,7,12,5,0,5
548347,2,7,12,15,0,15
548351,2,7,12,6,0,6
548360,2,7,12,9,1,10
548372,2,7,12,1,1,2
548375,2,7,12,3,0,3
548382,2,7,12,9,1,10
548384,2,7,12,7,0,7
598004,2,7,12,5,0,5
598024,2,7,12,8,0,8
598034,2,7,12,8,0,8
598060,2,7,12,8,0,8
598065,2,7,12,13,0,13
598071,2,7,12,2,0,2
598075,2,7,12,2,1,3
598077,2,7,12,14,2,16
729284,2,7,12,6,0,6
729322,2,7,12,4,0,4
733978,2,7,12,14,0,14
734006,2,7,12,13,0,13
734030,2,7,12,8,0,8
734046,2,7,12,18,0,18
829722,2,7,12,5,0,5
829752,2,7,12,5,0,5
829788,2,7,12,9,3,12
829794,2,7,12,1,0,1
829800,2,7,12,16,0,16
829820,2,7,12,22,0,22
980914,2,7,12,8,0,8
980932,2,7,12,8,0,8
980938,2,7,12,14,0,14
980952,2,7,12,11,0,11
980962,2,7,12,7,0,7
980978,2,7,12,4,0,4
980986,2,7,12,13,0,13
1082597,2,7,12,14,0,14
1082600,2,7,12,7,0,7
1082602,2,7,12,10,1,11
1082606,2,7,12,9,0,9
1082612,2,7,12,16,0,16
1082618,2,7,12,9,0,9
1082625,2,7,12,3,0,3
1082628,2,7,12,3,1,4
1082641,2,7,12,3,0,3
1082647,2,7,12,2,4,6
1082649,2,7,12,8,0,8
335991,1,8,12,2,0,2
335993,1,8,12,6,0,6
335995,1,8,12,9,0,9
336004,1,8,12,7,0,7
336007,1,8,12,7,0,7
336016,1,8,12,3,0,3
336036,1,8,12,9,0,9
336042,1,8,12,5,1,6
392193,1,8,12,4,2,6
392197,1,8,12,18,0,18
392206,1,8,12,15,1,16
392210,1,8,12,4,1,5
392217,1,8,12,11,0,11
392221,1,8,12,1,0,1
392225,1,8,12,3,1,4
392244,1,8,12,4,0,4
419115,1,8,12,11,0,11
419122,1,8,12,10,0,10
419125,1,8,12,12,0,12
419131,1,8,12,14,0,14
419156,1,8,12,14,0,14
419165,1,8,12,14,0,14
419169,1,8,12,3,1,4
501204,1,8,12,4,0,4
501213,1,8,12,9,0,9
501217,1,8,12,3,0,3
501221,1,8,12,3,0,3
501234,1,8,12,10,0,10
501248,1,8,12,6,2,8
501255,1,8,12,5,0,5
501261,1,8,12,9,0,9
501269,1,8,12,7,0,7
548319,1,8,12,14,1,15
548326,1,8,12,5,0,5
548331,1,8,12,9,0,9
548334,1,8,12,15,0,15
548340,1,8,12,7,1,8
548346,1,8,12,11,0,11
548351,1,8,12,5,0,5
548353,1,8,12,12,0,12
548361,1,8,12,10,0,10
548371,1,8,12,15,0,15
548381,1,8,12,2,0,2
335999,2,8,12,8,0,8
336012,2,8,12,6,0,6
336019,2,8,12,5,0,5
336025,2,8,12,19,0,19
336029,2,8,12,10,0,10
336039,2,8,12,15,0,15
392189,2,8,12,14,0,14
392201,2,8,12,8,0,8
392214,2,8,12,11,0,11
392228,2,8,12,12,0,12
392233,2,8,12,11,1,12
392234,2,8,12,3,0,3
392241,2,8,12,6,1,7
392242,2,8,12,5,0,5
419111,2,8,12,3,0,3
419135,2,8,12,6,0,6
419140,2,8,12,5,0,5
419143,2,8,12,7,0,7
419146,2,8,12,9,0,9
419150,2,8,12,7,1,8
419152,2,8,12,7,0,7
419161,2,8,12,12,0,12
419168,2,8,12,5,0,5
501208,2,8,12,10,1,11
501229,2,8,12,5,0,5
501241,2,8,12,11,0,11
501244,2,8,12,8,1,9
501264,2,8,12,4,0,4
548316,2,8,12,10,0,10
548357,2,8,12,5,1,6
548364,2,8,12,3,0,3
548378,2,8,12,7,2,9
501205,1,9,12,8,0,8
501212,1,9,12,9,0,9
501224,1,9,12,7,1,8
501230,1,9,12,5,0,5
501247,1,9,12,8,0,8
501252,1,9,12,5,1,6
501259,1,9,12,9,0,9
501215,2,9,12,13,0,13
501220,2,9,12,11,0,11
501234,2,9,12,5,0,5
501238,2,9,12,5,0,5
501243,2,9,12,10,0,10
501266,2,9,12,7,0,7
501218,1,10,12,6,0,6
501223,1,10,12,9,2,11
501233,1,10,12,8,0,8
501240,1,10,12,4,2,6
501264,1,10,12,5,0,5
501267,1,10,12,4,5,9
548313,1,10,12,12,0,12
548318,1,10,12,6,0,6
548324,1,10,12,6,0,6
548332,1,10,12,11,0,11
548338,1,10,12,12,1,13
548342,1,10,12,8,0,8
548363,1,10,12,6,1,7
598008,1,10,12,5,0,5
598020,1,10,12,4,1,5
598030,1,10,12,8,0,8
598052,1,10,12,5,0,5
598060,1,10,12,6,0,6
598066,1,10,12,5,0,5
598072,1,10,12,5,0,5
501207,2,10,12,13,0,13
501212,2,10,12,11,1,12
501231,2,10,12,7,0,7
501237,2,10,12,6,1,7
501246,2,10,12,11,0,11
501253,2,10,12,9,0,9
501255,2,10,12,6,0,6
548327,2,10,12,4,0,4
548335,2,10,12,13,0,13
548346,2,10,12,7,0,7
548353,2,10,12,11,0,11
548356,2,10,12,8,0,8
548358,2,10,12,5,0,5
548367,2,10,12,4,0,4
548370,2,10,12,8,0,8
548380,2,10,12,4,0,4
598005,2,10,12,7,0,7
598014,2,10,12,8,0,8
598016,2,10,12,6,0,6
598023,2,10,12,2,0,2
598032,2,10,12,8,0,8
598040,2,10,12,7,0,7
598043,2,10,12,2,0,2
598047,2,10,12,3,0,3
598058,2,10,12,5,0,5
598005,1,11,12,4,0,4
598023,1,11,12,13,0,13
598035,1,11,12,10,0,10
598037,1,11,12,3,1,4
598053,1,11,12,3,0,3
598061,1,11,12,7,0,7
598065,1,11,12,5,1,6
598070,1,11,12,6,4,10
598076,1,11,12,2,0,2
729290,1,11,12,4,0,4
729306,1,11,12,5,0,5
729316,1,11,12,6,0,6
729322,1,11,12,7,0,7
733982,1,11,12,6,0,6
733994,1,11,12,7,0,7
734006,1,11,12,7,0,7
734012,1,11,12,4,5,9
734020,1,11,12,12,0,12
734042,1,11,12,5,1,6
829732,1,11,12,8,0,8
829748,1,11,12,15,0,15
829764,1,11,12,3,0,3
829778,1,11,12,12,0,12
829792,1,11,12,4,1,5
829798,1,11,12,14,1,15
829804,1,11,12,9,0,9
829820,1,11,12,3,0,3
980920,1,11,12,8,0,8
980948,1,11,12,3,0,3
980958,1,11,12,11,0,11
980978,1,11,12,3,0,3
980984,1,11,12,3,0,3
980988,1,11,12,5,1,6
981008,1,11,12,13,0,13
981020,1,11,12,9,0,9
981024,1,11,12,12,1,13
1082591,1,11,12,8,0,8
1082600,1,11,12,9,0,9
1082609,1,11,12,9,0,9
1082611,1,11,12,7,0,7
1082615,1,11,12,13,0,13
1082623,1,11,12,6,1,7
1082627,1,11,12,7,0,7
1082630,1,11,12,3,0,3
1082648,1,11,12,2,2,4
598009,2,11,12,10,0,10
598015,2,11,12,9,0,9
598018,2,11,12,6,0,6
598026,2,11,12,4,0,4
598044,2,11,12,15,0,15
598049,2,11,12,4,1,5
598056,2,11,12,4,0,4
598074,2,11,12,6,0,6
729300,2,11,12,5,0,5
734026,2,11,12,14,0,14
734034,2,11,12,3,0,3
829716,2,11,12,5,0,5
829724,2,11,12,8,0,8
829736,2,11,12,7,0,7
829756,2,11,12,4,0,4
829786,2,11,12,3,0,3
980912,2,11,12,5,2,7
980928,2,11,12,13,0,13
980934,2,11,12,12,0,12
980940,2,11,12,3,0,3
980972,2,11,12,4,0,4
980996,2,11,12,10,1,11
981014,2,11,12,7,0,7
981022,2,11,12,7,0,7
1082596,2,11,12,7,1,8
1082604,2,11,12,10,0,10
1082634,2,11,12,7,0,7
1082638,2,11,12,4,0,4
1082643,2,11,12,16,0,16
980916,1,12,12,7,0,7
980924,1,12,12,5,0,5
980944,1,12,12,8,0,8
980954,1,12,12,11,0,11
980962,1,12,12,3,0,3
980974,1,12,12,13,0,13
980994,1,12,12,4,0,4
1082594,1,12,12,4,0,4
1082603,1,12,12,5,0,5
1082607,1,12,12,7,0,7
1082618,1,12,12,12,0,12
1082620,1,12,12,9,0,9
1082624,1,12,12,16,0,16
1082634,1,12,12,5,0,5
1082647,1,12,12,11,0,11
980906,2,12,12,11,0,11
980936,2,12,12,6,0,6
980970,2,12,12,6,1,7
980984,2,12,12,8,0,8
981010,2,12,12,9,1,10
1082592,2,12,12,8,0,8
1082599,2,12,12,3,0,3
1082615,2,12,12,4,0,4
1082629,2,12,12,8,0,8
1082631,2,12,12,9,0,9
1082642,2,12,12,8,0,8
1082645,2,12,12,11,0,11
1082650,2,12,12,6,0,6
980934,1,13,12,6,0,6
980950,1,13,12,2,0,2
980966,1,13,12,6,0,6
980972,1,13,12,9,0,9
981018,1,13,12,8,0,8
981022,1,13,12,4,0,4
1082593,1,13,12,7,0,7
1082596,1,13,12,7,0,7
1082606,1,13,12,2,0,2
1082625,1,13,12,0,1,1
1082629,1,13,12,8,0,8
1082632,1,13,12,18,0,18
1082640,1,13,12,4,1,5
1082643,1,13,12,7,0,7
980910,2,13,12,10,0,10
980916,2,13,12,13,0,13
980922,2,13,12,2,1,3
980942,2,13,12,10,1,11
980954,2,13,12,5,0,5
980960,2,13,12,3,0,3
980980,2,13,12,10,0,10
980992,2,13,12,2,0,2
981006,2,13,12,6,0,6
981012,2,13,12,10,0,10
1082603,2,13,12,5,0,5
1082610,2,13,12,1,0,1
1082613,2,13,12,9,0,9
1082616,2,13,12,5,0,5
1082621,2,13,12,11,0,11
1082637,2,13,12,9,0,9
335987,1,1,13,11,1,12
335998,1,1,13,8,0,8
336002,1,1,13,3,0,3
336015,1,1,13,6,0,6
336019,1,1,13,6,0,6
336022,1,1,13,6,1,7
336026,1,1,13,2,1,3
336030,1,1,13,4,0,4
336032,1,1,13,10,0,10
392189,1,1,13,5,0,5
392204,1,1,13,6,0,6
392212,1,1,13,4,0,4
392216,1,1,13,14,1,15
392224,1,1,13,4,0,4
392226,1,1,13,9,0,9
392233,1,1,13,4,0,4
419111,1,1,13,6,1,7
419127,1,1,13,6,0,6
419132,1,1,13,10,0,10
419140,1,1,13,13,0,13
419144,1,1,13,26,7,33
419149,1,1,13,6,0,6
419153,1,1,13,2,0,2
419158,1,1,13,13,0,13
501208,1,1,13,8,0,8
501227,1,1,13,8,0,8
501235,1,1,13,8,0,8
501244,1,1,13,3,0,3
501260,1,1,13,2,4,6
501272,1,1,13,4,0,4
501274,1,1,13,8,0,8
548320,1,1,13,8,0,8
548349,1,1,13,9,0,9
548358,1,1,13,3,0,3
548373,1,1,13,2,0,2
548375,1,1,13,9,0,9
548380,1,1,13,16,4,20
548383,1,1,13,7,0,7
598013,1,1,13,8,0,8
598018,1,1,13,8,0,8
598027,1,1,13,9,0,9
598034,1,1,13,9,0,9
598045,1,1,13,4,1,5
598058,1,1,13,6,4,10
598074,1,1,13,8,0,8
729284,1,1,13,8,0,8
729294,1,1,13,11,0,11
729304,1,1,13,5,0,5
734032,1,1,13,6,0,6
734048,1,1,13,5,1,6
829718,1,1,13,12,2,14
829766,1,1,13,6,2,8
829786,1,1,13,15,0,15
980914,1,1,13,10,0,10
980952,1,1,13,15,0,15
980968,1,1,13,11,0,11
980980,1,1,13,9,0,9
981000,1,1,13,5,2,7
981006,1,1,13,3,0,3
981014,1,1,13,13,1,14
1082597,1,1,13,9,0,9
1082604,1,1,13,14,0,14
1082613,1,1,13,6,0,6
1082617,1,1,13,4,0,4
1082631,1,1,13,6,0,6
1082649,1,1,13,10,0,10
335991,2,1,13,2,2,4
336005,2,1,13,7,0,7
336008,2,1,13,17,0,17
336040,2,1,13,2,0,2
392195,2,1,13,10,0,10
392202,2,1,13,0,0,0
392208,2,1,13,5,1,6
392236,2,1,13,11,0,11
392238,2,1,13,10,0,10
419114,2,1,13,4,3,7
419118,2,1,13,3,1,4
419123,2,1,13,8,0,8
419136,2,1,13,9,0,9
419163,2,1,13,15,1,16
419166,2,1,13,7,6,13
501203,2,1,13,4,0,4
501214,2,1,13,6,0,6
501219,2,1,13,7,0,7
501224,2,1,13,2,0,2
501239,2,1,13,6,0,6
501247,2,1,13,4,0,4
501267,2,1,13,6,0,6
548317,2,1,13,0,0,0
548325,2,1,13,5,0,5
548328,2,1,13,1,0,1
548333,2,1,13,8,0,8
548340,2,1,13,3,0,3
548352,2,1,13,2,2,4
548362,2,1,13,11,2,13
548368,2,1,13,12,1,13
548386,2,1,13,8,0,8
598003,2,1,13,6,0,6
598010,2,1,13,15,0,15
598021,2,1,13,9,0,9
598036,2,1,13,14,0,14
598039,2,1,13,8,0,8
598048,2,1,13,2,0,2
598055,2,1,13,2,0,2
598062,2,1,13,6,0,6
598066,2,1,13,9,0,9
729312,2,1,13,5,0,5
729320,2,1,13,11,1,12
733976,2,1,13,10,0,10
733984,2,1,13,15,1,16
733990,2,1,13,9,0,9
734002,2,1,13,8,0,8
734014,2,1,13,3,0,3
734020,2,1,13,7,0,7
734028,2,1,13,2,0,2
734042,2,1,13,26,0,26
734054,2,1,13,18,0,18
829710,2,1,13,9,0,9
829728,2,1,13,5,0,5
829738,2,1,13,19,0,19
829744,2,1,13,6,0,6
829770,2,1,13,3,1,4
829796,2,1,13,16,0,16
829810,2,1,13,10,0,10
829816,2,1,13,13,2,15
980908,2,1,13,2,0,2
980920,2,1,13,2,0,2
980930,2,1,13,3,0,3
980944,2,1,13,8,0,8
980956,2,1,13,3,0,3
980964,2,1,13,9,0,9
981020,2,1,13,11,0,11
1082593,2,1,13,6,0,6
1082601,2,1,13,8,0,8
1082608,2,1,13,11,0,11
1082620,2,1,13,6,6,12
1082622,2,1,13,12,0,12
1082627,2,1,13,3,0,3
1082636,2,1,13,11,0,11
1082639,2,1,13,11,0,11
1082644,2,1,13,11,0,11
335997,1,2,13,10,0,10
336011,1,2,13,3,0,3
336017,1,2,13,7,0,7
336021,1,2,13,10,0,10
336031,1,2,13,6,1,7
336034,1,2,13,6,0,6
336039,1,2,13,10,0,10
392187,1,2,13,7,0,7
392196,1,2,13,4,0,4
392199,1,2,13,5,0,5
392209,1,2,13,4,0,4
392218,1,2,13,3,0,3
392241,1,2,13,5,0,5
419114,1,2,13,5,0,5
419128,1,2,13,8,0,8
419138,1,2,13,10,0,10
419150,1,2,13,10,0,10
501210,1,2,13,7,0,7
501237,1,2,13,6,0,6
501249,1,2,13,9,0,9
501273,1,2,13,8,0,8
501275,1,2,13,10,1,11
548315,1,2,13,6,0,6
548323,1,2,13,4,0,4
548341,1,2,13,14,0,14
548355,1,2,13,18,1,19
548367,1,2,13,2,0,2
548372,1,2,13,2,0,2
548377,1,2,13,12,0,12
598004,1,2,13,7,0,7
598009,1,2,13,12,0,12
598017,1,2,13,12,0,12
598032,1,2,13,10,0,10
598041,1,2,13,0,0,0
598047,1,2,13,3,0,3
598050,1,2,13,8,2,10
598059,1,2,13,6,0,6
598062,1,2,13,7,0,7
598069,1,2,13,7,0,7
729310,1,2,13,4,0,4
729318,1,2,13,12,1,13
734004,1,2,13,13,1,14
734010,1,2,13,3,0,3
734026,1,2,13,4,3,7
734040,1,2,13,10,0,10
829724,1,2,13,4,0,4
829768,1,2,13,5,2,7
829790,1,2,13,16,2,18
829800,1,2,13,7,0,7
829824,1,2,13,6,0,6
829826,1,2,13,1,1,2
980912,1,2,13,14,1,15
980926,1,2,13,5,0,5
980932,1,2,13,2,0,2
980936,1,2,13,5,0,5
980942,1,2,13,7,0,7
980964,1,2,13,9,0,9
980982,1,2,13,10,0,10
980986,1,2,13,3,0,3
980992,1,2,13,12,0,12
981004,1,2,13,15,0,15
1082595,1,2,13,24,0,24
1082598,1,2,13,3,0,3
1082602,1,2,13,5,4,9
1082610,1,2,13,6,0,6
1082621,1,2,13,7,4,11
1082628,1,2,13,10,0,10
1082636,1,2,13,6,0,6
1082646,1,2,13,6,0,6
335987,2,2,13,9,2,11
335990,2,2,13,10,0,10
336001,2,2,13,8,0,8
336003,2,2,13,7,4,11
336007,2,2,13,5,0,5
336015,2,2,13,14,1,15
336028,2,2,13,17,2,19
392190,2,2,13,7,0,7
392193,2,2,13,6,0,6
392204,2,2,13,3,0,3
392213,2,2,13,5,0,5
392223,2,2,13,11,0,11
392226,2,2,13,14,0,14
392229,2,2,13,10,0,10
392237,2,2,13,5,1,6
392243,2,2,13,4,0,4
392244,2,2,13,11,1,12
419117,2,2,13,25,0,25
419124,2,2,13,10,0,10
419133,2,2,13,9,1,10
419141,2,2,13,8,0,8
419145,2,2,13,8,0,8
419153,2,2,13,16,0,16
419156,2,2,13,11,0,11
419159,2,2,13,2,0,2
419162,2,2,13,5,0,5
419167,2,2,13,4,2,6
419169,2,2,13,7,0,7
501205,2,2,13,9,0,9
501213,2,2,13,9,1,10
501216,2,2,13,9,1,10
501227,2,2,13,7,1,8
501232,2,2,13,3,0,3
501252,2,2,13,6,0,6
501257,2,2,13,11,0,11
501260,2,2,13,4,2,6
501265,2,2,13,5,0,5
501271,2,2,13,7,0,7
501276,2,2,13,3,1,4
548320,2,2,13,6,1,7
548329,2,2,13,10,0,10
548332,2,2,13,31,0,31
548336,2,2,13,12,0,12
548349,2,2,13,15,0,15
548361,2,2,13,5,0,5
548365,2,2,13,14,1,15
548381,2,2,13,4,0,4
598013,2,2,13,6,0,6
598022,2,2,13,3,0,3
598028,2,2,13,3,0,3
598038,2,2,13,3,0,3
598053,2,2,13,5,0,5
729286,2,2,13,3,0,3
729292,2,2,13,10,0,10
729304,2,2,13,10,0,10
733982,2,2,13,6,0,6
733988,2,2,13,2,0,2
733996,2,2,13,3,0,3
734018,2,2,13,4,1,5
734032,2,2,13,3,0,3
829718,2,2,13,10,0,10
829742,2,2,13,22,2,24
829750,2,2,13,3,0,3
829754,2,2,13,5,0,5
829784,2,2,13,7,0,7
980958,2,2,13,11,0,11
980974,2,2,13,5,1,6
981000,2,2,13,10,1,11
981016,2,2,13,8,0,8
981018,2,2,13,3,0,3
981024,2,2,13,12,0,12
1082591,2,2,13,8,0,8
1082607,2,2,13,5,0,5
1082624,2,2,13,1,0,1
1082633,2,2,13,7,2,9
335988,1,3,13,4,2,6
335994,1,3,13,11,0,11
336001,1,3,13,3,0,3
336006,1,3,13,8,0,8
336010,1,3,13,8,0,8
336012,1,3,13,4,0,4
336018,1,3,13,14,1,15
336023,1,3,13,6,1,7
336045,1,3,13,10,0,10
392190,1,3,13,5,0,5
392201,1,3,13,3,0,3
392207,1,3,13,3,0,3
392211,1,3,13,7,0,7
392214,1,3,13,6,0,6
392219,1,3,13,5,0,5
392229,1,3,13,8,0,8
392236,1,3,13,12,1,13
392239,1,3,13,6,0,6
392243,1,3,13,12,0,12
419118,1,3,13,9,0,9
419130,1,3,13,10,1,11
419142,1,3,13,16,0,16
419147,1,3,13,5,1,6
419152,1,3,13,5,2,7
419160,1,3,13,3,0,3
419168,1,3,13,5,1,6
419170,1,3,13,12,0,12
501203,1,3,13,5,0,5
501211,1,3,13,10,0,10
501216,1,3,13,3,0,3
501220,1,3,13,7,0,7
501231,1,3,13,11,0,11
501241,1,3,13,6,0,6
501250,1,3,13,4,0,4
501254,1,3,13,15,0,15
501258,1,3,13,10,0,10
501266,1,3,13,4,0,4
501271,1,3,13,8,4,12
501276,1,3,13,10,0,10
548311,1,3,13,2,0,2
548316,1,3,13,4,0,4
548321,1,3,13,1,0,1
548327,1,3,13,12,0,12
548335,1,3,13,6,0,6
548352,1,3,13,4,0,4
548357,1,3,13,7,1,8
548360,1,3,13,14,0,14
548376,1,3,13,2,0,2
548384,1,3,13,11,1,12
548385,1,3,13,12,0,12
548386,1,3,13,5,2,7
598025,1,3,13,11,0,11
598039,1,3,13,13,0,13
598043,1,3,13,13,0,13
598046,1,3,13,8,0,8
598056,1,3,13,5,0,5
598063,1,3,13,3,0,3
598067,1,3,13,4,0,4
598075,1,3,13,13,0,13
729288,1,3,13,12,0,12
729298,1,3,13,4,0,4
729302,1,3,13,4,0,4
733976,1,3,13,6,0,6
734018,1,3,13,15,0,15
734028,1,3,13,9,0,9
734034,1,3,13,3,0,3
829712,1,3,13,9,0,9
829716,1,3,13,14,0,14
829728,1,3,13,3,0,3
829740,1,3,13,4,0,4
829750,1,3,13,19,0,19
829758,1,3,13,10,0,10
829770,1,3,13,3,0,3
829784,1,3,13,10,0,10
829794,1,3,13,4,0,4
829802,1,3,13,9,0,9
829806,1,3,13,5,0,5
335998,2,3,13,4,1,5
336014,2,3,13,7,1,8
336034,2,3,13,14,1,15
336038,2,3,13,12,0,12
336042,2,3,13,8,0,8
336044,2,3,13,10,0,10
392186,2,3,13,8,0,8
392194,2,3,13,7,1,8
392207,2,3,13,4,0,4
392222,2,3,13,2,1,3
392232,2,3,13,9,5,14
419115,2,3,13,7,0,7
419121,2,3,13,7,3,10
419126,2,3,13,2,1,3
419128,2,3,13,7,0,7
419134,2,3,13,7,0,7
419138,2,3,13,4,0,4
419158,2,3,13,9,1,10
419164,2,3,13,7,0,7
501226,2,3,13,1,0,1
501233,2,3,13,9,0,9
501245,2,3,13,12,0,12
501273,2,3,13,21,2,23
548323,2,3,13,15,0,15
548337,2,3,13,5,0,5
548348,2,3,13,3,2,5
548366,2,3,13,1,0,1
548369,2,3,13,6,0,6
548373,2,3,13,4,0,4
598007,2,3,13,4,0,4
598012,2,3,13,14,0,14
598017,2,3,13,3,1,4
598020,2,3,13,8,0,8
598027,2,3,13,4,0,4
598031,2,3,13,5,0,5
598035,2,3,13,12,0,12
598051,2,3,13,1,0,1
598078,2,3,13,8,0,8
729308,2,3,13,10,0,10
729316,2,3,13,8,0,8
733986,2,3,13,9,2,11
733992,2,3,13,5,0,5
734000,2,3,13,7,0,7
734008,2,3,13,8,0,8
734040,2,3,13,4,0,4
734050,2,3,13,6,0,6
734052,2,3,13,3,0,3
829734,2,3,13,3,0,3
829778,2,3,13,5,0,5
829814,2,3,13,5,0,5
829822,2,3,13,4,0,4
829826,2,3,13,10,0,10
829828,2,3,13,9,0,9
335992,1,4,13,4,0,4
335996,1,4,13,6,0,6
336008,1,4,13,1,1,2
336024,1,4,13,7,0,7
336033,1,4,13,13,0,13
336040,1,4,13,4,0,4
336044,1,4,13,5,0,5
392191,1,4,13,6,0,6
392200,1,4,13,5,0,5
392205,1,4,13,10,5,15
392227,1,4,13,3,0,3
392234,1,4,13,5,1,6
419113,1,4,13,12,0,12
419117,1,4,13,13,2,15
419126,1,4,13,8,1,9
419137,1,4,13,6,0,6
419141,1,4,13,9,0,9
419148,1,4,13,2,1,3
419161,1,4,13,1,0,1
419164,1,4,13,14,0,14
501207,1,4,13,5,0,5
501225,1,4,13,8,0,8
501239,1,4,13,6,0,6
501253,1,4,13,3,0,3
501256,1,4,13,8,0,8
501262,1,4,13,25,0,25
501265,1,4,13,7,0,7
548328,1,4,13,1,1,2
548333,1,4,13,8,0,8
548336,1,4,13,7,1,8
548344,1,4,13,4,1,5
548348,1,4,13,8,0,8
548364,1,4,13,11,0,11
548374,1,4,13,9,0,9
548379,1,4,13,10,0,10
598012,1,4,13,9,0,9
598019,1,4,13,3,0,3
598021,1,4,13,8,0,8
598026,1,4,13,3,0,3
598033,1,4,13,2,0,2
598036,1,4,13,13,0,13
598057,1,4,13,7,0,7
598071,1,4,13,18,0,18
729300,1,4,13,25,0,25
729312,1,4,13,5,0,5
733978,1,4,13,8,0,8
733992,1,4,13,21,0,21
733996,1,4,13,14,1,15
734002,1,4,13,6,0,6
734030,1,4,13,4,0,4
734038,1,4,13,10,0,10
734052,1,4,13,15,2,17
734054,1,4,13,9,1,10
829722,1,4,13,6,0,6
829730,1,4,13,8,0,8
829738,1,4,13,4,0,4
829772,1,4,13,3,1,4
829796,1,4,13,9,2,11
829814,1,4,13,3,0,3
980910,1,4,13,5,0,5
980918,1,4,13,2,0,2
980930,1,4,13,4,2,6
980940,1,4,13,10,2,12
980960,1,4,13,6,0,6
980976,1,4,13,8,0,8
980996,1,4,13,7,2,9
981010,1,4,13,14,0,14
1082601,1,4,13,6,0,6
1082612,1,4,13,7,2,9
1082616,1,4,13,10,0,10
1082633,1,4,13,6,1,7
1082637,1,4,13,10,0,10
1082639,1,4,13,10,1,11
1082641,1,4,13,6,0,6
1082645,1,4,13,5,0,5
335988,2,4,13,12,2,14
336000,2,4,13,11,0,11
336004,2,4,13,7,0,7
336011,2,4,13,6,0,6
336018,2,4,13,2,0,2
336021,2,4,13,9,0,9
336036,2,4,13,4,0,4
392196,2,4,13,3,0,3
392209,2,4,13,4,0,4
392212,2,4,13,5,3,8
392215,2,4,13,8,0,8
392219,2,4,13,10,0,10
392221,2,4,13,10,0,10
392231,2,4,13,7,0,7
392239,2,4,13,2,0,2
419122,2,4,13,2,1,3
419129,2,4,13,3,0,3
419132,2,4,13,7,0,7
419144,2,4,13,8,0,8
419151,2,4,13,9,0,9
419154,2,4,13,3,0,3
501211,2,4,13,12,0,12
501217,2,4,13,16,0,16
501228,2,4,13,10,0,10
501242,2,4,13,3,1,4
501249,2,4,13,4,0,4
501259,2,4,13,16,0,16
501269,2,4,13,4,0,4
548314,2,4,13,12,0,12
548318,2,4,13,3,0,3
548324,2,4,13,4,0,4
548339,2,4,13,10,0,10
548355,2,4,13,17,0,17
548359,2,4,13,2,2,4
548371,2,4,13,3,0,3
548376,2,4,13,5,0,5
598008,2,4,13,0,1,1
598030,2,4,13,8,1,9
598042,2,4,13,15,0,15
598046,2,4,13,11,0,11
598050,2,4,13,12,0,12
598061,2,4,13,5,4,9
598064,2,4,13,4,0,4
598069,2,4,13,5,0,5
729288,2,4,13,21,1,22
729296,2,4,13,18,0,18
729318,2,4,13,4,0,4
734012,2,4,13,3,0,3
734024,2,4,13,7,0,7
734044,2,4,13,10,0,10
734048,2,4,13,6,0,6
829714,2,4,13,11,0,11
829746,2,4,13,13,0,13
829758,2,4,13,4,0,4
829764,2,4,13,4,0,4
829780,2,4,13,7,0,7
829790,2,4,13,4,0,4
829804,2,4,13,4,0,4
980924,2,4,13,4,0,4
980946,2,4,13,6,1,7
980968,2,4,13,5,0,5
980982,2,4,13,11,0,11
980990,2,4,13,13,1,14
981004,2,4,13,4,0,4
1082594,2,4,13,14,1,15
1082598,2,4,13,7,1,8
1082605,2,4,13,4,0,4
1082609,2,4,13,13,0,13
1082623,2,4,13,19,0,19
335989,1,5,13,7,2,9
336005,1,5,13,7,1,8
336013,1,5,13,8,1,9
336028,1,5,13,5,0,5
336038,1,5,13,3,0,3
336043,1,5,13,7,0,7
392195,1,5,13,7,1,8
392215,1,5,13,6,0,6
392222,1,5,13,1,0,1
392230,1,5,13,9,0,9
392238,1,5,13,6,0,6
419116,1,5,13,6,0,6
419120,1,5,13,5,1,6
419123,1,5,13,2,0,2
419129,1,5,13,9,2,11
419134,1,5,13,7,0,7
419146,1,5,13,6,0,6
419159,1,5,13,2,4,6
419163,1,5,13,12,0,12
501214,1,5,13,4,0,4
501219,1,5,13,5,0,5
501245,1,5,13,3,0,3
501257,1,5,13,8,0,8
501263,1,5,13,1,0,1
548314,1,5,13,7,0,7
548317,1,5,13,7,0,7
548325,1,5,13,4,0,4
548329,1,5,13,7,0,7
548337,1,5,13,4,1,5
548354,1,5,13,3,0,3
548359,1,5,13,5,1,6
548366,1,5,13,4,0,4
548370,1,5,13,15,0,15
548378,1,5,13,6,1,7
548382,1,5,13,6,0,6
598006,1,5,13,12,0,12
598010,1,5,13,10,0,10
598014,1,5,13,4,1,5
598024,1,5,13,4,1,5
598028,1,5,13,7,0,7
598031,1,5,13,9,0,9
598048,1,5,13,11,0,11
598077,1,5,13,5,1,6
729296,1,5,13,9,0,9
729320,1,5,13,5,0,5
733984,1,5,13,9,0,9
734008,1,5,13,9,0,9
734016,1,5,13,6,1,7
734046,1,5,13,16,0,16
829714,1,5,13,4,1,5
829746,1,5,13,15,0,15
829754,1,5,13,2,0,2
829782,1,5,13,9,0,9
829816,1,5,13,7,0,7
335992,2,5,13,12,0,12
335995,2,5,13,8,0,8
335997,2,5,13,8,0,8
336010,2,5,13,12,0,12
336016,2,5,13,9,1,10
336020,2,5,13,3,1,4
336024,2,5,13,11,0,11
336032,2,5,13,8,0,8
336041,2,5,13,3,0,3
336045,2,5,13,15,0,15
392187,2,5,13,5,0,5
392200,2,5,13,4,0,4
392203,2,5,13,19,0,19
392207,2,5,13,3,0,3
392210,2,5,13,4,0,4
392218,2,5,13,8,1,9
392225,2,5,13,4,0,4
392235,2,5,13,2,0,2
419112,2,5,13,15,2,17
419131,2,5,13,16,0,16
419139,2,5,13,8,0,8
419142,2,5,13,18,1,19
419148,2,5,13,8,0,8
419155,2,5,13,5,0,5
501204,2,5,13,6,0,6
501209,2,5,13,11,0,11
501225,2,5,13,13,0,13
501230,2,5,13,16,0,16
501236,2,5,13,4,0,4
501240,2,5,13,13,0,13
501254,2,5,13,10,1,11
501268,2,5,13,10,0,10
548322,2,5,13,16,0,16
548331,2,5,13,8,1,9
548341,2,5,13,2,1,3
548350,2,5,13,9,0,9
548363,2,5,13,8,0,8
598019,2,5,13,3,0,3
598037,2,5,13,4,0,4
598041,2,5,13,9,1,10
598052,2,5,13,7,0,7
598054,2,5,13,8,0,8
598057,2,5,13,3,0,3
598063,2,5,13,10,0,10
598068,2,5,13,6,4,10
598070,2,5,13,6,2,8
598076,2,5,13,3,0,3
729290,2,5,13,6,0,6
729302,2,5,13,9,0,9
729310,2,5,13,10,0,10
733980,2,5,13,15,0,15
733994,2,5,13,3,0,3
734004,2,5,13,8,0,8
734022,2,5,13,5,0,5
734038,2,5,13,4,2,6
829720,2,5,13,18,1,19
829726,2,5,13,7,0,7
829732,2,5,13,3,0,3
829740,2,5,13,5,0,5
829774,2,5,13,6,0,6
829792,2,5,13,14,0,14
829802,2,5,13,9,1,10
829824,2,5,13,4,0,4
336000,1,6,13,6,0,6
336003,1,6,13,6,0,6
336014,1,6,13,3,3,6
336020,1,6,13,8,0,8
336025,1,6,13,13,0,13
392194,1,6,13,4,0,4
392203,1,6,13,11,1,12
392228,1,6,13,4,0,4
392231,1,6,13,4,0,4
392235,1,6,13,7,0,7
392237,1,6,13,4,0,4
392242,1,6,13,8,0,8
419121,1,6,13,10,0,10
419133,1,6,13,8,1,9
419136,1,6,13,5,0,5
419139,1,6,13,9,0,9
419145,1,6,13,4,0,4
419154,1,6,13,5,0,5
501206,1,6,13,4,1,5
501209,1,6,13,8,0,8
501228,1,6,13,3,1,4
501232,1,6,13,12,0,12
501238,1,6,13,15,0,15
501243,1,6,13,9,0,9
548347,1,6,13,10,3,13
548350,1,6,13,4,0,4
548362,1,6,13,6,0,6
548369,1,6,13,11,0,11
598003,1,6,13,8,0,8
598015,1,6,13,5,1,6
598022,1,6,13,8,0,8
598040,1,6,13,12,0,12
598049,1,6,13,5,0,5
598054,1,6,13,6,0,6
598064,1,6,13,7,0,7
729286,1,6,13,10,1,11
733980,1,6,13,6,0,6
733986,1,6,13,12,0,12
733990,1,6,13,8,1,9
733998,1,6,13,8,3,11
734024,1,6,13,7,0,7
734044,1,6,13,6,0,6
829720,1,6,13,8,0,8
829736,1,6,13,7,1,8
829744,1,6,13,6,0,6
829752,1,6,13,11,0,11
829762,1,6,13,0,0,0
829788,1,6,13,8,0,8
829818,1,6,13,6,0,6
980908,1,6,13,4,0,4
980938,1,6,13,8,0,8
980956,1,6,13,7,0,7
980970,1,6,13,17,1,18
981002,1,6,13,5,0,5
981016,1,6,13,5,2,7
1082599,1,6,13,4,0,4
1082605,1,6,13,6,0,6
1082608,1,6,13,6,0,6
1082622,1,6,13,15,0,15
1082626,1,6,13,6,1,7
1082642,1,6,13,4,0,4
335989,2,6,13,6,5,11
335993,2,6,13,30,0,30
336006,2,6,13,5,0,5
336009,2,6,13,11,0,11
336022,2,6,13,7,0,7
336031,2,6,13,3,1,4
336037,2,6,13,13,0,13
336043,2,6,13,2,0,2
392199,2,6,13,7,0,7
392206,2,6,13,8,0,8
392211,2,6,13,14,0,14
392216,2,6,13,6,0,6
392220,2,6,13,2,0,2
392224,2,6,13,2,2,4
392240,2,6,13,14,0,14
419113,2,6,13,6,1,7
419116,2,6,13,2,0,2
419119,2,6,13,1,0,1
419125,2,6,13,3,0,3
419149,2,6,13,14,0,14
419157,2,6,13,3,0,3
419160,2,6,13,7,5,12
419165,2,6,13,3,0,3
501218,2,6,13,1,0,1
501221,2,6,13,6,2,8
501235,2,6,13,7,2,9
501248,2,6,13,11,1,12
501251,2,6,13,15,0,15
501258,2,6,13,9,0,9
501262,2,6,13,14,1,15
548315,2,6,13,4,0,4
548321,2,6,13,10,0,10
548326,2,6,13,21,0,21
548330,2,6,13,6,0,6
548334,2,6,13,9,0,9
548338,2,6,13,6,0,6
548342,2,6,13,8,1,9
548354,2,6,13,11,1,12
548374,2,6,13,6,0,6
548377,2,6,13,13,0,13
548379,2,6,13,7,0,7
548383,2,6,13,5,0,5
548385,2,6,13,3,1,4
598006,2,6,13,10,0,10
598011,2,6,13,5,6,11
598025,2,6,13,4,0,4
598029,2,6,13,12,0,12
598033,2,6,13,6,0,6
598045,2,6,13,7,0,7
598059,2,6,13,3,1,4
598067,2,6,13,7,0,7
598072,2,6,13,9,0,9
729294,2,6,13,7,0,7
729298,2,6,13,2,0,2
729306,2,6,13,11,0,11
729314,2,6,13,3,0,3
734010,2,6,13,5,0,5
734016,2,6,13,9,0,9
734036,2,6,13,7,2,9
829712,2,6,13,4,1,5
829730,2,6,13,8,0,8
829766,2,6,13,10,0,10
829772,2,6,13,11,0,11
829782,2,6,13,14,0,14
829798,2,6,13,9,0,9
829806,2,6,13,10,0,10
980918,2,6,13,6,0,6
980926,2,6,13,10,1,11
980950,2,6,13,16,0,16
980966,2,6,13,9,0,9
980976,2,6,13,5,1,6
980988,2,6,13,3,0,3
980998,2,6,13,6,0,6
981008,2,6,13,9,0,9
1082595,2,6,13,12,1,13
1082611,2,6,13,10,0,10
1082614,2,6,13,8,1,9
1082630,2,6,13,16,0,16
1082632,2,6,13,11,1,12
1082635,2,6,13,2,0,2
1082640,2,6,13,9,0,9
1082646,2,6,13,3,0,3
335990,1,7,13,3,0,3
335999,1,7,13,8,0,8
336009,1,7,13,9,1,10
336029,1,7,13,4,2,6
336037,1,7,13,2,0,2
336041,1,7,13,7,1,8
392186,1,7,13,9,0,9
392202,1,7,13,8,0,8
392208,1,7,13,3,0,3
392213,1,7,13,10,0,10
392220,1,7,13,6,1,7
392223,1,7,13,3,0,3
392232,1,7,13,5,0,5
392240,1,7,13,6,5,11
419112,1,7,13,8,0,8
419119,1,7,13,11,0,11
419124,1,7,13,9,0,9
419135,1,7,13,1,0,1
419143,1,7,13,6,0,6
419151,1,7,13,5,0,5
419155,1,7,13,4,1,5
419157,1,7,13,11,0,11
419162,1,7,13,9,0,9
419166,1,7,13,3,0,3
419167,1,7,13,5,0,5
501215,1,7,13,7,1,8
501226,1,7,13,4,1,5
501229,1,7,13,9,0,9
501236,1,7,13,2,4,6
501242,1,7,13,5,0,5
501246,1,7,13,7,0,7
501251,1,7,13,10,1,11
501268,1,7,13,3,1,4
548322,1,7,13,8,1,9
548330,1,7,13,6,1,7
548339,1,7,13,12,0,12
548356,1,7,13,6,0,6
548365,1,7,13,13,0,13
548368,1,7,13,7,0,7
598007,1,7,13,7,0,7
598011,1,7,13,13,0,13
598016,1,7,13,2,0,2
598029,1,7,13,12,1,13
598038,1,7,13,9,0,9
598042,1,7,13,13,0,13
598044,1,7,13,6,0,6
598051,1,7,13,9,0,9
598055,1,7,13,9,0,9
598068,1,7,13,5,0,5
598078,1,7,13,9,1,10
729292,1,7,13,5,1,6
729308,1,7,13,15,0,15
729314,1,7,13,5,0,5
733988,1,7,13,6,0,6
734000,1,7,13,8,0,8
734014,1,7,13,6,0,6
734022,1,7,13,11,0,11
734036,1,7,13,10,0,10
734050,1,7,13,9,0,9
829710,1,7,13,7,0,7
829726,1,7,13,9,0,9
829734,1,7,13,14,0,14
829742,1,7,13,10,3,13
829756,1,7,13,12,0,12
829774,1,7,13,4,0,4
829780,1,7,13,5,0,5
829810,1,7,13,6,0,6
829822,1,7,13,9,0,9
829828,1,7,13,5,0,5
980906,1,7,13,5,0,5
980922,1,7,13,9,0,9
980928,1,7,13,4,1,5
980946,1,7,13,12,1,13
980990,1,7,13,3,0,3
980998,1,7,13,23,0,23
981012,1,7,13,11,0,11
1082592,1,7,13,9,2,11
1082614,1,7,13,1,1,2
1082635,1,7,13,13,0,13
1082638,1,7,13,8,0,8
1082644,1,7,13,5,0,5
1082650,1,7,13,10,0,10
335994,2,7,13,10,1,11
335996,2,7,13,4,0,4
336002,2,7,13,8,0,8
336013,2,7,13,11,0,11
336017,2,7,13,6,0,6
336023,2,7,13,12,0,12
336033,2,7,13,19,0,19
392197,2,7,13,6,0,6
392202,2,7,13,1,0,1
392205,2,7,13,9,2,11
392217,2,7,13,6,0,6
392227,2,7,13,7,0,7
392230,2,7,13,11,1,12
419119,2,7,13,2,0,2
419127,2,7,13,14,0,14
419130,2,7,13,13,0,13
419137,2,7,13,3,5,8
419147,2,7,13,4,0,4
419170,2,7,13,7,0,7
501206,2,7,13,3,0,3
501210,2,7,13,10,0,10
501223,2,7,13,3,0,3
501256,2,7,13,6,1,7
501261,2,7,13,8,2,10
501272,2,7,13,3,0,3
501274,2,7,13,5,0,5
501275,2,7,13,4,0,4
548311,2,7,13,5,0,5
548313,2,7,13,2,0,2
548319,2,7,13,9,0,9
548344,2,7,13,10,2,12
548347,2,7,13,3,0,3
548351,2,7,13,4,0,4
548360,2,7,13,8,0,8
548372,2,7,13,13,1,14
548375,2,7,13,2,2,4
548382,2,7,13,13,0,13
548384,2,7,13,3,1,4
598004,2,7,13,11,0,11
598024,2,7,13,5,0,5
598034,2,7,13,14,0,14
598060,2,7,13,4,0,4
598065,2,7,13,4,0,4
598071,2,7,13,5,0,5
598075,2,7,13,8,0,8
598077,2,7,13,12,1,13
729284,2,7,13,12,0,12
729322,2,7,13,19,0,19
733978,2,7,13,20,0,20
734006,2,7,13,12,0,12
734030,2,7,13,1,1,2
734046,2,7,13,13,0,13
829722,2,7,13,8,0,8
829752,2,7,13,10,1,11
829788,2,7,13,7,1,8
829794,2,7,13,5,0,5
829800,2,7,13,12,0,12
829820,2,7,13,3,0,3
980914,2,7,13,4,0,4
980932,2,7,13,12,0,12
980938,2,7,13,6,0,6
980952,2,7,13,4,0,4
980962,2,7,13,5,0,5
980978,2,7,13,8,0,8
980986,2,7,13,3,0,3
1082597,2,7,13,8,0,8
1082600,2,7,13,10,1,11
1082602,2,7,13,5,0,5
1082606,2,7,13,5,0,5
1082612,2,7,13,15,1,16
1082618,2,7,13,8,0,8
1082625,2,7,13,11,0,11
1082628,2,7,13,8,0,8
1082641,2,7,13,3,0,3
1082647,2,7,13,4,0,4
1082649,2,7,13,3,0,3
335991,1,8,13,3,0,3
335993,1,8,13,2,0,2
335995,1,8,13,10,0,10
336004,1,8,13,3,0,3
336007,1,8,13,1,0,1
336016,1,8,13,9,0,9
336036,1,8,13,3,0,3
336042,1,8,13,6,0,6
392193,1,8,13,20,0,20
392197,1,8,13,11,1,12
392206,1,8,13,20,0,20
392210,1,8,13,12,0,12
392217,1,8,13,4,1,5
392221,1,8,13,11,0,11
392225,1,8,13,3,0,3
392244,1,8,13,5,0,5
419115,1,8,13,5,2,7
419122,1,8,13,2,0,2
419125,1,8,13,7,0,7
419131,1,8,13,2,1,3
419156,1,8,13,4,0,4
419165,1,8,13,13,0,13
419169,1,8,13,10,0,10
501204,1,8,13,2,0,2
501213,1,8,13,8,1,9
501217,1,8,13,5,0,5
501221,1,8,13,6,0,6
501234,1,8,13,13,0,13
501248,1,8,13,4,1,5
501255,1,8,13,5,0,5
501261,1,8,13,3,0,3
501269,1,8,13,20,0,20
548319,1,8,13,2,1,3
548326,1,8,13,4,0,4
548331,1,8,13,2,1,3
548334,1,8,13,16,0,16
548340,1,8,13,3,0,3
548346,1,8,13,5,0,5
548351,1,8,13,2,0,2
548353,1,8,13,10,0,10
548361,1,8,13,6,0,6
548371,1,8,13,12,0,12
548381,1,8,13,7,1,8
336012,2,8,13,6,1,7
336019,2,8,13,8,0,8
336025,2,8,13,2,0,2
336029,2,8,13,10,0,10
336039,2,8,13,7,0,7
392189,2,8,13,8,1,9
392201,2,8,13,6,0,6
392214,2,8,13,2,0,2
392228,2,8,13,10,2,12
392233,2,8,13,2,0,2
392234,2,8,13,5,1,6
392241,2,8,13,6,1,7
392242,2,8,13,11,0,11
419111,2,8,13,2,4,6
419135,2,8,13,9,0,9
419140,2,8,13,9,0,9
419143,2,8,13,3,0,3
419146,2,8,13,7,0,7
419150,2,8,13,5,0,5
419152,2,8,13,11,1,12
419161,2,8,13,10,0,10
419168,2,8,13,3,1,4
501208,2,8,13,3,1,4
501229,2,8,13,10,0,10
501241,2,8,13,7,0,7
501244,2,8,13,11,0,11
501264,2,8,13,5,0,5
548316,2,8,13,7,0,7
548357,2,8,13,3,0,3
548364,2,8,13,6,0,6
548378,2,8,13,2,1,3
501205,1,9,13,5,6,11
501212,1,9,13,4,0,4
501224,1,9,13,13,0,13
501230,1,9,13,6,0,6
501247,1,9,13,7,0,7
501252,1,9,13,6,1,7
501259,1,9,13,4,0,4
501215,2,9,13,7,1,8
501220,2,9,13,7,0,7
501234,2,9,13,7,0,7
501238,2,9,13,15,0,15
501243,2,9,13,14,1,15
501266,2,9,13,4,0,4
501218,1,10,13,2,0,2
501223,1,10,13,7,1,8
501233,1,10,13,5,1,6
501240,1,10,13,3,0,3
501264,1,10,13,2,0,2
501267,1,10,13,2,2,4
548313,1,10,13,6,1,7
548318,1,10,13,3,3,6
548324,1,10,13,2,4,6
548332,1,10,13,5,0,5
548338,1,10,13,8,2,10
548342,1,10,13,13,0,13
548363,1,10,13,3,1,4
598008,1,10,13,6,0,6
598020,1,10,13,8,0,8
598030,1,10,13,12,0,12
598052,1,10,13,11,0,11
598060,1,10,13,6,0,6
598066,1,10,13,3,0,3
598072,1,10,13,2,0,2
501207,2,10,13,15,0,15
501212,2,10,13,9,0,9
501231,2,10,13,4,1,5
501237,2,10,13,9,0,9
501246,2,10,13,5,0,5
501253,2,10,13,1,0,1
501255,2,10,13,3,0,3
548327,2,10,13,5,0,5
548335,2,10,13,10,1,11
548346,2,10,13,3,0,3
548353,2,10,13,9,0,9
548356,2,10,13,9,0,9
548358,2,10,13,3,1,4
548367,2,10,13,6,0,6
548370,2,10,13,5,0,5
548380,2,10,13,3,1,4
598005,2,10,13,11,0,11
598014,2,10,13,5,0,5
598016,2,10,13,11,1,12
598023,2,10,13,4,0,4
598032,2,10,13,7,0,7
598040,2,10,13,11,0,11
598043,2,10,13,5,0,5
598047,2,10,13,13,0,13
598058,2,10,13,11,0,11
598005,1,11,13,1,0,1
598023,1,11,13,4,0,4
598035,1,11,13,5,0,5
598037,1,11,13,9,0,9
598053,1,11,13,12,1,13
598061,1,11,13,5,0,5
598065,1,11,13,7,0,7
598070,1,11,13,6,2,8
598076,1,11,13,5,0,5
729290,1,11,13,3,0,3
729306,1,11,13,2,0,2
729316,1,11,13,8,0,8
729322,1,11,13,5,1,6
733982,1,11,13,4,0,4
733994,1,11,13,5,0,5
734006,1,11,13,3,0,3
734012,1,11,13,16,0,16
734020,1,11,13,4,0,4
734042,1,11,13,0,0,0
829732,1,11,13,4,0,4
829748,1,11,13,7,1,8
829764,1,11,13,7,0,7
829778,1,11,13,3,0,3
829792,1,11,13,13,0,13
829798,1,11,13,7,0,7
829804,1,11,13,15,0,15
829820,1,11,13,4,0,4
980920,1,11,13,10,0,10
980948,1,11,13,8,0,8
980958,1,11,13,11,0,11
980978,1,11,13,3,0,3
980984,1,11,13,1,0,1
980988,1,11,13,4,0,4
981008,1,11,13,8,0,8
981020,1,11,13,12,0,12
981024,1,11,13,4,0,4
1082591,1,11,13,17,1,18
1082600,1,11,13,10,2,12
1082609,1,11,13,11,0,11
1082611,1,11,13,9,1,10
1082615,1,11,13,2,0,2
1082623,1,11,13,11,0,11
1082627,1,11,13,7,0,7
1082630,1,11,13,5,0,5
1082648,1,11,13,5,0,5
598009,2,11,13,8,0,8
598015,2,11,13,2,0,2
598018,2,11,13,7,1,8
598026,2,11,13,5,0,5
598044,2,11,13,5,0,5
598049,2,11,13,8,0,8
598056,2,11,13,9,0,9
598074,2,11,13,2,6,8
729300,2,11,13,8,0,8
734026,2,11,13,4,0,4
734034,2,11,13,6,0,6
829716,2,11,13,6,0,6
829724,2,11,13,5,1,6
829736,2,11,13,4,0,4
829756,2,11,13,13,0,13
829786,2,11,13,6,0,6
980912,2,11,13,7,0,7
980928,2,11,13,8,0,8
980934,2,11,13,4,0,4
980940,2,11,13,11,0,11
980972,2,11,13,12,0,12
980996,2,11,13,13,0,13
981014,2,11,13,2,2,4
981022,2,11,13,9,0,9
1082596,2,11,13,11,0,11
1082604,2,11,13,14,1,15
1082634,2,11,13,11,0,11
1082638,2,11,13,1,0,1
1082643,2,11,13,10,0,10
980916,1,12,13,11,0,11
980924,1,12,13,4,1,5
980944,1,12,13,4,0,4
980954,1,12,13,14,0,14
980962,1,12,13,2,0,2
980974,1,12,13,11,0,11
980994,1,12,13,6,0,6
1082594,1,12,13,9,0,9
1082603,1,12,13,3,1,4
1082607,1,12,13,5,1,6
1082618,1,12,13,4,0,4
1082620,1,12,13,9,0,9
1082624,1,12,13,13,0,13
1082634,1,12,13,13,0,13
1082647,1,12,13,6,0,6
980906,2,12,13,7,1,8
980936,2,12,13,8,0,8
980970,2,12,13,10,0,10
980984,2,12,13,8,0,8
981010,2,12,13,4,0,4
1082592,2,12,13,9,0,9
1082599,2,12,13,14,1,15
1082615,2,12,13,6,1,7
1082629,2,12,13,6,1,7
1082631,2,12,13,20,0,20
1082642,2,12,13,7,0,7
1082650,2,12,13,2,0,2
980934,1,13,13,7,1,8
980950,1,13,13,3,0,3
980966,1,13,13,6,0,6
980972,1,13,13,8,0,8
981018,1,13,13,16,1,17
981022,1,13,13,2,0,2
1082593,1,13,13,7,0,7
1082596,1,13,13,12,0,12
1082606,1,13,13,9,1,10
1082625,1,13,13,8,0,8
1082629,1,13,13,12,0,12
1082632,1,13,13,10,2,12
1082640,1,13,13,11,1,12
1082643,1,13,13,2,0,2
980910,2,13,13,4,0,4
980916,2,13,13,6,0,6
980922,2,13,13,4,0,4
980942,2,13,13,8,0,8
980954,2,13,13,7,0,7
980960,2,13,13,10,0,10
980980,2,13,13,8,0,8
980992,2,13,13,3,2,5
981006,2,13,13,6,0,6
981012,2,13,13,5,0,5
1082603,2,13,13,5,0,5
1082610,2,13,13,14,0,14
1082613,2,13,13,5,0,5
1082616,2,13,13,7,0,7
1082621,2,13,13,8,1,9
1082637,2,13,13,8,0,8
335987,1,1,14,6,0,6
335998,1,1,14,5,0,5
336002,1,1,14,0,0,0
336015,1,1,14,6,0,6
336019,1,1,14,18,1,19
336022,1,1,14,4,1,5
336026,1,1,14,8,1,9
336030,1,1,14,2,1,3
336032,1,1,14,11,0,11
392189,1,1,14,7,0,7
392204,1,1,14,9,0,9
392212,1,1,14,3,0,3
392216,1,1,14,0,0,0
392224,1,1,14,8,1,9
392226,1,1,14,6,1,7
392233,1,1,14,7,0,7
419111,1,1,14,3,0,3
419127,1,1,14,13,0,13
419132,1,1,14,9,4,13
419140,1,1,14,6,1,7
419144,1,1,14,11,0,11
419149,1,1,14,8,0,8
419153,1,1,14,16,0,16
419158,1,1,14,4,0,4
501208,1,1,14,11,1,12
501227,1,1,14,3,0,3
501235,1,1,14,5,1,6
501244,1,1,14,9,1,10
501272,1,1,14,9,0,9
501274,1,1,14,6,1,7
548320,1,1,14,3,0,3
548349,1,1,14,5,0,5
548358,1,1,14,1,0,1
548373,1,1,14,3,0,3
548375,1,1,14,2,2,4
548380,1,1,14,11,0,11
548383,1,1,14,4,0,4
598013,1,1,14,9,0,9
598018,1,1,14,8,0,8
598027,1,1,14,6,1,7
598034,1,1,14,9,0,9
598045,1,1,14,10,1,11
598058,1,1,14,5,0,5
598074,1,1,14,6,0,6
729284,1,1,14,4,0,4
729294,1,1,14,6,0,6
729304,1,1,14,4,0,4
734032,1,1,14,5,1,6
734048,1,1,14,8,0,8
829718,1,1,14,7,0,7
829766,1,1,14,10,1,11
829786,1,1,14,6,0,6
980914,1,1,14,4,0,4
980952,1,1,14,6,0,6
980968,1,1,14,7,0,7
980980,1,1,14,5,0,5
981000,1,1,14,7,4,11
981006,1,1,14,5,0,5
981014,1,1,14,19,0,19
1082597,1,1,14,9,0,9
1082604,1,1,14,9,0,9
1082613,1,1,14,9,1,10
1082617,1,1,14,2,0,2
1082631,1,1,14,8,0,8
1082649,1,1,14,11,1,12
335991,2,1,14,9,0,9
336005,2,1,14,13,0,13
336008,2,1,14,5,0,5
336040,2,1,14,9,0,9
392195,2,1,14,3,2,5
392202,2,1,14,2,0,2
392208,2,1,14,7,0,7
392236,2,1,14,10,0,10
392238,2,1,14,3,1,4
419114,2,1,14,3,0,3
419118,2,1,14,2,0,2
419123,2,1,14,8,0,8
419136,2,1,14,8,1,9
419163,2,1,14,6,0,6
419166,2,1,14,7,1,8
501203,2,1,14,6,0,6
501214,2,1,14,10,0,10
501219,2,1,14,19,2,21
501224,2,1,14,2,0,2
501239,2,1,14,3,1,4
501247,2,1,14,9,0,9
501267,2,1,14,8,0,8
548317,2,1,14,8,1,9
548325,2,1,14,13,0,13
548328,2,1,14,5,0,5
548333,2,1,14,6,0,6
548340,2,1,14,9,0,9
548352,2,1,14,6,0,6
548362,2,1,14,9,2,11
548368,2,1,14,7,0,7
548386,2,1,14,8,0,8
598003,2,1,14,5,0,5
598010,2,1,14,12,1,13
598021,2,1,14,0,1,1
598036,2,1,14,5,0,5
598039,2,1,14,12,0,12
598048,2,1,14,8,1,9
598055,2,1,14,10,0,10
598062,2,1,14,6,0,6
598066,2,1,14,9,0,9
729312,2,1,14,3,1,4
729320,2,1,14,6,1,7
733976,2,1,14,4,0,4
733984,2,1,14,7,0,7
733990,2,1,14,8,0,8
734002,2,1,14,3,0,3
734014,2,1,14,8,0,8
734020,2,1,14,4,0,4
734028,2,1,14,11,0,11
734042,2,1,14,12,0,12
734054,2,1,14,12,2,14
829710,2,1,14,10,0,10
829728,2,1,14,12,0,12
829738,2,1,14,10,0,10
829744,2,1,14,9,0,9
829770,2,1,14,3,1,4
829796,2,1,14,23,1,24
829810,2,1,14,8,2,10
829816,2,1,14,2,0,2
980908,2,1,14,13,0,13
980920,2,1,14,7,0,7
980930,2,1,14,2,0,2
980944,2,1,14,12,1,13
980956,2,1,14,11,0,11
980964,2,1,14,3,9,12
981020,2,1,14,8,0,8
1082593,2,1,14,9,0,9
1082601,2,1,14,12,0,12
1082608,2,1,14,15,0,15
1082620,2,1,14,12,0,12
1082622,2,1,14,13,0,13
1082627,2,1,14,8,0,8
1082636,2,1,14,4,0,4
1082639,2,1,14,8,1,9
1082644,2,1,14,2,0,2
335997,1,2,14,2,0,2
336011,1,2,14,7,5,12
336017,1,2,14,2,0,2
336021,1,2,14,6,0,6
336031,1,2,14,11,0,11
336034,1,2,14,7,0,7
336039,1,2,14,7,0,7
392187,1,2,14,6,1,7
392196,1,2,14,14,0,14
392199,1,2,14,8,0,8
392209,1,2,14,4,0,4
392218,1,2,14,8,1,9
392241,1,2,14,11,0,11
419114,1,2,14,7,0,7
419128,1,2,14,5,0,5
419138,1,2,14,10,1,11
419150,1,2,14,2,3,5
501210,1,2,14,11,0,11
501237,1,2,14,4,0,4
501249,1,2,14,14,0,14
501273,1,2,14,11,0,11
501275,1,2,14,15,0,15
548315,1,2,14,10,1,11
548323,1,2,14,13,0,13
548341,1,2,14,9,1,10
548355,1,2,14,16,0,16
548367,1,2,14,16,0,16
548372,1,2,14,6,3,9
548377,1,2,14,20,0,20
598004,1,2,14,10,1,11
598009,1,2,14,7,0,7
598017,1,2,14,12,1,13
598032,1,2,14,7,0,7
598041,1,2,14,12,1,13
598047,1,2,14,12,0,12
598050,1,2,14,10,0,10
598059,1,2,14,3,0,3
598062,1,2,14,6,0,6
598069,1,2,14,10,0,10
729310,1,2,14,7,0,7
729318,1,2,14,4,0,4
734004,1,2,14,10,0,10
734010,1,2,14,8,0,8
734026,1,2,14,7,0,7
734040,1,2,14,5,0,5
829724,1,2,14,13,0,13
829768,1,2,14,14,0,14
829790,1,2,14,7,0,7
829800,1,2,14,11,0,11
829824,1,2,14,3,3,6
829826,1,2,14,17,2,19
980912,1,2,14,14,0,14
980926,1,2,14,15,1,16
980932,1,2,14,5,0,5
980936,1,2,14,11,0,11
980942,1,2,14,12,0,12
980964,1,2,14,3,0,3
980982,1,2,14,7,0,7
980986,1,2,14,7,0,7
980992,1,2,14,7,0,7
981004,1,2,14,18,0,18
1082595,1,2,14,15,1,16
1082598,1,2,14,2,0,2
1082602,1,2,14,19,0,19
1082610,1,2,14,10,0,10
1082621,1,2,14,14,0,14
1082628,1,2,14,5,0,5
1082636,1,2,14,12,0,12
1082646,1,2,14,4,1,5
335987,2,2,14,7,0,7
335990,2,2,14,3,2,5
336001,2,2,14,8,0,8
336003,2,2,14,11,1,12
336007,2,2,14,15,0,15
336015,2,2,14,5,0,5
336028,2,2,14,4,0,4
392190,2,2,14,0,0,0
392193,2,2,14,17,0,17
392204,2,2,14,9,2,11
392213,2,2,14,15,0,15
392223,2,2,14,2,5,7
392226,2,2,14,16,0,16
392229,2,2,14,9,0,9
392237,2,2,14,12,0,12
392243,2,2,14,4,0,4
392244,2,2,14,8,0,8
419117,2,2,14,4,0,4
419124,2,2,14,5,0,5
419133,2,2,14,8,4,12
419141,2,2,14,9,0,9
419145,2,2,14,20,0,20
419153,2,2,14,9,0,9
419156,2,2,14,3,0,3
419159,2,2,14,7,0,7
419162,2,2,14,7,0,7
419167,2,2,14,3,0,3
419169,2,2,14,8,0,8
501205,2,2,14,3,0,3
501213,2,2,14,10,0,10
501216,2,2,14,12,1,13
501227,2,2,14,6,0,6
501232,2,2,14,1,1,2
501252,2,2,14,4,0,4
501257,2,2,14,3,0,3
501265,2,2,14,6,0,6
501271,2,2,14,1,0,1
501276,2,2,14,3,0,3
548320,2,2,14,8,0,8
548329,2,2,14,9,0,9
548332,2,2,14,5,0,5
548336,2,2,14,14,1,15
548349,2,2,14,7,0,7
548361,2,2,14,5,0,5
548365,2,2,14,3,0,3
548381,2,2,14,4,1,5
598013,2,2,14,4,1,5
598022,2,2,14,12,0,12
598028,2,2,14,5,0,5
598038,2,2,14,8,0,8
598053,2,2,14,11,0,11
729286,2,2,14,15,0,15
729292,2,2,14,6,1,7
729304,2,2,14,6,0,6
733982,2,2,14,10,0,10
733988,2,2,14,1,0,1
733996,2,2,14,12,0,12
734018,2,2,14,3,1,4
734032,2,2,14,6,1,7
829718,2,2,14,4,0,4
829742,2,2,14,5,0,5
829750,2,2,14,10,0,10
829754,2,2,14,16,0,16
829784,2,2,14,3,1,4
980958,2,2,14,19,0,19
980974,2,2,14,20,0,20
981000,2,2,14,13,0,13
981016,2,2,14,8,0,8
981018,2,2,14,4,0,4
981024,2,2,14,8,0,8
1082591,2,2,14,4,0,4
1082607,2,2,14,4,0,4
1082624,2,2,14,5,0,5
1082633,2,2,14,4,0,4
335988,1,3,14,9,1,10
335994,1,3,14,14,0,14
336001,1,3,14,8,0,8
336006,1,3,14,5,0,5
336010,1,3,14,3,0,3
336012,1,3,14,3,0,3
336018,1,3,14,8,0,8
336023,1,3,14,9,1,10
336045,1,3,14,12,0,12
392190,1,3,14,12,1,13
392201,1,3,14,3,0,3
392207,1,3,14,7,0,7
392211,1,3,14,9,0,9
392214,1,3,14,6,0,6
392219,1,3,14,16,0,16
392229,1,3,14,1,0,1
392236,1,3,14,9,1,10
392239,1,3,14,4,0,4
392243,1,3,14,8,0,8
419118,1,3,14,4,0,4
419130,1,3,14,7,1,8
419142,1,3,14,22,0,22
419147,1,3,14,8,0,8
419152,1,3,14,11,0,11
419160,1,3,14,6,0,6
419168,1,3,14,6,0,6
419170,1,3,14,11,0,11
501203,1,3,14,3,0,3
501211,1,3,14,9,0,9
501216,1,3,14,5,0,5
501220,1,3,14,13,0,13
501231,1,3,14,4,0,4
501241,1,3,14,4,1,5
501250,1,3,14,7,0,7
501254,1,3,14,7,1,8
501258,1,3,14,3,0,3
501266,1,3,14,8,0,8
501271,1,3,14,7,1,8
501276,1,3,14,12,0,12
548311,1,3,14,4,0,4
548316,1,3,14,18,0,18
548321,1,3,14,5,0,5
548327,1,3,14,5,1,6
548335,1,3,14,11,0,11
548352,1,3,14,3,1,4
548357,1,3,14,8,1,9
548360,1,3,14,8,0,8
548376,1,3,14,12,0,12
548384,1,3,14,8,0,8
548385,1,3,14,12,0,12
548386,1,3,14,17,0,17
598025,1,3,14,10,0,10
598039,1,3,14,12,0,12
598043,1,3,14,12,0,12
598046,1,3,14,8,0,8
598056,1,3,14,7,1,8
598063,1,3,14,4,1,5
598067,1,3,14,8,0,8
598075,1,3,14,7,0,7
729288,1,3,14,4,0,4
729298,1,3,14,9,0,9
729302,1,3,14,8,5,13
733976,1,3,14,6,0,6
734018,1,3,14,9,0,9
734028,1,3,14,19,0,19
734034,1,3,14,2,0,2
829712,1,3,14,6,0,6
829716,1,3,14,7,0,7
829728,1,3,14,11,0,11
829740,1,3,14,9,2,11
829750,1,3,14,8,0,8
829758,1,3,14,2,1,3
829770,1,3,14,4,0,4
829784,1,3,14,9,0,9
829794,1,3,14,14,0,14
829802,1,3,14,14,0,14
829806,1,3,14,7,4,11
335998,2,3,14,11,1,12
336014,2,3,14,23,0,23
336034,2,3,14,2,1,3
336038,2,3,14,3,0,3
336042,2,3,14,11,1,12
336044,2,3,14,9,1,10
392186,2,3,14,3,0,3
392194,2,3,14,7,0,7
392207,2,3,14,5,0,5
392222,2,3,14,7,0,7
392232,2,3,14,7,1,8
419115,2,3,14,10,0,10
419121,2,3,14,3,1,4
419126,2,3,14,7,0,7
419128,2,3,14,9,0,9
419134,2,3,14,8,0,8
419138,2,3,14,7,0,7
419158,2,3,14,7,0,7
419164,2,3,14,6,1,7
501226,2,3,14,6,2,8
501233,2,3,14,12,0,12
501245,2,3,14,5,0,5
501273,2,3,14,5,0,5
548323,2,3,14,14,1,15
548337,2,3,14,5,0,5
548348,2,3,14,7,0,7
548366,2,3,14,8,0,8
548369,2,3,14,8,0,8
548373,2,3,14,2,0,2
598007,2,3,14,10,0,10
598012,2,3,14,9,0,9
598017,2,3,14,12,1,13
598020,2,3,14,9,0,9
598027,2,3,14,4,2,6
598031,2,3,14,13,1,14
598035,2,3,14,5,0,5
598051,2,3,14,14,6,20
598078,2,3,14,6,0,6
729308,2,3,14,9,0,9
729316,2,3,14,12,0,12
733986,2,3,14,13,0,13
733992,2,3,14,11,0,11
734000,2,3,14,11,1,12
734008,2,3,14,5,0,5
734040,2,3,14,4,0,4
734050,2,3,14,9,0,9
734052,2,3,14,5,0,5
829734,2,3,14,12,0,12
829778,2,3,14,1,0,1
829814,2,3,14,4,1,5
829822,2,3,14,11,0,11
829826,2,3,14,3,0,3
829828,2,3,14,4,0,4
335992,1,4,14,11,0,11
335996,1,4,14,6,0,6
336008,1,4,14,3,4,7
336024,1,4,14,13,0,13
336033,1,4,14,10,1,11
336040,1,4,14,13,0,13
336044,1,4,14,2,0,2
392191,1,4,14,3,0,3
392200,1,4,14,10,0,10
392205,1,4,14,4,1,5
392227,1,4,14,4,0,4
392234,1,4,14,4,0,4
419113,1,4,14,7,0,7
419117,1,4,14,10,0,10
419126,1,4,14,4,1,5
419137,1,4,14,10,0,10
419141,1,4,14,8,0,8
419148,1,4,14,5,0,5
419161,1,4,14,3,1,4
419164,1,4,14,14,0,14
501207,1,4,14,4,0,4
501225,1,4,14,21,0,21
501239,1,4,14,8,0,8
501253,1,4,14,7,0,7
501256,1,4,14,11,0,11
501262,1,4,14,7,1,8
501265,1,4,14,10,1,11
548328,1,4,14,8,2,10
548333,1,4,14,3,0,3
548336,1,4,14,5,0,5
548344,1,4,14,5,6,11
548348,1,4,14,8,0,8
548364,1,4,14,9,0,9
548374,1,4,14,7,0,7
548379,1,4,14,4,0,4
598012,1,4,14,9,0,9
598019,1,4,14,4,0,4
598021,1,4,14,9,1,10
598026,1,4,14,8,1,9
598033,1,4,14,9,0,9
598036,1,4,14,5,0,5
598057,1,4,14,4,0,4
598071,1,4,14,9,2,11
729300,1,4,14,15,1,16
729312,1,4,14,4,0,4
733978,1,4,14,16,0,16
733992,1,4,14,18,0,18
733996,1,4,14,5,0,5
734002,1,4,14,10,0,10
734030,1,4,14,3,0,3
734038,1,4,14,5,0,5
734052,1,4,14,9,0,9
734054,1,4,14,19,0,19
829722,1,4,14,11,0,11
829730,1,4,14,5,0,5
829738,1,4,14,8,4,12
829772,1,4,14,8,0,8
829796,1,4,14,14,0,14
829814,1,4,14,2,5,7
980910,1,4,14,7,0,7
980918,1,4,14,3,0,3
980930,1,4,14,6,1,7
980940,1,4,14,1,0,1
980960,1,4,14,5,0,5
980976,1,4,14,5,0,5
980996,1,4,14,13,0,13
981010,1,4,14,9,0,9
1082601,1,4,14,12,3,15
1082612,1,4,14,11,0,11
1082616,1,4,14,14,0,14
1082633,1,4,14,1,8,9
1082637,1,4,14,5,0,5
1082639,1,4,14,7,1,8
1082641,1,4,14,14,0,14
1082645,1,4,14,0,0,0
335988,2,4,14,9,2,11
336000,2,4,14,4,1,5
336004,2,4,14,2,0,2
336011,2,4,14,3,1,4
336018,2,4,14,10,0,10
336021,2,4,14,12,1,13
336036,2,4,14,4,0,4
392196,2,4,14,9,0,9
392209,2,4,14,7,0,7
392212,2,4,14,7,0,7
392215,2,4,14,11,0,11
392219,2,4,14,18,1,19
392221,2,4,14,4,0,4
392231,2,4,14,6,0,6
392239,2,4,14,5,0,5
419122,2,4,14,9,4,13
419129,2,4,14,7,0,7
419132,2,4,14,8,0,8
419144,2,4,14,5,0,5
419151,2,4,14,10,0,10
419154,2,4,14,12,2,14
501211,2,4,14,5,0,5
501217,2,4,14,4,0,4
501228,2,4,14,11,0,11
501242,2,4,14,7,0,7
501249,2,4,14,4,0,4
501259,2,4,14,11,0,11
501269,2,4,14,3,0,3
548314,2,4,14,13,0,13
548318,2,4,14,9,0,9
548324,2,4,14,3,0,3
548339,2,4,14,6,1,7
548355,2,4,14,7,0,7
548359,2,4,14,6,1,7
548371,2,4,14,6,1,7
548376,2,4,14,11,0,11
598030,2,4,14,10,0,10
598042,2,4,14,1,0,1
598046,2,4,14,9,0,9
598050,2,4,14,12,0,12
598061,2,4,14,18,0,18
598064,2,4,14,4,0,4
598069,2,4,14,16,1,17
729288,2,4,14,9,0,9
729296,2,4,14,7,0,7
729318,2,4,14,5,0,5
734012,2,4,14,7,0,7
734024,2,4,14,6,1,7
734044,2,4,14,8,0,8
734048,2,4,14,2,0,2
829714,2,4,14,9,0,9
829746,2,4,14,14,0,14
829758,2,4,14,2,0,2
829764,2,4,14,4,0,4
829780,2,4,14,8,0,8
829790,2,4,14,6,0,6
829804,2,4,14,16,0,16
980924,2,4,14,3,0,3
980946,2,4,14,10,0,10
980968,2,4,14,10,1,11
980982,2,4,14,9,1,10
980990,2,4,14,14,0,14
981004,2,4,14,11,0,11
1082594,2,4,14,11,2,13
1082598,2,4,14,16,0,16
1082605,2,4,14,5,0,5
1082609,2,4,14,4,0,4
1082623,2,4,14,6,0,6
335989,1,5,14,7,0,7
336005,1,5,14,12,0,12
336013,1,5,14,1,0,1
336028,1,5,14,7,5,12
336038,1,5,14,10,0,10
336043,1,5,14,10,0,10
392195,1,5,14,4,0,4
392215,1,5,14,9,0,9
392222,1,5,14,17,0,17
392230,1,5,14,19,0,19
392238,1,5,14,3,0,3
419116,1,5,14,5,0,5
419120,1,5,14,7,0,7
419123,1,5,14,12,0,12
419129,1,5,14,12,0,12
419134,1,5,14,7,0,7
419146,1,5,14,14,1,15
419159,1,5,14,5,0,5
419163,1,5,14,5,0,5
501214,1,5,14,10,2,12
501219,1,5,14,1,0,1
501245,1,5,14,11,0,11
501257,1,5,14,11,1,12
501263,1,5,14,1,0,1
548314,1,5,14,16,0,16
548317,1,5,14,17,0,17
548325,1,5,14,3,0,3
548329,1,5,14,24,0,24
548337,1,5,14,4,0,4
548354,1,5,14,4,0,4
548359,1,5,14,3,0,3
548366,1,5,14,3,0,3
548370,1,5,14,9,0,9
548378,1,5,14,4,1,5
548382,1,5,14,11,3,14
598006,1,5,14,3,2,5
598010,1,5,14,7,0,7
598014,1,5,14,4,0,4
598024,1,5,14,3,0,3
598028,1,5,14,9,0,9
598031,1,5,14,8,0,8
598048,1,5,14,7,0,7
598077,1,5,14,8,0,8
729296,1,5,14,3,0,3
729320,1,5,14,17,0,17
733984,1,5,14,3,2,5
734008,1,5,14,4,0,4
734016,1,5,14,9,0,9
734046,1,5,14,15,0,15
829714,1,5,14,16,0,16
829746,1,5,14,9,0,9
829754,1,5,14,4,0,4
829782,1,5,14,7,0,7
829816,1,5,14,13,1,14
335992,2,5,14,12,1,13
335995,2,5,14,5,0,5
335997,2,5,14,26,0,26
336010,2,5,14,4,0,4
336016,2,5,14,3,0,3
336020,2,5,14,3,0,3
336024,2,5,14,23,0,23
336032,2,5,14,7,1,8
336041,2,5,14,5,0,5
336045,2,5,14,5,0,5
392187,2,5,14,1,1,2
392200,2,5,14,5,0,5
392203,2,5,14,4,2,6
392210,2,5,14,4,0,4
392218,2,5,14,6,0,6
392225,2,5,14,4,0,4
392235,2,5,14,5,0,5
419112,2,5,14,7,0,7
419131,2,5,14,9,5,14
419139,2,5,14,6,0,6
419142,2,5,14,8,1,9
419148,2,5,14,3,0,3
419155,2,5,14,13,0,13
501204,2,5,14,1,0,1
501209,2,5,14,8,0,8
501225,2,5,14,3,0,3
501230,2,5,14,11,0,11
501236,2,5,14,5,0,5
501240,2,5,14,11,0,11
501254,2,5,14,9,0,9
501268,2,5,14,4,0,4
548322,2,5,14,19,0,19
548331,2,5,14,3,1,4
548341,2,5,14,2,0,2
548350,2,5,14,4,2,6
548363,2,5,14,3,0,3
598019,2,5,14,9,0,9
598037,2,5,14,7,0,7
598041,2,5,14,10,0,10
598052,2,5,14,21,0,21
598054,2,5,14,8,0,8
598057,2,5,14,3,0,3
598063,2,5,14,22,0,22
598068,2,5,14,6,0,6
598070,2,5,14,6,0,6
598076,2,5,14,18,0,18
729290,2,5,14,8,0,8
729302,2,5,14,9,0,9
733980,2,5,14,9,1,10
733994,2,5,14,6,0,6
734004,2,5,14,9,0,9
734022,2,5,14,4,0,4
734038,2,5,14,1,0,1
829720,2,5,14,11,0,11
829726,2,5,14,15,0,15
829732,2,5,14,10,0,10
829740,2,5,14,13,0,13
829774,2,5,14,9,0,9
829792,2,5,14,9,1,10
829802,2,5,14,5,0,5
829824,2,5,14,4,0,4
336000,1,6,14,3,1,4
336003,1,6,14,19,0,19
336014,1,6,14,12,1,13
336020,1,6,14,2,3,5
336025,1,6,14,18,0,18
392194,1,6,14,4,1,5
392203,1,6,14,4,0,4
392228,1,6,14,8,1,9
392231,1,6,14,14,0,14
392235,1,6,14,10,1,11
392237,1,6,14,4,0,4
392242,1,6,14,10,0,10
419121,1,6,14,12,0,12
419133,1,6,14,4,0,4
419136,1,6,14,17,1,18
419139,1,6,14,9,2,11
419145,1,6,14,6,1,7
419154,1,6,14,3,1,4
501206,1,6,14,8,0,8
501209,1,6,14,6,0,6
501228,1,6,14,13,0,13
501232,1,6,14,6,2,8
501238,1,6,14,4,0,4
501243,1,6,14,8,0,8
548347,1,6,14,1,0,1
548350,1,6,14,3,0,3
548362,1,6,14,5,0,5
548369,1,6,14,3,0,3
598003,1,6,14,4,1,5
598015,1,6,14,3,0,3
598022,1,6,14,7,0,7
598040,1,6,14,5,0,5
598049,1,6,14,5,0,5
598054,1,6,14,8,1,9
598064,1,6,14,3,1,4
729286,1,6,14,5,0,5
733980,1,6,14,3,0,3
733986,1,6,14,9,2,11
733990,1,6,14,5,0,5
733998,1,6,14,13,0,13
734024,1,6,14,5,0,5
734044,1,6,14,1,5,6
829720,1,6,14,6,1,7
829736,1,6,14,2,1,3
829744,1,6,14,8,1,9
829752,1,6,14,18,0,18
829762,1,6,14,8,0,8
829788,1,6,14,2,0,2
829818,1,6,14,20,0,20
980908,1,6,14,5,0,5
980938,1,6,14,11,0,11
980956,1,6,14,7,0,7
980970,1,6,14,6,0,6
981002,1,6,14,6,0,6
981016,1,6,14,4,0,4
1082599,1,6,14,4,0,4
1082605,1,6,14,7,0,7
1082608,1,6,14,5,0,5
1082622,1,6,14,15,0,15
1082626,1,6,14,1,0,1
1082642,1,6,14,8,0,8
335989,2,6,14,4,0,4
335993,2,6,14,0,1,1
336006,2,6,14,11,0,11
336009,2,6,14,8,0,8
336022,2,6,14,11,0,11
336031,2,6,14,5,0,5
336037,2,6,14,9,0,9
336043,2,6,14,2,0,2
392199,2,6,14,5,0,5
392206,2,6,14,5,0,5
392211,2,6,14,11,0,11
392216,2,6,14,7,0,7
392220,2,6,14,7,0,7
392224,2,6,14,7,0,7
392240,2,6,14,14,1,15
419113,2,6,14,16,0,16
419116,2,6,14,8,3,11
419119,2,6,14,1,0,1
419125,2,6,14,5,0,5
419149,2,6,14,6,1,7
419157,2,6,14,6,0,6
419160,2,6,14,3,0,3
419165,2,6,14,10,1,11
501218,2,6,14,4,0,4
501221,2,6,14,5,0,5
501235,2,6,14,2,0,2
501248,2,6,14,10,0,10
501251,2,6,14,4,0,4
501258,2,6,14,6,1,7
501262,2,6,14,2,0,2
548315,2,6,14,5,0,5
548321,2,6,14,2,1,3
548326,2,6,14,9,0,9
548330,2,6,14,7,0,7
548334,2,6,14,16,0,16
548338,2,6,14,5,0,5
548342,2,6,14,6,0,6
548354,2,6,14,6,0,6
548374,2,6,14,7,0,7
548377,2,6,14,10,3,13
548379,2,6,14,2,2,4
548383,2,6,14,5,0,5
548385,2,6,14,9,0,9
598006,2,6,14,9,3,12
598011,2,6,14,5,0,5
598025,2,6,14,2,0,2
598029,2,6,14,7,0,7
598033,2,6,14,14,0,14
598045,2,6,14,10,1,11
598059,2,6,14,4,5,9
598067,2,6,14,7,0,7
598072,2,6,14,7,1,8
729294,2,6,14,13,0,13
729298,2,6,14,5,0,5
729306,2,6,14,3,1,4
729314,2,6,14,5,0,5
734010,2,6,14,8,0,8
734016,2,6,14,5,0,5
734036,2,6,14,9,1,10
829712,2,6,14,10,0,10
829730,2,6,14,4,1,5
829766,2,6,14,2,0,2
829772,2,6,14,6,1,7
829782,2,6,14,8,2,10
829798,2,6,14,15,0,15
829806,2,6,14,3,0,3
980918,2,6,14,11,0,11
980926,2,6,14,19,1,20
980950,2,6,14,11,0,11
980966,2,6,14,4,0,4
980976,2,6,14,15,2,17
980988,2,6,14,14,0,14
980998,2,6,14,9,0,9
981008,2,6,14,11,0,11
1082595,2,6,14,5,0,5
1082611,2,6,14,6,0,6
1082614,2,6,14,5,0,5
1082630,2,6,14,12,0,12
1082632,2,6,14,12,0,12
1082635,2,6,14,0,0,0
1082640,2,6,14,2,0,2
1082646,2,6,14,11,0,11
335990,1,7,14,1,1,2
335999,1,7,14,15,0,15
336009,1,7,14,8,0,8
336029,1,7,14,7,0,7
336037,1,7,14,5,0,5
336041,1,7,14,9,0,9
392186,1,7,14,8,0,8
392202,1,7,14,16,0,16
392208,1,7,14,7,0,7
392213,1,7,14,6,0,6
392220,1,7,14,5,0,5
392223,1,7,14,7,0,7
392232,1,7,14,3,0,3
392240,1,7,14,4,0,4
419112,1,7,14,11,0,11
419119,1,7,14,14,1,15
419124,1,7,14,2,0,2
419135,1,7,14,4,0,4
419143,1,7,14,14,0,14
419151,1,7,14,5,0,5
419155,1,7,14,5,0,5
419157,1,7,14,12,0,12
419162,1,7,14,11,2,13
419166,1,7,14,2,2,4
419167,1,7,14,10,0,10
501215,1,7,14,14,0,14
501226,1,7,14,5,0,5
501229,1,7,14,10,0,10
501236,1,7,14,2,0,2
501242,1,7,14,8,0,8
501246,1,7,14,9,0,9
501251,1,7,14,3,1,4
501268,1,7,14,15,0,15
548322,1,7,14,22,1,23
548330,1,7,14,6,0,6
548339,1,7,14,12,0,12
548356,1,7,14,2,0,2
548365,1,7,14,12,0,12
548368,1,7,14,2,0,2
598007,1,7,14,2,0,2
598011,1,7,14,11,0,11
598016,1,7,14,12,0,12
598029,1,7,14,8,0,8
598038,1,7,14,6,0,6
598042,1,7,14,5,0,5
598044,1,7,14,2,2,4
598051,1,7,14,3,0,3
598055,1,7,14,8,0,8
598068,1,7,14,13,0,13
598078,1,7,14,6,0,6
729292,1,7,14,9,0,9
729308,1,7,14,6,0,6
729314,1,7,14,4,0,4
733988,1,7,14,8,1,9
734000,1,7,14,7,0,7
734014,1,7,14,17,0,17
734022,1,7,14,12,0,12
734036,1,7,14,6,0,6
734050,1,7,14,9,0,9
829710,1,7,14,4,0,4
829726,1,7,14,13,0,13
829734,1,7,14,24,2,26
829742,1,7,14,5,1,6
829756,1,7,14,4,0,4
829774,1,7,14,12,1,13
829780,1,7,14,3,0,3
829810,1,7,14,4,1,5
829822,1,7,14,9,0,9
829828,1,7,14,9,0,9
980906,1,7,14,3,0,3
980922,1,7,14,1,0,1
980928,1,7,14,26,0,26
980946,1,7,14,11,0,11
980990,1,7,14,3,4,7
980998,1,7,14,12,0,12
981012,1,7,14,6,0,6
1082592,1,7,14,5,0,5
1082614,1,7,14,10,0,10
1082635,1,7,14,17,0,17
1082638,1,7,14,15,0,15
1082644,1,7,14,6,0,6
1082650,1,7,14,3,0,3
335994,2,7,14,20,0,20
335996,2,7,14,4,0,4
336002,2,7,14,4,0,4
336013,2,7,14,7,0,7
336017,2,7,14,7,1,8
336023,2,7,14,26,0,26
336033,2,7,14,3,4,7
392197,2,7,14,6,1,7
392202,2,7,14,5,0,5
392205,2,7,14,5,1,6
392217,2,7,14,4,0,4
392227,2,7,14,9,0,9
392230,2,7,14,4,0,4
419119,2,7,14,1,0,1
419127,2,7,14,11,0,11
419130,2,7,14,7,0,7
419137,2,7,14,5,0,5
419147,2,7,14,3,0,3
419170,2,7,14,13,2,15
501206,2,7,14,7,1,8
501210,2,7,14,9,0,9
501223,2,7,14,2,0,2
501261,2,7,14,3,0,3
501272,2,7,14,5,0,5
501274,2,7,14,10,0,10
501275,2,7,14,1,0,1
548311,2,7,14,4,0,4
548313,2,7,14,3,0,3
548319,2,7,14,14,0,14
548344,2,7,14,14,0,14
548347,2,7,14,9,0,9
548351,2,7,14,8,0,8
548360,2,7,14,10,0,10
548372,2,7,14,4,0,4
548375,2,7,14,10,0,10
548382,2,7,14,10,2,12
548384,2,7,14,2,0,2
598004,2,7,14,6,0,6
598024,2,7,14,2,0,2
598034,2,7,14,8,0,8
598060,2,7,14,5,1,6
598065,2,7,14,1,0,1
598071,2,7,14,7,1,8
598075,2,7,14,4,0,4
598077,2,7,14,13,0,13
729284,2,7,14,3,0,3
729322,2,7,14,13,0,13
733978,2,7,14,6,0,6
734006,2,7,14,12,0,12
734030,2,7,14,4,0,4
734046,2,7,14,11,0,11
829722,2,7,14,6,0,6
829752,2,7,14,15,0,15
829788,2,7,14,6,0,6
829794,2,7,14,3,0,3
829800,2,7,14,4,0,4
829820,2,7,14,9,0,9
980914,2,7,14,9,0,9
980932,2,7,14,6,0,6
980938,2,7,14,5,0,5
980952,2,7,14,10,0,10
980962,2,7,14,5,1,6
980978,2,7,14,6,2,8
980986,2,7,14,5,0,5
1082597,2,7,14,3,0,3
1082600,2,7,14,3,1,4
1082602,2,7,14,10,0,10
1082606,2,7,14,13,0,13
1082612,2,7,14,3,1,4
1082618,2,7,14,11,0,11
1082625,2,7,14,5,0,5
1082628,2,7,14,6,0,6
1082641,2,7,14,14,0,14
1082647,2,7,14,12,1,13
1082649,2,7,14,12,2,14
335991,1,8,14,2,1,3
335993,1,8,14,6,0,6
335995,1,8,14,11,0,11
336004,1,8,14,5,0,5
336007,1,8,14,6,2,8
336016,1,8,14,3,1,4
336036,1,8,14,18,0,18
336042,1,8,14,14,0,14
392193,1,8,14,5,0,5
392197,1,8,14,5,1,6
392206,1,8,14,15,0,15
392210,1,8,14,5,2,7
392217,1,8,14,8,0,8
392221,1,8,14,4,0,4
392225,1,8,14,6,0,6
392244,1,8,14,7,0,7
419115,1,8,14,9,0,9
419122,1,8,14,4,0,4
419125,1,8,14,6,0,6
419131,1,8,14,4,0,4
419156,1,8,14,3,0,3
419165,1,8,14,2,0,2
419169,1,8,14,10,0,10
501204,1,8,14,5,0,5
501213,1,8,14,13,0,13
501217,1,8,14,10,0,10
501221,1,8,14,14,0,14
501234,1,8,14,12,0,12
501248,1,8,14,13,0,13
501255,1,8,14,12,0,12
501261,1,8,14,5,0,5
501269,1,8,14,5,0,5
548319,1,8,14,3,0,3
548326,1,8,14,3,0,3
548331,1,8,14,2,0,2
548334,1,8,14,11,0,11
548340,1,8,14,8,0,8
548346,1,8,14,12,0,12
548351,1,8,14,8,0,8
548353,1,8,14,6,0,6
548361,1,8,14,12,0,12
548371,1,8,14,3,4,7
548381,1,8,14,5,1,6
336012,2,8,14,11,0,11
336019,2,8,14,22,0,22
336025,2,8,14,6,0,6
336029,2,8,14,10,0,10
336039,2,8,14,8,0,8
392189,2,8,14,4,0,4
392201,2,8,14,2,0,2
392214,2,8,14,1,1,2
392228,2,8,14,13,0,13
392233,2,8,14,12,0,12
392234,2,8,14,2,0,2
392241,2,8,14,11,0,11
392242,2,8,14,6,0,6
419111,2,8,14,8,0,8
419135,2,8,14,14,0,14
419140,2,8,14,14,0,14
419143,2,8,14,5,0,5
419146,2,8,14,4,1,5
419150,2,8,14,10,0,10
419152,2,8,14,10,0,10
419161,2,8,14,3,0,3
419168,2,8,14,6,0,6
501208,2,8,14,4,0,4
501229,2,8,14,4,0,4
501241,2,8,14,7,0,7
501244,2,8,14,6,0,6
501264,2,8,14,7,0,7
548316,2,8,14,4,0,4
548357,2,8,14,4,0,4
548364,2,8,14,11,0,11
548378,2,8,14,5,1,6
501205,1,9,14,6,0,6
501212,1,9,14,10,2,12
501224,1,9,14,11,0,11
501230,1,9,14,5,0,5
501247,1,9,14,3,1,4
501252,1,9,14,1,0,1
501259,1,9,14,2,0,2
501215,2,9,14,9,4,13
501220,2,9,14,13,1,14
501234,2,9,14,4,2,6
501238,2,9,14,3,0,3
501243,2,9,14,3,0,3
501266,2,9,14,6,0,6
501218,1,10,14,9,0,9
501223,1,10,14,10,0,10
501233,1,10,14,7,0,7
501240,1,10,14,3,0,3
501264,1,10,14,4,1,5
501267,1,10,14,7,0,7
548313,1,10,14,4,0,4
548318,1,10,14,9,0,9
548324,1,10,14,7,0,7
548332,1,10,14,12,0,12
548338,1,10,14,3,1,4
548342,1,10,14,7,0,7
548363,1,10,14,4,0,4
598008,1,10,14,5,0,5
598020,1,10,14,4,0,4
598030,1,10,14,12,1,13
598052,1,10,14,11,0,11
598060,1,10,14,1,0,1
598066,1,10,14,1,0,1
598072,1,10,14,4,0,4
501207,2,10,14,4,1,5
501212,2,10,14,14,0,14
501231,2,10,14,7,0,7
501237,2,10,14,9,0,9
501246,2,10,14,7,0,7
501253,2,10,14,7,0,7
501255,2,10,14,9,1,10
548327,2,10,14,10,0,10
548335,2,10,14,4,0,4
548346,2,10,14,3,0,3
548353,2,10,14,10,0,10
548356,2,10,14,7,0,7
548358,2,10,14,6,0,6
548367,2,10,14,8,0,8
548370,2,10,14,8,0,8
548380,2,10,14,4,0,4
598005,2,10,14,4,0,4
598014,2,10,14,3,0,3
598016,2,10,14,10,0,10
598023,2,10,14,3,0,3
598032,2,10,14,1,0,1
598040,2,10,14,8,0,8
598043,2,10,14,13,0,13
598047,2,10,14,14,0,14
598058,2,10,14,9,0,9
598005,1,11,14,11,0,11
598023,1,11,14,5,0,5
598035,1,11,14,6,0,6
598037,1,11,14,4,0,4
598053,1,11,14,4,0,4
598061,1,11,14,13,0,13
598065,1,11,14,5,0,5
598070,1,11,14,14,0,14
598076,1,11,14,4,1,5
729290,1,11,14,3,0,3
729306,1,11,14,6,1,7
729316,1,11,14,5,1,6
729322,1,11,14,10,0,10
733982,1,11,14,2,0,2
733994,1,11,14,3,1,4
734006,1,11,14,8,0,8
734012,1,11,14,3,0,3
734020,1,11,14,7,1,8
734042,1,11,14,13,0,13
829732,1,11,14,8,0,8
829748,1,11,14,9,0,9
829764,1,11,14,6,0,6
829778,1,11,14,1,0,1
829792,1,11,14,16,1,17
829798,1,11,14,6,0,6
829804,1,11,14,9,0,9
829820,1,11,14,5,0,5
980920,1,11,14,13,0,13
980948,1,11,14,6,0,6
980958,1,11,14,13,0,13
980978,1,11,14,6,0,6
980984,1,11,14,12,0,12
980988,1,11,14,7,1,8
981008,1,11,14,9,0,9
981020,1,11,14,4,0,4
981024,1,11,14,7,0,7
1082591,1,11,14,8,0,8
1082600,1,11,14,4,1,5
1082609,1,11,14,10,0,10
1082611,1,11,14,19,0,19
1082615,1,11,14,11,1,12
1082623,1,11,14,11,1,12
1082627,1,11,14,6,0,6
1082630,1,11,14,8,0,8
1082648,1,11,14,5,0,5
598009,2,11,14,5,0,5
598015,2,11,14,4,0,4
598018,2,11,14,14,0,14
598026,2,11,14,6,1,7
598044,2,11,14,10,0,10
598049,2,11,14,8,1,9
598056,2,11,14,4,0,4
598074,2,11,14,5,0,5
729300,2,11,14,2,1,3
734026,2,11,14,10,0,10
734034,2,11,14,14,0,14
829716,2,11,14,3,0,3
829724,2,11,14,3,2,5
829736,2,11,14,11,0,11
829756,2,11,14,5,0,5
829786,2,11,14,6,0,6
980912,2,11,14,12,0,12
980928,2,11,14,8,0,8
980934,2,11,14,9,0,9
980940,2,11,14,6,0,6
980972,2,11,14,0,0,0
980996,2,11,14,9,0,9
981014,2,11,14,13,0,13
981022,2,11,14,6,0,6
1082596,2,11,14,6,0,6
1082604,2,11,14,3,0,3
1082634,2,11,14,2,0,2
1082638,2,11,14,9,1,10
1082643,2,11,14,5,0,5
980916,1,12,14,2,0,2
980924,1,12,14,9,0,9
980944,1,12,14,6,1,7
980954,1,12,14,7,1,8
980962,1,12,14,6,0,6
980974,1,12,14,8,1,9
980994,1,12,14,3,2,5
1082594,1,12,14,14,0,14
1082603,1,12,14,10,0,10
1082607,1,12,14,8,3,11
1082618,1,12,14,7,0,7
1082620,1,12,14,7,0,7
1082624,1,12,14,11,0,11
1082634,1,12,14,11,1,12
1082647,1,12,14,7,0,7
980906,2,12,14,10,0,10
980936,2,12,14,7,1,8
980970,2,12,14,2,0,2
980984,2,12,14,4,0,4
981010,2,12,14,5,0,5
1082592,2,12,14,14,1,15
1082599,2,12,14,6,0,6
1082615,2,12,14,3,0,3
1082629,2,12,14,3,0,3
1082631,2,12,14,1,0,1
1082642,2,12,14,12,0,12
1082650,2,12,14,4,0,4
980934,1,13,14,4,0,4
980950,1,13,14,8,0,8
980966,1,13,14,5,0,5
980972,1,13,14,1,0,1
981018,1,13,14,5,0,5
981022,1,13,14,17,0,17
1082593,1,13,14,7,0,7
1082596,1,13,14,9,0,9
1082606,1,13,14,7,5,12
1082625,1,13,14,3,0,3
1082629,1,13,14,6,1,7
1082632,1,13,14,19,0,19
1082640,1,13,14,11,0,11
1082643,1,13,14,3,0,3
980910,2,13,14,9,0,9
980916,2,13,14,8,1,9
980922,2,13,14,3,0,3
980942,2,13,14,9,0,9
980954,2,13,14,10,0,10
980960,2,13,14,8,0,8
980980,2,13,14,9,0,9
980992,2,13,14,11,2,13
981006,2,13,14,6,0,6
981012,2,13,14,12,0,12
1082603,2,13,14,11,0,11
1082610,2,13,14,13,0,13
1082613,2,13,14,9,0,9
1082616,2,13,14,4,0,4
1082621,2,13,14,11,0,11
1082637,2,13,14,6,0,6
335987,1,1,15,22,2,24
335998,1,1,15,12,0,12
336002,1,1,15,10,0,10
336015,1,1,15,14,0,14
336019,1,1,15,10,0,10
336022,1,1,15,4,0,4
336026,1,1,15,2,0,2
336030,1,1,15,8,1,9
336032,1,1,15,9,0,9
392189,1,1,15,5,0,5
392204,1,1,15,5,0,5
392212,1,1,15,14,0,14
392216,1,1,15,5,0,5
392224,1,1,15,5,1,6
392226,1,1,15,5,0,5
392233,1,1,15,11,0,11
419111,1,1,15,10,1,11
419127,1,1,15,8,1,9
419132,1,1,15,2,0,2
419140,1,1,15,10,0,10
419144,1,1,15,16,0,16
419149,1,1,15,7,1,8
419153,1,1,15,3,0,3
419158,1,1,15,4,0,4
501208,1,1,15,15,0,15
501227,1,1,15,10,0,10
501235,1,1,15,8,0,8
501244,1,1,15,13,0,13
501272,1,1,15,8,0,8
501274,1,1,15,15,0,15
548320,1,1,15,2,0,2
548349,1,1,15,13,0,13
548358,1,1,15,5,1,6
548373,1,1,15,7,0,7
548375,1,1,15,3,0,3
548380,1,1,15,9,1,10
548383,1,1,15,7,0,7
598013,1,1,15,8,0,8
598018,1,1,15,5,0,5
598027,1,1,15,0,0,0
598034,1,1,15,1,0,1
598045,1,1,15,7,0,7
598058,1,1,15,5,1,6
598074,1,1,15,8,1,9
729284,1,1,15,20,0,20
729294,1,1,15,13,0,13
729304,1,1,15,6,0,6
734032,1,1,15,24,0,24
734048,1,1,15,8,0,8
829718,1,1,15,14,0,14
829766,1,1,15,7,0,7
829786,1,1,15,4,0,4
980914,1,1,15,15,1,16
980952,1,1,15,4,0,4
980968,1,1,15,14,0,14
980980,1,1,15,9,1,10
981000,1,1,15,6,0,6
981006,1,1,15,14,0,14
981014,1,1,15,10,1,11
1082597,1,1,15,10,0,10
1082604,1,1,15,7,0,7
1082613,1,1,15,9,0,9
1082617,1,1,15,7,0,7
1082631,1,1,15,7,0,7
1082649,1,1,15,4,1,5
335991,2,1,15,3,1,4
336005,2,1,15,7,1,8
336008,2,1,15,16,0,16
336040,2,1,15,8,0,8
392195,2,1,15,4,0,4
392202,2,1,15,7,0,7
392208,2,1,15,10,0,10
392236,2,1,15,7,0,7
392238,2,1,15,4,0,4
419114,2,1,15,4,0,4
419118,2,1,15,6,0,6
419123,2,1,15,3,1,4
419136,2,1,15,7,0,7
419163,2,1,15,11,0,11
419166,2,1,15,7,0,7
501203,2,1,15,9,1,10
501214,2,1,15,11,1,12
501224,2,1,15,9,0,9
501239,2,1,15,7,0,7
501247,2,1,15,3,0,3
501267,2,1,15,8,0,8
548317,2,1,15,8,0,8
548325,2,1,15,3,0,3
548328,2,1,15,9,0,9
548333,2,1,15,10,0,10
548340,2,1,15,7,0,7
548352,2,1,15,11,0,11
548362,2,1,15,10,0,10
548368,2,1,15,3,1,4
548386,2,1,15,4,0,4
598003,2,1,15,2,0,2
598010,2,1,15,9,0,9
598021,2,1,15,8,1,9
598036,2,1,15,12,0,12
598039,2,1,15,6,1,7
598048,2,1,15,3,0,3
598055,2,1,15,3,0,3
598062,2,1,15,4,1,5
598066,2,1,15,8,0,8
729312,2,1,15,8,1,9
729320,2,1,15,8,1,9
733976,2,1,15,3,0,3
733984,2,1,15,1,0,1
733990,2,1,15,4,0,4
734002,2,1,15,10,0,10
734014,2,1,15,4,0,4
734020,2,1,15,11,0,11
734028,2,1,15,7,0,7
734042,2,1,15,6,1,7
734054,2,1,15,9,0,9
829710,2,1,15,12,0,12
829728,2,1,15,15,0,15
829738,2,1,15,12,0,12
829744,2,1,15,8,0,8
829770,2,1,15,6,0,6
829796,2,1,15,10,0,10
829810,2,1,15,6,0,6
829816,2,1,15,11,0,11
980908,2,1,15,1,1,2
980920,2,1,15,12,0,12
980930,2,1,15,5,0,5
980944,2,1,15,4,0,4
980956,2,1,15,12,2,14
980964,2,1,15,18,0,18
981020,2,1,15,10,0,10
1082593,2,1,15,20,2,22
1082601,2,1,15,9,0,9
1082608,2,1,15,10,0,10
1082620,2,1,15,10,2,12
1082622,2,1,15,2,0,2
1082627,2,1,15,4,0,4
1082636,2,1,15,0,1,1
1082639,2,1,15,12,0,12
1082644,2,1,15,3,0,3
335997,1,2,15,5,0,5
336011,1,2,15,13,0,13
336017,1,2,15,7,1,8
336021,1,2,15,5,0,5
336031,1,2,15,5,0,5
336034,1,2,15,11,0,11
336039,1,2,15,4,0,4
392187,1,2,15,9,1,10
392196,1,2,15,9,4,13
392199,1,2,15,6,0,6
392209,1,2,15,12,0,12
392218,1,2,15,4,0,4
392241,1,2,15,10,0,10
419114,1,2,15,4,0,4
419128,1,2,15,4,1,5
419138,1,2,15,2,0,2
419150,1,2,15,10,5,15
501210,1,2,15,8,1,9
501237,1,2,15,14,0,14
501249,1,2,15,6,0,6
501273,1,2,15,16,1,17
501275,1,2,15,5,0,5
548315,1,2,15,6,0,6
548323,1,2,15,13,1,14
548341,1,2,15,8,0,8
548355,1,2,15,5,0,5
548367,1,2,15,14,0,14
548372,1,2,15,8,0,8
548377,1,2,15,9,0,9
598004,1,2,15,6,1,7
598009,1,2,15,9,0,9
598017,1,2,15,15,1,16
598032,1,2,15,27,1,28
598041,1,2,15,4,0,4
598047,1,2,15,8,0,8
598050,1,2,15,21,1,22
598059,1,2,15,7,0,7
598062,1,2,15,8,0,8
598069,1,2,15,5,3,8
729310,1,2,15,8,0,8
729318,1,2,15,1,0,1
734004,1,2,15,10,2,12
734010,1,2,15,5,0,5
734026,1,2,15,12,0,12
734040,1,2,15,13,0,13
829724,1,2,15,3,1,4
829768,1,2,15,6,0,6
829790,1,2,15,23,0,23
829800,1,2,15,15,0,15
829824,1,2,15,19,0,19
829826,1,2,15,4,0,4
980912,1,2,15,15,1,16
980926,1,2,15,13,0,13
980932,1,2,15,9,0,9
980936,1,2,15,6,0,6
980942,1,2,15,10,1,11
980964,1,2,15,3,0,3
980982,1,2,15,11,0,11
980986,1,2,15,15,0,15
980992,1,2,15,14,0,14
981004,1,2,15,12,0,12
1082595,1,2,15,6,1,7
1082598,1,2,15,1,0,1
1082602,1,2,15,6,0,6
1082610,1,2,15,17,1,18
1082621,1,2,15,5,0,5
1082628,1,2,15,4,0,4
1082636,1,2,15,9,0,9
1082646,1,2,15,6,0,6
335987,2,2,15,2,2,4
335990,2,2,15,9,0,9
336001,2,2,15,4,1,5
336003,2,2,15,4,0,4
336007,2,2,15,3,0,3
336015,2,2,15,15,0,15
336028,2,2,15,10,0,10
392190,2,2,15,7,0,7
392193,2,2,15,11,0,11
392204,2,2,15,9,0,9
392213,2,2,15,15,0,15
392223,2,2,15,8,0,8
392226,2,2,15,8,1,9
392229,2,2,15,6,0,6
392237,2,2,15,14,0,14
392243,2,2,15,10,0,10
392244,2,2,15,4,0,4
419117,2,2,15,6,0,6
419124,2,2,15,2,0,2
419133,2,2,15,9,0,9
419141,2,2,15,12,0,12
419145,2,2,15,6,0,6
419153,2,2,15,10,0,10
419156,2,2,15,4,2,6
419159,2,2,15,1,0,1
419162,2,2,15,8,0,8
419167,2,2,15,9,0,9
501205,2,2,15,14,1,15
501213,2,2,15,9,0,9
501216,2,2,15,4,0,4
501227,2,2,15,13,2,15
501232,2,2,15,7,0,7
501257,2,2,15,11,0,11
501265,2,2,15,2,0,2
501271,2,2,15,8,0,8
501276,2,2,15,12,0,12
548320,2,2,15,4,1,5
548329,2,2,15,4,0,4
548332,2,2,15,5,0,5
548336,2,2,15,3,0,3
548349,2,2,15,2,0,2
548361,2,2,15,4,2,6
548365,2,2,15,14,0,14
548381,2,2,15,12,0,12
598013,2,2,15,2,0,2
598022,2,2,15,7,1,8
598028,2,2,15,8,0,8
598038,2,2,15,5,0,5
598053,2,2,15,5,0,5
729286,2,2,15,20,0,20
729292,2,2,15,10,0,10
729304,2,2,15,7,0,7
733982,2,2,15,8,0,8
733988,2,2,15,6,0,6
733996,2,2,15,9,0,9
734018,2,2,15,11,0,11
734032,2,2,15,6,0,6
829718,2,2,15,2,0,2
829742,2,2,15,5,0,5
829750,2,2,15,12,0,12
829754,2,2,15,10,0,10
829784,2,2,15,3,0,3
980958,2,2,15,9,1,10
980974,2,2,15,19,0,19
981000,2,2,15,10,0,10
981016,2,2,15,7,0,7
981018,2,2,15,14,0,14
981024,2,2,15,9,0,9
1082591,2,2,15,9,0,9
1082607,2,2,15,4,1,5
1082624,2,2,15,5,0,5
1082633,2,2,15,6,4,10
335988,1,3,15,18,0,18
335994,1,3,15,6,0,6
336001,1,3,15,8,0,8
336006,1,3,15,7,0,7
336010,1,3,15,4,0,4
336012,1,3,15,2,0,2
336018,1,3,15,12,0,12
336023,1,3,15,5,1,6
336045,1,3,15,8,0,8
392190,1,3,15,6,0,6
392201,1,3,15,7,0,7
392207,1,3,15,7,1,8
392211,1,3,15,4,4,8
392214,1,3,15,19,0,19
392219,1,3,15,24,0,24
392229,1,3,15,3,0,3
392236,1,3,15,2,0,2
392239,1,3,15,7,0,7
392243,1,3,15,3,0,3
419118,1,3,15,15,0,15
419130,1,3,15,6,0,6
419142,1,3,15,18,1,19
419147,1,3,15,5,0,5
419152,1,3,15,9,0,9
419160,1,3,15,3,0,3
419168,1,3,15,10,0,10
419170,1,3,15,16,1,17
501203,1,3,15,9,0,9
501211,1,3,15,13,0,13
501216,1,3,15,12,2,14
501220,1,3,15,1,1,2
501231,1,3,15,10,0,10
501241,1,3,15,7,1,8
501250,1,3,15,11,0,11
501254,1,3,15,10,1,11
501258,1,3,15,7,0,7
501266,1,3,15,11,0,11
501271,1,3,15,11,0,11
501276,1,3,15,18,0,18
548311,1,3,15,4,1,5
548316,1,3,15,4,2,6
548321,1,3,15,2,0,2
548327,1,3,15,8,0,8
548335,1,3,15,15,0,15
548352,1,3,15,5,1,6
548357,1,3,15,6,0,6
548360,1,3,15,8,1,9
548376,1,3,15,6,0,6
548384,1,3,15,12,0,12
548385,1,3,15,21,2,23
548386,1,3,15,8,0,8
598025,1,3,15,11,1,12
598039,1,3,15,12,0,12
598043,1,3,15,7,2,9
598046,1,3,15,9,0,9
598056,1,3,15,10,2,12
598063,1,3,15,6,0,6
598067,1,3,15,8,1,9
598075,1,3,15,11,0,11
729288,1,3,15,13,0,13
729298,1,3,15,8,0,8
729302,1,3,15,3,0,3
733976,1,3,15,11,1,12
734018,1,3,15,5,1,6
734028,1,3,15,7,0,7
734034,1,3,15,17,0,17
829712,1,3,15,5,0,5
829716,1,3,15,3,0,3
829728,1,3,15,6,0,6
829740,1,3,15,6,0,6
829750,1,3,15,2,0,2
829758,1,3,15,8,1,9
829770,1,3,15,7,0,7
829784,1,3,15,3,0,3
829794,1,3,15,5,0,5
829802,1,3,15,6,5,11
829806,1,3,15,6,1,7
335998,2,3,15,14,0,14
336014,2,3,15,4,0,4
336034,2,3,15,5,0,5
336038,2,3,15,13,0,13
336042,2,3,15,6,0,6
336044,2,3,15,16,0,16
392186,2,3,15,14,0,14
392194,2,3,15,8,1,9
392207,2,3,15,6,0,6
392222,2,3,15,9,1,10
392232,2,3,15,6,4,10
419115,2,3,15,9,0,9
419121,2,3,15,9,1,10
419126,2,3,15,5,0,5
419128,2,3,15,6,0,6
419134,2,3,15,13,1,14
419138,2,3,15,6,1,7
419164,2,3,15,7,0,7
501226,2,3,15,8,1,9
501233,2,3,15,3,0,3
501245,2,3,15,4,0,4
501273,2,3,15,11,0,11
548323,2,3,15,4,0,4
548337,2,3,15,11,0,11
548348,2,3,15,3,1,4
548366,2,3,15,8,0,8
548369,2,3,15,11,0,11
548373,2,3,15,5,0,5
598007,2,3,15,13,0,13
598012,2,3,15,6,0,6
598017,2,3,15,6,0,6
598020,2,3,15,3,1,4
598027,2,3,15,4,0,4
598031,2,3,15,10,2,12
598035,2,3,15,10,1,11
598051,2,3,15,3,0,3
598078,2,3,15,10,0,10
729308,2,3,15,3,0,3
729316,2,3,15,10,0,10
733986,2,3,15,11,0,11
733992,2,3,15,5,0,5
734000,2,3,15,8,0,8
734008,2,3,15,6,0,6
734040,2,3,15,8,0,8
734050,2,3,15,14,0,14
734052,2,3,15,6,1,7
829734,2,3,15,8,2,10
829778,2,3,15,14,0,14
829814,2,3,15,9,0,9
829822,2,3,15,11,0,11
829826,2,3,15,6,0,6
829828,2,3,15,10,0,10
335992,1,4,15,3,0,3
335996,1,4,15,16,0,16
336008,1,4,15,6,2,8
336024,1,4,15,9,0,9
336033,1,4,15,9,0,9
336040,1,4,15,12,0,12
336044,1,4,15,5,0,5
392191,1,4,15,11,2,13
392200,1,4,15,11,1,12
392205,1,4,15,4,2,6
392227,1,4,15,5,0,5
392234,1,4,15,16,0,16
419113,1,4,15,3,0,3
419117,1,4,15,4,0,4
419126,1,4,15,6,0,6
419137,1,4,15,7,0,7
419141,1,4,15,14,0,14
419148,1,4,15,9,0,9
419161,1,4,15,6,0,6
419164,1,4,15,9,1,10
501207,1,4,15,7,0,7
501225,1,4,15,16,0,16
501239,1,4,15,6,0,6
501253,1,4,15,6,1,7
501256,1,4,15,3,2,5
501262,1,4,15,2,1,3
501265,1,4,15,30,0,30
548328,1,4,15,2,0,2
548333,1,4,15,3,0,3
548336,1,4,15,10,1,11
548344,1,4,15,8,1,9
548348,1,4,15,8,0,8
548364,1,4,15,12,0,12
548374,1,4,15,3,0,3
548379,1,4,15,7,0,7
598012,1,4,15,9,1,10
598019,1,4,15,9,0,9
598021,1,4,15,3,0,3
598026,1,4,15,4,0,4
598033,1,4,15,5,1,6
598036,1,4,15,8,0,8
598057,1,4,15,2,1,3
598071,1,4,15,12,0,12
729300,1,4,15,12,1,13
729312,1,4,15,8,0,8
733978,1,4,15,9,0,9
733992,1,4,15,14,0,14
733996,1,4,15,4,0,4
734002,1,4,15,4,0,4
734030,1,4,15,3,0,3
734038,1,4,15,2,0,2
734052,1,4,15,10,0,10
734054,1,4,15,20,0,20
829722,1,4,15,11,0,11
829730,1,4,15,9,1,10
829738,1,4,15,5,0,5
829772,1,4,15,10,0,10
829796,1,4,15,20,1,21
829814,1,4,15,7,1,8
980910,1,4,15,9,2,11
980918,1,4,15,5,0,5
980930,1,4,15,10,0,10
980940,1,4,15,12,1,13
980960,1,4,15,5,0,5
980976,1,4,15,12,1,13
980996,1,4,15,6,0,6
981010,1,4,15,9,0,9
1082601,1,4,15,15,0,15
1082612,1,4,15,27,1,28
1082616,1,4,15,7,0,7
1082633,1,4,15,5,0,5
1082637,1,4,15,9,0,9
1082639,1,4,15,10,0,10
1082641,1,4,15,11,1,12
1082645,1,4,15,2,0,2
335988,2,4,15,13,0,13
336000,2,4,15,4,0,4
336004,2,4,15,18,1,19
336011,2,4,15,6,0,6
336018,2,4,15,8,0,8
336021,2,4,15,17,1,18
336036,2,4,15,12,0,12
392196,2,4,15,6,0,6
392209,2,4,15,3,1,4
392212,2,4,15,7,0,7
392215,2,4,15,2,1,3
392219,2,4,15,4,0,4
392221,2,4,15,4,0,4
392231,2,4,15,9,0,9
392239,2,4,15,5,0,5
419122,2,4,15,13,1,14
419129,2,4,15,5,0,5
419132,2,4,15,5,0,5
419144,2,4,15,7,0,7
419151,2,4,15,4,0,4
419154,2,4,15,2,1,3
501211,2,4,15,2,0,2
501217,2,4,15,3,0,3
501228,2,4,15,9,0,9
501242,2,4,15,11,1,12
501249,2,4,15,10,1,11
501259,2,4,15,2,1,3
501269,2,4,15,6,0,6
548314,2,4,15,5,0,5
548318,2,4,15,15,0,15
548324,2,4,15,10,0,10
548339,2,4,15,16,0,16
548355,2,4,15,9,1,10
548359,2,4,15,8,0,8
548371,2,4,15,21,0,21
548376,2,4,15,22,0,22
598030,2,4,15,8,0,8
598042,2,4,15,6,1,7
598046,2,4,15,10,0,10
598050,2,4,15,17,0,17
598061,2,4,15,3,1,4
598064,2,4,15,0,0,0
598069,2,4,15,25,1,26
729288,2,4,15,8,1,9
729296,2,4,15,4,1,5
729318,2,4,15,8,0,8
734012,2,4,15,2,1,3
734024,2,4,15,5,1,6
734048,2,4,15,4,0,4
829714,2,4,15,3,0,3
829746,2,4,15,6,0,6
829758,2,4,15,5,0,5
829764,2,4,15,14,0,14
829780,2,4,15,8,0,8
829804,2,4,15,3,2,5
980924,2,4,15,9,0,9
980946,2,4,15,9,0,9
980968,2,4,15,8,0,8
980982,2,4,15,9,0,9
980990,2,4,15,8,0,8
1082594,2,4,15,12,0,12
1082598,2,4,15,7,0,7
1082605,2,4,15,13,0,13
1082609,2,4,15,19,1,20
1082623,2,4,15,16,1,17
335989,1,5,15,9,0,9
336005,1,5,15,11,0,11
336013,1,5,15,7,0,7
336028,1,5,15,17,0,17
336038,1,5,15,17,0,17
336043,1,5,15,12,0,12
392195,1,5,15,10,0,10
392215,1,5,15,8,0,8
392222,1,5,15,6,1,7
392230,1,5,15,11,0,11
392238,1,5,15,5,2,7
419116,1,5,15,6,1,7
419120,1,5,15,3,0,3
419123,1,5,15,7,0,7
419129,1,5,15,10,0,10
419134,1,5,15,4,0,4
419146,1,5,15,6,0,6
419159,1,5,15,10,0,10
419163,1,5,15,0,0,0
501214,1,5,15,7,0,7
501219,1,5,15,1,0,1
501245,1,5,15,7,0,7
501257,1,5,15,6,0,6
501263,1,5,15,4,1,5
548314,1,5,15,4,5,9
548317,1,5,15,11,0,11
548325,1,5,15,5,0,5
548329,1,5,15,6,1,7
548337,1,5,15,12,10,22
548354,1,5,15,4,1,5
548359,1,5,15,7,0,7
548366,1,5,15,10,1,11
548370,1,5,15,8,0,8
548378,1,5,15,7,1,8
548382,1,5,15,1,0,1
598006,1,5,15,19,0,19
598010,1,5,15,13,1,14
598014,1,5,15,10,0,10
598024,1,5,15,7,1,8
598028,1,5,15,11,0,11
598031,1,5,15,11,0,11
598048,1,5,15,5,0,5
598077,1,5,15,3,0,3
729296,1,5,15,12,0,12
729320,1,5,15,7,0,7
733984,1,5,15,10,0,10
734008,1,5,15,8,0,8
734016,1,5,15,17,0,17
734046,1,5,15,13,0,13
829714,1,5,15,4,2,6
829746,1,5,15,13,0,13
829754,1,5,15,6,1,7
829782,1,5,15,10,0,10
829816,1,5,15,10,0,10
335992,2,5,15,15,0,15
335995,2,5,15,19,1,20
335997,2,5,15,4,0,4
336010,2,5,15,2,0,2
336016,2,5,15,10,5,15
336020,2,5,15,13,2,15
336024,2,5,15,8,0,8
336032,2,5,15,15,0,15
336041,2,5,15,5,0,5
336045,2,5,15,5,0,5
392187,2,5,15,4,0,4
392200,2,5,15,6,1,7
392203,2,5,15,3,1,4
392207,2,5,15,1,0,1
392210,2,5,15,5,0,5
392218,2,5,15,15,1,16
392225,2,5,15,8,1,9
392235,2,5,15,7,0,7
419112,2,5,15,5,0,5
419131,2,5,15,4,0,4
419139,2,5,15,8,0,8
419142,2,5,15,23,0,23
419148,2,5,15,13,1,14
419155,2,5,15,2,0,2
501204,2,5,15,9,0,9
501209,2,5,15,3,1,4
501225,2,5,15,11,0,11
501230,2,5,15,4,0,4
501236,2,5,15,8,0,8
501240,2,5,15,0,0,0
501254,2,5,15,9,0,9
548322,2,5,15,2,0,2
548331,2,5,15,11,0,11
548341,2,5,15,9,1,10
548350,2,5,15,8,0,8
548363,2,5,15,6,0,6
598019,2,5,15,6,0,6
598037,2,5,15,20,0,20
598041,2,5,15,3,2,5
598052,2,5,15,1,0,1
598054,2,5,15,13,0,13
598057,2,5,15,7,0,7
598063,2,5,15,16,0,16
598068,2,5,15,7,1,8
598070,2,5,15,7,1,8
598076,2,5,15,8,0,8
729290,2,5,15,13,0,13
729302,2,5,15,3,0,3
733980,2,5,15,4,0,4
733994,2,5,15,2,0,2
734004,2,5,15,14,0,14
734022,2,5,15,12,0,12
734038,2,5,15,6,2,8
829720,2,5,15,15,0,15
829726,2,5,15,5,1,6
829732,2,5,15,6,0,6
829740,2,5,15,9,1,10
829774,2,5,15,2,1,3
829792,2,5,15,8,1,9
829802,2,5,15,3,0,3
829824,2,5,15,4,1,5
336000,1,6,15,7,2,9
336003,1,6,15,13,0,13
336014,1,6,15,14,0,14
336020,1,6,15,2,0,2
336025,1,6,15,7,1,8
392194,1,6,15,9,0,9
392203,1,6,15,3,0,3
392228,1,6,15,6,0,6
392231,1,6,15,11,1,12
392235,1,6,15,6,0,6
392237,1,6,15,7,1,8
392242,1,6,15,5,0,5
419121,1,6,15,12,0,12
419133,1,6,15,12,0,12
419136,1,6,15,7,0,7
419139,1,6,15,9,0,9
419145,1,6,15,3,0,3
419154,1,6,15,2,0,2
501206,1,6,15,6,0,6
501209,1,6,15,13,0,13
501228,1,6,15,9,0,9
501232,1,6,15,9,1,10
501238,1,6,15,15,0,15
501243,1,6,15,4,1,5
548347,1,6,15,16,1,17
548350,1,6,15,3,0,3
548362,1,6,15,8,0,8
548369,1,6,15,4,0,4
598003,1,6,15,4,0,4
598015,1,6,15,5,0,5
598022,1,6,15,3,0,3
598040,1,6,15,4,0,4
598049,1,6,15,4,0,4
598054,1,6,15,8,0,8
598064,1,6,15,4,0,4
729286,1,6,15,3,0,3
733980,1,6,15,5,0,5
733986,1,6,15,3,0,3
733990,1,6,15,4,0,4
733998,1,6,15,6,0,6
734024,1,6,15,17,0,17
734044,1,6,15,5,0,5
829720,1,6,15,6,0,6
829736,1,6,15,15,0,15
829744,1,6,15,7,0,7
829752,1,6,15,7,0,7
829762,1,6,15,10,0,10
829788,1,6,15,5,0,5
829818,1,6,15,2,1,3
980908,1,6,15,3,0,3
980938,1,6,15,6,1,7
980956,1,6,15,13,1,14
980970,1,6,15,5,0,5
981002,1,6,15,5,0,5
981016,1,6,15,4,1,5
1082599,1,6,15,11,0,11
1082605,1,6,15,10,0,10
1082608,1,6,15,1,0,1
1082622,1,6,15,8,0,8
1082626,1,6,15,1,0,1
1082642,1,6,15,5,1,6
335989,2,6,15,12,1,13
336006,2,6,15,8,0,8
336009,2,6,15,5,0,5
336022,2,6,15,6,0,6
336031,2,6,15,4,0,4
336037,2,6,15,8,2,10
336043,2,6,15,3,0,3
392199,2,6,15,8,2,10
392206,2,6,15,2,1,3
392211,2,6,15,9,0,9
392216,2,6,15,9,0,9
392220,2,6,15,5,0,5
392224,2,6,15,6,0,6
392240,2,6,15,3,0,3
419113,2,6,15,4,0,4
419116,2,6,15,5,0,5
419119,2,6,15,0,0,0
419125,2,6,15,11,0,11
419149,2,6,15,10,0,10
419157,2,6,15,5,0,5
419160,2,6,15,4,0,4
419165,2,6,15,3,0,3
501218,2,6,15,8,0,8
501221,2,6,15,7,1,8
501235,2,6,15,9,0,9
501248,2,6,15,20,0,20
501251,2,6,15,3,1,4
501258,2,6,15,8,2,10
501262,2,6,15,6,0,6
548315,2,6,15,6,0,6
548326,2,6,15,2,0,2
548330,2,6,15,3,3,6
548334,2,6,15,13,0,13
548338,2,6,15,5,1,6
548342,2,6,15,4,0,4
548354,2,6,15,4,2,6
548374,2,6,15,8,0,8
548377,2,6,15,7,0,7
548379,2,6,15,1,0,1
548383,2,6,15,4,0,4
548385,2,6,15,8,0,8
598006,2,6,15,8,0,8
598011,2,6,15,8,0,8
598025,2,6,15,7,0,7
598029,2,6,15,11,0,11
598033,2,6,15,11,3,14
598045,2,6,15,4,0,4
598059,2,6,15,5,0,5
598067,2,6,15,6,0,6
598072,2,6,15,3,1,4
729294,2,6,15,6,0,6
729298,2,6,15,0,1,1
729306,2,6,15,5,0,5
729314,2,6,15,17,0,17
734010,2,6,15,9,0,9
734016,2,6,15,3,0,3
734036,2,6,15,4,0,4
829712,2,6,15,4,1,5
829730,2,6,15,17,1,18
829766,2,6,15,7,2,9
829782,2,6,15,9,0,9
829798,2,6,15,7,0,7
829806,2,6,15,2,0,2
980926,2,6,15,8,2,10
980950,2,6,15,17,0,17
980966,2,6,15,3,0,3
980976,2,6,15,4,0,4
980988,2,6,15,6,0,6
980998,2,6,15,3,0,3
981008,2,6,15,4,0,4
1082595,2,6,15,1,0,1
1082611,2,6,15,15,1,16
1082614,2,6,15,8,0,8
1082630,2,6,15,5,0,5
1082632,2,6,15,4,1,5
1082640,2,6,15,17,0,17
1082646,2,6,15,3,0,3
335990,1,7,15,6,0,6
335999,1,7,15,15,0,15
336009,1,7,15,2,0,2
336029,1,7,15,10,0,10
336037,1,7,15,9,0,9
336041,1,7,15,4,1,5
392186,1,7,15,4,0,4
392202,1,7,15,4,0,4
392208,1,7,15,5,0,5
392213,1,7,15,3,0,3
392220,1,7,15,10,1,11
392223,1,7,15,12,0,12
392232,1,7,15,9,0,9
392240,1,7,15,3,1,4
419112,1,7,15,19,0,19
419119,1,7,15,14,0,14
419124,1,7,15,10,1,11
419135,1,7,15,2,1,3
419143,1,7,15,9,1,10
419151,1,7,15,11,1,12
419155,1,7,15,5,0,5
419157,1,7,15,4,0,4
419162,1,7,15,21,1,22
419166,1,7,15,5,0,5
419167,1,7,15,4,0,4
501215,1,7,15,12,0,12
501226,1,7,15,11,0,11
501229,1,7,15,5,0,5
501236,1,7,15,3,1,4
501242,1,7,15,9,0,9
501246,1,7,15,1,0,1
501251,1,7,15,18,0,18
501268,1,7,15,9,0,9
548322,1,7,15,9,0,9
548330,1,7,15,4,0,4
548339,1,7,15,21,0,21
548356,1,7,15,3,0,3
548365,1,7,15,10,0,10
548368,1,7,15,19,0,19
598007,1,7,15,4,0,4
598011,1,7,15,14,0,14
598016,1,7,15,11,0,11
598029,1,7,15,11,1,12
598038,1,7,15,18,0,18
598042,1,7,15,3,1,4
598044,1,7,15,5,0,5
598051,1,7,15,4,0,4
598055,1,7,15,5,0,5
598068,1,7,15,8,1,9
598078,1,7,15,10,0,10
729292,1,7,15,5,0,5
729308,1,7,15,14,0,14
729314,1,7,15,6,0,6
733988,1,7,15,8,1,9
734000,1,7,15,6,0,6
734014,1,7,15,6,0,6
734022,1,7,15,3,0,3
734036,1,7,15,13,0,13
734050,1,7,15,10,0,10
829710,1,7,15,21,0,21
829726,1,7,15,8,1,9
829734,1,7,15,8,0,8
829742,1,7,15,12,1,13
829756,1,7,15,4,0,4
829774,1,7,15,8,0,8
829780,1,7,15,4,1,5
829810,1,7,15,8,0,8
829822,1,7,15,16,0,16
829828,1,7,15,12,0,12
980906,1,7,15,3,0,3
980922,1,7,15,4,0,4
980928,1,7,15,13,0,13
980946,1,7,15,15,0,15
980990,1,7,15,17,0,17
980998,1,7,15,7,5,12
981012,1,7,15,14,0,14
1082592,1,7,15,9,0,9
1082614,1,7,15,8,0,8
1082635,1,7,15,9,0,9
1082638,1,7,15,4,0,4
1082644,1,7,15,13,0,13
1082650,1,7,15,2,0,2
335994,2,7,15,4,0,4
335996,2,7,15,3,0,3
336002,2,7,15,8,0,8
336013,2,7,15,8,3,11
336017,2,7,15,7,0,7
336033,2,7,15,9,1,10
392197,2,7,15,4,1,5
392205,2,7,15,8,0,8
392217,2,7,15,3,0,3
392227,2,7,15,4,0,4
392230,2,7,15,16,2,18
419119,2,7,15,1,1,2
419127,2,7,15,5,0,5
419130,2,7,15,6,1,7
419137,2,7,15,13,0,13
419147,2,7,15,2,1,3
419170,2,7,15,5,1,6
501206,2,7,15,8,0,8
501210,2,7,15,8,0,8
501223,2,7,15,5,1,6
501261,2,7,15,6,1,7
501272,2,7,15,8,0,8
501274,2,7,15,5,1,6
501275,2,7,15,11,0,11
548311,2,7,15,4,0,4
548313,2,7,15,6,0,6
548319,2,7,15,2,0,2
548344,2,7,15,7,2,9
548347,2,7,15,15,0,15
548351,2,7,15,2,0,2
548360,2,7,15,15,0,15
548372,2,7,15,11,0,11
548375,2,7,15,3,0,3
548382,2,7,15,9,1,10
548384,2,7,15,8,1,9
598004,2,7,15,4,1,5
598024,2,7,15,7,0,7
598034,2,7,15,4,0,4
598060,2,7,15,10,0,10
598065,2,7,15,13,0,13
598071,2,7,15,16,0,16
598075,2,7,15,14,0,14
598077,2,7,15,1,0,1
729284,2,7,15,5,4,9
729322,2,7,15,7,0,7
733978,2,7,15,3,0,3
734006,2,7,15,8,0,8
734030,2,7,15,15,0,15
734046,2,7,15,14,0,14
829722,2,7,15,17,2,19
829752,2,7,15,5,0,5
829788,2,7,15,8,0,8
829794,2,7,15,7,0,7
829800,2,7,15,6,0,6
980914,2,7,15,17,0,17
980932,2,7,15,13,0,13
980938,2,7,15,5,0,5
980952,2,7,15,10,0,10
980962,2,7,15,11,0,11
980978,2,7,15,6,1,7
980986,2,7,15,12,1,13
1082597,2,7,15,7,0,7
1082600,2,7,15,9,0,9
1082602,2,7,15,10,1,11
1082606,2,7,15,11,2,13
1082612,2,7,15,21,0,21
1082618,2,7,15,7,1,8
1082625,2,7,15,5,0,5
1082628,2,7,15,10,0,10
1082641,2,7,15,11,0,11
1082647,2,7,15,4,1,5
1082649,2,7,15,5,1,6
335991,1,8,15,12,0,12
335993,1,8,15,5,0,5
335995,1,8,15,18,1,19
336004,1,8,15,13,0,13
336007,1,8,15,6,0,6
336016,1,8,15,3,0,3
336036,1,8,15,2,0,2
336042,1,8,15,7,1,8
392193,1,8,15,7,0,7
392197,1,8,15,6,0,6
392206,1,8,15,6,0,6
392210,1,8,15,13,0,13
392217,1,8,15,6,0,6
392221,1,8,15,11,0,11
392225,1,8,15,13,0,13
392244,1,8,15,18,2,20
419115,1,8,15,9,3,12
419122,1,8,15,6,0,6
419125,1,8,15,7,0,7
419131,1,8,15,3,0,3
419156,1,8,15,9,0,9
419165,1,8,15,3,0,3
419169,1,8,15,6,0,6
501204,1,8,15,8,0,8
501213,1,8,15,2,0,2
501217,1,8,15,7,0,7
501221,1,8,15,2,1,3
501234,1,8,15,7,0,7
501248,1,8,15,16,4,20
501255,1,8,15,2,0,2
501261,1,8,15,5,1,6
501269,1,8,15,13,0,13
548319,1,8,15,10,0,10
548326,1,8,15,7,0,7
548331,1,8,15,9,0,9
548334,1,8,15,15,0,15
548340,1,8,15,3,0,3
548346,1,8,15,7,4,11
548351,1,8,15,8,0,8
548353,1,8,15,19,0,19
548361,1,8,15,12,0,12
548371,1,8,15,5,0,5
548381,1,8,15,8,0,8
336012,2,8,15,3,0,3
336019,2,8,15,4,0,4
336025,2,8,15,8,0,8
336029,2,8,15,14,0,14
336039,2,8,15,7,0,7
392201,2,8,15,14,0,14
392214,2,8,15,1,0,1
392228,2,8,15,8,2,10
392233,2,8,15,6,0,6
392234,2,8,15,5,0,5
392241,2,8,15,3,0,3
392242,2,8,15,9,0,9
419111,2,8,15,6,0,6
419135,2,8,15,8,0,8
419140,2,8,15,3,1,4
419143,2,8,15,8,0,8
419146,2,8,15,5,0,5
419150,2,8,15,13,0,13
419152,2,8,15,12,0,12
419161,2,8,15,6,2,8
419168,2,8,15,12,5,17
501208,2,8,15,13,0,13
501229,2,8,15,5,0,5
501241,2,8,15,3,0,3
501244,2,8,15,12,0,12
501264,2,8,15,12,0,12
548316,2,8,15,2,0,2
548357,2,8,15,10,0,10
548364,2,8,15,6,1,7
548378,2,8,15,5,0,5
501205,1,9,15,8,0,8
501212,1,9,15,12,0,12
501224,1,9,15,10,0,10
501230,1,9,15,9,0,9
501247,1,9,15,5,0,5
501252,1,9,15,6,2,8
501259,1,9,15,6,0,6
501215,2,9,15,5,0,5
501220,2,9,15,11,0,11
501234,2,9,15,7,0,7
501238,2,9,15,12,0,12
501243,2,9,15,14,0,14
501266,2,9,15,5,0,5
501218,1,10,15,8,1,9
501223,1,10,15,3,0,3
501233,1,10,15,7,0,7
501240,1,10,15,5,0,5
501264,1,10,15,7,0,7
501267,1,10,15,2,0,2
548313,1,10,15,10,0,10
548318,1,10,15,12,0,12
548324,1,10,15,6,0,6
548332,1,10,15,4,1,5
548338,1,10,15,7,0,7
548342,1,10,15,13,1,14
548363,1,10,15,4,0,4
598008,1,10,15,8,0,8
598020,1,10,15,4,1,5
598030,1,10,15,7,1,8
598052,1,10,15,1,0,1
598060,1,10,15,3,0,3
598066,1,10,15,13,1,14
598072,1,10,15,9,1,10
501212,2,10,15,8,1,9
501231,2,10,15,8,0,8
501237,2,10,15,7,0,7
501246,2,10,15,4,2,6
501253,2,10,15,21,1,22
501255,2,10,15,6,0,6
548327,2,10,15,6,0,6
548335,2,10,15,7,0,7
548346,2,10,15,10,0,10
548353,2,10,15,6,0,6
548356,2,10,15,2,1,3
548358,2,10,15,19,0,19
548367,2,10,15,3,0,3
548370,2,10,15,8,0,8
548380,2,10,15,6,0,6
598005,2,10,15,6,0,6
598014,2,10,15,5,0,5
598016,2,10,15,13,0,13
598023,2,10,15,7,0,7
598032,2,10,15,9,1,10
598040,2,10,15,6,0,6
598043,2,10,15,1,0,1
598047,2,10,15,10,0,10
598058,2,10,15,2,0,2
598005,1,11,15,4,0,4
598023,1,11,15,4,0,4
598035,1,11,15,8,0,8
598037,1,11,15,5,0,5
598053,1,11,15,14,0,14
598061,1,11,15,9,0,9
598065,1,11,15,15,0,15
598070,1,11,15,5,2,7
598076,1,11,15,10,0,10
729290,1,11,15,4,1,5
729306,1,11,15,19,0,19
729316,1,11,15,6,0,6
729322,1,11,15,13,5,18
733982,1,11,15,11,2,13
733994,1,11,15,6,1,7
734006,1,11,15,11,1,12
734012,1,11,15,16,0,16
734020,1,11,15,1,0,1
734042,1,11,15,19,0,19
829732,1,11,15,3,0,3
829748,1,11,15,7,0,7
829764,1,11,15,6,0,6
829778,1,11,15,11,0,11
829792,1,11,15,7,0,7
829798,1,11,15,7,0,7
829804,1,11,15,17,0,17
829820,1,11,15,10,0,10
980920,1,11,15,8,0,8
980948,1,11,15,12,1,13
980958,1,11,15,19,0,19
980978,1,11,15,14,0,14
980984,1,11,15,14,0,14
980988,1,11,15,7,0,7
981008,1,11,15,7,0,7
981020,1,11,15,11,0,11
981024,1,11,15,13,0,13
1082591,1,11,15,19,0,19
1082600,1,11,15,8,0,8
1082609,1,11,15,10,2,12
1082611,1,11,15,8,0,8
1082615,1,11,15,15,1,16
1082623,1,11,15,12,0,12
1082627,1,11,15,7,1,8
1082630,1,11,15,7,1,8
1082648,1,11,15,13,0,13
598009,2,11,15,4,5,9
598015,2,11,15,7,0,7
598018,2,11,15,5,0,5
598026,2,11,15,5,0,5
598044,2,11,15,12,0,12
598056,2,11,15,5,0,5
598074,2,11,15,2,1,3
729300,2,11,15,4,0,4
734026,2,11,15,5,0,5
734034,2,11,15,11,0,11
829716,2,11,15,13,0,13
829724,2,11,15,12,1,13
829736,2,11,15,9,0,9
829756,2,11,15,5,0,5
829786,2,11,15,7,0,7
980912,2,11,15,14,0,14
980928,2,11,15,8,1,9
980934,2,11,15,12,0,12
980940,2,11,15,4,0,4
980972,2,11,15,10,0,10
980996,2,11,15,11,0,11
981014,2,11,15,5,0,5
981022,2,11,15,19,0,19
1082596,2,11,15,5,0,5
1082604,2,11,15,13,2,15
1082634,2,11,15,5,0,5
1082638,2,11,15,3,1,4
1082643,2,11,15,10,0,10
980916,1,12,15,8,0,8
980924,1,12,15,8,0,8
980944,1,12,15,10,0,10
980954,1,12,15,9,0,9
980962,1,12,15,6,1,7
980974,1,12,15,5,3,8
980994,1,12,15,5,0,5
1082594,1,12,15,10,0,10
1082603,1,12,15,6,0,6
1082607,1,12,15,8,0,8
1082618,1,12,15,9,0,9
1082620,1,12,15,15,0,15
1082624,1,12,15,1,1,2
1082634,1,12,15,2,0,2
1082647,1,12,15,8,0,8
980906,2,12,15,12,0,12
980936,2,12,15,13,0,13
980970,2,12,15,10,0,10
980984,2,12,15,6,0,6
981010,2,12,15,12,1,13
1082592,2,12,15,9,1,10
1082599,2,12,15,5,1,6
1082615,2,12,15,14,0,14
1082629,2,12,15,12,0,12
1082631,2,12,15,3,0,3
1082642,2,12,15,6,0,6
1082650,2,12,15,5,1,6
980934,1,13,15,9,0,9
980950,1,13,15,4,0,4
980966,1,13,15,7,0,7
980972,1,13,15,6,0,6
981018,1,13,15,10,0,10
981022,1,13,15,9,0,9
1082593,1,13,15,9,0,9
1082596,1,13,15,6,0,6
1082606,1,13,15,15,0,15
1082625,1,13,15,4,1,5
1082629,1,13,15,7,0,7
1082632,1,13,15,5,1,6
1082640,1,13,15,8,0,8
1082643,1,13,15,3,0,3
980910,2,13,15,2,2,4
980916,2,13,15,3,0,3
980922,2,13,15,9,0,9
980942,2,13,15,6,0,6
980954,2,13,15,9,0,9
980960,2,13,15,5,0,5
980980,2,13,15,15,0,15
980992,2,13,15,5,2,7
981012,2,13,15,9,0,9
1082603,2,13,15,9,1,10
1082610,2,13,15,5,0,5
1082613,2,13,15,12,1,13
1082616,2,13,15,15,0,15
1082637,2,13,15,10,1,11
335987,1,1,16,4,0,4
335998,1,1,16,2,2,4
336002,1,1,16,5,1,6
336015,1,1,16,13,1,14
336019,1,1,16,18,0,18
336022,1,1,16,9,0,9
336026,1,1,16,0,0,0
336030,1,1,16,13,0,13
336032,1,1,16,4,0,4
392189,1,1,16,10,0,10
392204,1,1,16,13,0,13
392212,1,1,16,10,3,13
392216,1,1,16,8,0,8
392224,1,1,16,11,0,11
392226,1,1,16,11,0,11
392233,1,1,16,14,1,15
419111,1,1,16,11,0,11
419127,1,1,16,15,1,16
419132,1,1,16,4,0,4
419140,1,1,16,9,0,9
419144,1,1,16,10,0,10
419149,1,1,16,4,0,4
419153,1,1,16,9,0,9
419158,1,1,16,5,0,5
501208,1,1,16,8,1,9
501227,1,1,16,14,0,14
501235,1,1,16,4,0,4
501244,1,1,16,11,0,11
501272,1,1,16,3,0,3
501274,1,1,16,6,2,8
548320,1,1,16,7,0,7
548349,1,1,16,10,0,10
548358,1,1,16,3,1,4
548373,1,1,16,10,0,10
548375,1,1,16,6,0,6
548380,1,1,16,6,0,6
548383,1,1,16,7,0,7
598013,1,1,16,10,0,10
598018,1,1,16,13,0,13
598027,1,1,16,2,0,2
598034,1,1,16,12,1,13
598045,1,1,16,7,1,8
598058,1,1,16,2,1,3
598074,1,1,16,2,4,6
729284,1,1,16,15,0,15
729294,1,1,16,12,0,12
729304,1,1,16,7,0,7
734032,1,1,16,9,0,9
734048,1,1,16,1,1,2
829718,1,1,16,9,0,9
829766,1,1,16,10,0,10
829786,1,1,16,9,1,10
980914,1,1,16,12,1,13
980952,1,1,16,4,0,4
980968,1,1,16,6,1,7
980980,1,1,16,10,0,10
981000,1,1,16,13,0,13
981006,1,1,16,10,0,10
981014,1,1,16,5,0,5
1082597,1,1,16,14,0,14
1082604,1,1,16,11,1,12
1082613,1,1,16,8,0,8
1082617,1,1,16,9,0,9
1082631,1,1,16,9,0,9
1082649,1,1,16,4,0,4
335991,2,1,16,6,0,6
336005,2,1,16,8,0,8
336008,2,1,16,12,0,12
336040,2,1,16,14,0,14
392195,2,1,16,21,1,22
392208,2,1,16,12,1,13
392236,2,1,16,6,0,6
392238,2,1,16,10,0,10
419114,2,1,16,2,0,2
419118,2,1,16,7,0,7
419123,2,1,16,10,0,10
419136,2,1,16,8,2,10
419163,2,1,16,14,0,14
419166,2,1,16,10,1,11
501203,2,1,16,7,0,7
501214,2,1,16,10,0,10
501224,2,1,16,12,0,12
501239,2,1,16,10,1,11
501247,2,1,16,6,0,6
501267,2,1,16,1,2,3
548317,2,1,16,4,0,4
548325,2,1,16,7,0,7
548328,2,1,16,5,0,5
548333,2,1,16,10,0,10
548340,2,1,16,4,0,4
548352,2,1,16,9,0,9
548362,2,1,16,5,1,6
548368,2,1,16,11,0,11
548386,2,1,16,11,0,11
598003,2,1,16,5,1,6
598010,2,1,16,5,0,5
598021,2,1,16,0,1,1
598036,2,1,16,8,1,9
598039,2,1,16,12,0,12
598048,2,1,16,7,0,7
598055,2,1,16,5,0,5
598062,2,1,16,2,0,2
598066,2,1,16,5,0,5
729312,2,1,16,10,0,10
729320,2,1,16,10,0,10
733976,2,1,16,19,0,19
733984,2,1,16,3,1,4
733990,2,1,16,10,0,10
734002,2,1,16,8,0,8
734014,2,1,16,16,0,16
734020,2,1,16,4,0,4
734028,2,1,16,9,0,9
734054,2,1,16,10,0,10
829710,2,1,16,2,0,2
829728,2,1,16,14,0,14
829738,2,1,16,14,0,14
829744,2,1,16,12,0,12
829770,2,1,16,5,0,5
829796,2,1,16,18,1,19
829810,2,1,16,8,0,8
829816,2,1,16,4,3,7
980920,2,1,16,10,1,11
980930,2,1,16,7,0,7
980944,2,1,16,5,0,5
980956,2,1,16,8,1,9
980964,2,1,16,14,2,16
981020,2,1,16,6,0,6
1082601,2,1,16,7,0,7
1082608,2,1,16,5,1,6
1082620,2,1,16,14,0,14
1082622,2,1,16,16,0,16
1082627,2,1,16,5,3,8
1082636,2,1,16,2,0,2
1082639,2,1,16,6,0,6
1082644,2,1,16,4,0,4
335997,1,2,16,13,0,13
336011,1,2,16,5,0,5
336017,1,2,16,7,5,12
336021,1,2,16,16,0,16
336031,1,2,16,3,0,3
336034,1,2,16,10,1,11
336039,1,2,16,7,1,8
392187,1,2,16,1,0,1
392196,1,2,16,13,0,13
392199,1,2,16,9,0,9
392209,1,2,16,4,0,4
392218,1,2,16,6,0,6
392241,1,2,16,16,0,16
419114,1,2,16,8,0,8
419128,1,2,16,6,0,6
419138,1,2,16,0,0,0
419150,1,2,16,8,0,8
501210,1,2,16,8,4,12
501237,1,2,16,16,0,16
501249,1,2,16,8,0,8
501273,1,2,16,9,0,9
501275,1,2,16,4,1,5
548315,1,2,16,5,0,5
548323,1,2,16,12,0,12
548341,1,2,16,15,0,15
548355,1,2,16,7,0,7
548367,1,2,16,3,0,3
548372,1,2,16,13,2,15
548377,1,2,16,22,0,22
598004,1,2,16,6,0,6
598009,1,2,16,2,0,2
598017,1,2,16,8,2,10
598032,1,2,16,5,0,5
598041,1,2,16,6,1,7
598047,1,2,16,11,0,11
598050,1,2,16,15,0,15
598059,1,2,16,7,0,7
598062,1,2,16,12,0,12
598069,1,2,16,7,0,7
729318,1,2,16,2,0,2
734004,1,2,16,17,0,17
734010,1,2,16,6,1,7
734026,1,2,16,18,1,19
734040,1,2,16,7,2,9
829724,1,2,16,11,0,11
829768,1,2,16,11,1,12
829790,1,2,16,8,0,8
829800,1,2,16,13,0,13
829824,1,2,16,11,0,11
829826,1,2,16,13,0,13
980912,1,2,16,7,1,8
980926,1,2,16,21,0,21
980932,1,2,16,6,5,11
980936,1,2,16,3,6,9
980942,1,2,16,13,0,13
980964,1,2,16,13,0,13
980982,1,2,16,16,0,16
980986,1,2,16,10,0,10
980992,1,2,16,23,0,23
1082595,1,2,16,13,0,13
1082598,1,2,16,8,1,9
1082602,1,2,16,3,1,4
1082610,1,2,16,7,0,7
1082621,1,2,16,4,0,4
1082628,1,2,16,7,0,7
1082636,1,2,16,3,0,3
1082646,1,2,16,5,0,5
335987,2,2,16,0,1,1
335990,2,2,16,8,0,8
336001,2,2,16,8,0,8
336003,2,2,16,6,0,6
336007,2,2,16,17,0,17
336015,2,2,16,13,0,13
336028,2,2,16,6,0,6
392190,2,2,16,2,0,2
392193,2,2,16,12,0,12
392204,2,2,16,9,0,9
392213,2,2,16,5,0,5
392223,2,2,16,5,1,6
392226,2,2,16,3,0,3
392229,2,2,16,2,0,2
392237,2,2,16,3,0,3
392243,2,2,16,2,0,2
392244,2,2,16,5,0,5
419117,2,2,16,10,0,10
419124,2,2,16,15,0,15
419133,2,2,16,4,1,5
419141,2,2,16,12,0,12
419145,2,2,16,8,0,8
419153,2,2,16,16,1,17
419156,2,2,16,7,0,7
419159,2,2,16,8,0,8
419162,2,2,16,9,0,9
419167,2,2,16,4,1,5
501205,2,2,16,5,0,5
501213,2,2,16,16,0,16
501216,2,2,16,8,3,11
501227,2,2,16,7,0,7
501232,2,2,16,7,5,12
501257,2,2,16,13,0,13
501265,2,2,16,13,0,13
501271,2,2,16,5,3,8
501276,2,2,16,8,0,8
548320,2,2,16,7,3,10
548329,2,2,16,3,0,3
548332,2,2,16,10,1,11
548336,2,2,16,14,2,16
548349,2,2,16,11,0,11
548361,2,2,16,16,1,17
548365,2,2,16,9,1,10
548381,2,2,16,14,0,14
598013,2,2,16,17,1,18
598022,2,2,16,3,0,3
598028,2,2,16,4,0,4
598038,2,2,16,8,0,8
598053,2,2,16,19,2,21
729286,2,2,16,8,0,8
729292,2,2,16,3,0,3
729304,2,2,16,7,0,7
733982,2,2,16,19,0,19
733988,2,2,16,9,0,9
733996,2,2,16,17,2,19
734018,2,2,16,10,0,10
734032,2,2,16,18,4,22
829718,2,2,16,13,0,13
829742,2,2,16,13,2,15
829750,2,2,16,12,0,12
829754,2,2,16,6,0,6
829784,2,2,16,9,0,9
980958,2,2,16,10,0,10
980974,2,2,16,3,0,3
981000,2,2,16,9,0,9
981016,2,2,16,8,0,8
981018,2,2,16,16,0,16
981024,2,2,16,4,0,4
1082591,2,2,16,12,0,12
1082607,2,2,16,9,1,10
1082624,2,2,16,2,1,3
1082633,2,2,16,7,1,8
335988,1,3,16,8,0,8
335994,1,3,16,14,1,15
336001,1,3,16,14,0,14
336006,1,3,16,1,0,1
336010,1,3,16,5,0,5
336012,1,3,16,8,1,9
336018,1,3,16,5,0,5
336023,1,3,16,13,0,13
336045,1,3,16,10,0,10
392190,1,3,16,9,0,9
392201,1,3,16,7,0,7
392207,1,3,16,3,1,4
392211,1,3,16,7,1,8
392214,1,3,16,7,0,7
392219,1,3,16,8,1,9
392229,1,3,16,2,0,2
392236,1,3,16,17,0,17
392239,1,3,16,4,0,4
392243,1,3,16,7,0,7
419118,1,3,16,7,0,7
419130,1,3,16,10,0,10
419142,1,3,16,26,0,26
419147,1,3,16,4,0,4
419152,1,3,16,3,1,4
419160,1,3,16,3,0,3
419168,1,3,16,6,1,7
419170,1,3,16,19,0,19
501203,1,3,16,14,0,14
501211,1,3,16,14,0,14
501216,1,3,16,11,0,11
501220,1,3,16,8,0,8
501231,1,3,16,9,1,10
501241,1,3,16,15,0,15
501250,1,3,16,4,0,4
501254,1,3,16,4,0,4
501258,1,3,16,11,1,12
501266,1,3,16,13,0,13
501271,1,3,16,3,0,3
501276,1,3,16,6,0,6
548311,1,3,16,4,0,4
548316,1,3,16,12,0,12
548321,1,3,16,3,0,3
548327,1,3,16,11,0,11
548335,1,3,16,1,0,1
548352,1,3,16,4,0,4
548357,1,3,16,5,0,5
548360,1,3,16,15,0,15
548376,1,3,16,1,0,1
548384,1,3,16,14,0,14
548385,1,3,16,4,1,5
548386,1,3,16,10,0,10
598025,1,3,16,7,0,7
598039,1,3,16,7,0,7
598043,1,3,16,12,0,12
598046,1,3,16,16,0,16
598056,1,3,16,16,0,16
598063,1,3,16,5,0,5
598067,1,3,16,15,1,16
598075,1,3,16,12,0,12
729288,1,3,16,14,1,15
729298,1,3,16,8,0,8
729302,1,3,16,5,0,5
733976,1,3,16,5,2,7
734018,1,3,16,6,1,7
734028,1,3,16,13,1,14
734034,1,3,16,10,3,13
829712,1,3,16,3,0,3
829716,1,3,16,9,0,9
829728,1,3,16,7,0,7
829740,1,3,16,7,0,7
829750,1,3,16,6,0,6
829758,1,3,16,14,1,15
829770,1,3,16,6,1,7
829784,1,3,16,12,0,12
829794,1,3,16,5,0,5
829802,1,3,16,7,0,7
829806,1,3,16,3,0,3
335998,2,3,16,13,5,18
336014,2,3,16,5,1,6
336034,2,3,16,1,0,1
336038,2,3,16,8,0,8
336042,2,3,16,3,0,3
392186,2,3,16,6,0,6
392194,2,3,16,8,0,8
392207,2,3,16,3,0,3
392222,2,3,16,20,0,20
392232,2,3,16,7,1,8
419115,2,3,16,10,0,10
419121,2,3,16,3,0,3
419126,2,3,16,3,0,3
419128,2,3,16,12,0,12
419134,2,3,16,3,3,6
419138,2,3,16,10,1,11
419164,2,3,16,8,3,11
501226,2,3,16,3,1,4
501233,2,3,16,6,0,6
501245,2,3,16,7,0,7
501273,2,3,16,8,0,8
548323,2,3,16,10,0,10
548337,2,3,16,11,1,12
548348,2,3,16,8,0,8
548366,2,3,16,3,0,3
548369,2,3,16,3,0,3
548373,2,3,16,9,0,9
598007,2,3,16,6,0,6
598012,2,3,16,15,1,16
598017,2,3,16,11,0,11
598020,2,3,16,5,0,5
598027,2,3,16,10,0,10
598031,2,3,16,14,0,14
598035,2,3,16,0,0,0
598051,2,3,16,1,0,1
598078,2,3,16,10,0,10
729308,2,3,16,7,0,7
729316,2,3,16,2,1,3
733986,2,3,16,14,0,14
733992,2,3,16,8,0,8
734000,2,3,16,12,1,13
734008,2,3,16,6,0,6
734040,2,3,16,18,4,22
734050,2,3,16,20,0,20
734052,2,3,16,9,0,9
829734,2,3,16,5,0,5
829778,2,3,16,6,0,6
829814,2,3,16,6,0,6
829822,2,3,16,6,2,8
829826,2,3,16,15,0,15
829828,2,3,16,12,1,13
335992,1,4,16,13,0,13
335996,1,4,16,8,0,8
336008,1,4,16,9,0,9
336024,1,4,16,7,0,7
336033,1,4,16,5,0,5
336040,1,4,16,7,0,7
336044,1,4,16,4,1,5
392191,1,4,16,6,0,6
392200,1,4,16,9,0,9
392205,1,4,16,6,1,7
392227,1,4,16,6,0,6
392234,1,4,16,11,0,11
419113,1,4,16,1,0,1
419117,1,4,16,9,0,9
419126,1,4,16,9,0,9
419137,1,4,16,6,0,6
419141,1,4,16,12,1,13
419148,1,4,16,6,0,6
419161,1,4,16,13,1,14
419164,1,4,16,8,0,8
501207,1,4,16,8,0,8
501225,1,4,16,3,3,6
501239,1,4,16,7,0,7
501253,1,4,16,5,1,6
501256,1,4,16,5,0,5
501262,1,4,16,6,2,8
501265,1,4,16,8,4,12
548328,1,4,16,11,0,11
548333,1,4,16,7,0,7
548336,1,4,16,7,0,7
548344,1,4,16,16,0,16
548348,1,4,16,8,0,8
548364,1,4,16,6,0,6
548374,1,4,16,7,0,7
548379,1,4,16,8,0,8
598012,1,4,16,7,0,7
598019,1,4,16,4,0,4
598021,1,4,16,10,0,10
598026,1,4,16,10,0,10
598033,1,4,16,16,0,16
598036,1,4,16,9,0,9
598057,1,4,16,13,0,13
598071,1,4,16,10,2,12
729300,1,4,16,3,0,3
729312,1,4,16,3,0,3
733978,1,4,16,5,0,5
733992,1,4,16,19,1,20
733996,1,4,16,25,1,26
734002,1,4,16,7,0,7
734030,1,4,16,9,0,9
734038,1,4,16,6,0,6
734052,1,4,16,8,1,9
734054,1,4,16,8,1,9
829722,1,4,16,12,1,13
829730,1,4,16,16,0,16
829738,1,4,16,3,0,3
829772,1,4,16,13,5,18
829796,1,4,16,7,0,7
829814,1,4,16,7,1,8
980910,1,4,16,5,0,5
980918,1,4,16,11,1,12
980930,1,4,16,7,0,7
980940,1,4,16,2,0,2
980960,1,4,16,13,0,13
980976,1,4,16,16,0,16
980996,1,4,16,13,0,13
981010,1,4,16,4,0,4
1082601,1,4,16,3,1,4
1082612,1,4,16,21,1,22
1082616,1,4,16,8,0,8
1082633,1,4,16,13,2,15
1082637,1,4,16,10,0,10
1082639,1,4,16,13,0,13
1082641,1,4,16,15,2,17
1082645,1,4,16,2,0,2
335988,2,4,16,10,1,11
336000,2,4,16,10,0,10
336004,2,4,16,10,1,11
336011,2,4,16,1,0,1
336018,2,4,16,3,1,4
336021,2,4,16,3,0,3
336036,2,4,16,3,1,4
392196,2,4,16,19,0,19
392209,2,4,16,7,0,7
392212,2,4,16,4,1,5
392215,2,4,16,17,1,18
392219,2,4,16,9,0,9
392221,2,4,16,5,0,5
392231,2,4,16,2,0,2
392239,2,4,16,2,0,2
419122,2,4,16,6,0,6
419129,2,4,16,7,0,7
419132,2,4,16,9,0,9
419144,2,4,16,12,1,13
419151,2,4,16,7,0,7
419154,2,4,16,7,0,7
501211,2,4,16,13,0,13
501217,2,4,16,11,1,12
501228,2,4,16,14,0,14
501242,2,4,16,12,0,12
501249,2,4,16,6,1,7
501259,2,4,16,4,0,4
501269,2,4,16,3,0,3
548314,2,4,16,10,0,10
548318,2,4,16,5,0,5
548324,2,4,16,11,0,11
548339,2,4,16,1,0,1
548355,2,4,16,14,0,14
548359,2,4,16,7,0,7
548371,2,4,16,11,0,11
548376,2,4,16,5,0,5
598030,2,4,16,12,0,12
598042,2,4,16,9,2,11
598046,2,4,16,11,0,11
598050,2,4,16,8,0,8
598061,2,4,16,3,0,3
598064,2,4,16,10,0,10
598069,2,4,16,15,1,16
729288,2,4,16,16,0,16
729296,2,4,16,11,0,11
729318,2,4,16,4,0,4
734012,2,4,16,6,0,6
734024,2,4,16,12,0,12
734048,2,4,16,5,0,5
829714,2,4,16,9,0,9
829746,2,4,16,17,1,18
829758,2,4,16,4,0,4
829764,2,4,16,12,0,12
829780,2,4,16,4,1,5
829804,2,4,16,10,2,12
980924,2,4,16,6,0,6
980946,2,4,16,12,0,12
980968,2,4,16,4,1,5
980982,2,4,16,13,0,13
980990,2,4,16,8,1,9
1082594,2,4,16,15,0,15
1082605,2,4,16,9,0,9
1082609,2,4,16,21,0,21
1082623,2,4,16,7,1,8
335989,1,5,16,10,0,10
336005,1,5,16,12,2,14
336013,1,5,16,1,0,1
336028,1,5,16,8,0,8
336038,1,5,16,7,0,7
336043,1,5,16,12,1,13
392195,1,5,16,4,0,4
392215,1,5,16,17,0,17
392222,1,5,16,2,0,2
392230,1,5,16,3,0,3
392238,1,5,16,5,0,5
419116,1,5,16,17,0,17
419120,1,5,16,2,0,2
419123,1,5,16,11,0,11
419129,1,5,16,11,0,11
419134,1,5,16,6,0,6
419146,1,5,16,1,1,2
419159,1,5,16,5,0,5
419163,1,5,16,3,0,3
501214,1,5,16,14,0,14
501219,1,5,16,1,0,1
501245,1,5,16,5,0,5
501257,1,5,16,7,0,7
501263,1,5,16,3,0,3
548314,1,5,16,11,0,11
548317,1,5,16,9,0,9
548325,1,5,16,15,1,16
548329,1,5,16,20,1,21
548337,1,5,16,9,0,9
548354,1,5,16,11,0,11
548359,1,5,16,7,0,7
548366,1,5,16,4,0,4
548370,1,5,16,9,1,10
548378,1,5,16,3,0,3
548382,1,5,16,13,1,14
598006,1,5,16,15,0,15
598010,1,5,16,1,0,1
598014,1,5,16,4,0,4
598024,1,5,16,7,0,7
598028,1,5,16,7,0,7
598031,1,5,16,5,2,7
598048,1,5,16,6,0,6
598077,1,5,16,6,0,6
729296,1,5,16,3,0,3
729320,1,5,16,12,0,12
733984,1,5,16,19,0,19
734008,1,5,16,5,1,6
734016,1,5,16,15,1,16
734046,1,5,16,7,0,7
829714,1,5,16,4,1,5
829746,1,5,16,6,0,6
829754,1,5,16,9,0,9
829782,1,5,16,15,1,16
829816,1,5,16,4,1,5
335992,2,5,16,10,0,10
335995,2,5,16,17,0,17
335997,2,5,16,9,0,9
336016,2,5,16,12,0,12
336020,2,5,16,18,0,18
336024,2,5,16,6,0,6
336032,2,5,16,6,0,6
336041,2,5,16,7,0,7
336045,2,5,16,13,0,13
392187,2,5,16,0,0,0
392200,2,5,16,4,0,4
392203,2,5,16,13,0,13
392207,2,5,16,6,0,6
392210,2,5,16,15,0,15
392225,2,5,16,3,0,3
392235,2,5,16,6,0,6
419112,2,5,16,11,0,11
419131,2,5,16,12,0,12
419139,2,5,16,4,0,4
419142,2,5,16,6,2,8
419155,2,5,16,2,0,2
501204,2,5,16,13,0,13
501209,2,5,16,3,0,3
501225,2,5,16,5,0,5
501236,2,5,16,6,1,7
501240,2,5,16,17,0,17
501254,2,5,16,5,0,5
548322,2,5,16,10,0,10
548331,2,5,16,8,0,8
548341,2,5,16,6,1,7
548350,2,5,16,9,0,9
548363,2,5,16,9,0,9
598019,2,5,16,7,0,7
598037,2,5,16,15,0,15
598041,2,5,16,10,0,10
598052,2,5,16,8,0,8
598054,2,5,16,7,0,7
598057,2,5,16,9,3,12
598063,2,5,16,3,0,3
598068,2,5,16,16,0,16
598070,2,5,16,2,0,2
598076,2,5,16,3,0,3
729290,2,5,16,6,0,6
729302,2,5,16,4,1,5
733980,2,5,16,9,0,9
733994,2,5,16,2,1,3
734004,2,5,16,4,0,4
734022,2,5,16,6,0,6
734038,2,5,16,11,0,11
829720,2,5,16,11,0,11
829726,2,5,16,11,2,13
829732,2,5,16,5,0,5
829740,2,5,16,6,0,6
829774,2,5,16,13,0,13
829792,2,5,16,9,0,9
829802,2,5,16,14,0,14
829824,2,5,16,3,0,3
336000,1,6,16,14,1,15
336003,1,6,16,8,0,8
336014,1,6,16,5,1,6
336020,1,6,16,4,1,5
336025,1,6,16,6,2,8
392194,1,6,16,11,0,11
392203,1,6,16,7,0,7
392228,1,6,16,10,0,10
392231,1,6,16,6,1,7
392235,1,6,16,4,0,4
392237,1,6,16,11,0,11
392242,1,6,16,11,0,11
419121,1,6,16,5,0,5
419133,1,6,16,6,0,6
419136,1,6,16,4,0,4
419139,1,6,16,11,0,11
419145,1,6,16,12,1,13
419154,1,6,16,5,2,7
501206,1,6,16,1,0,1
501209,1,6,16,17,0,17
501228,1,6,16,7,0,7
501232,1,6,16,7,0,7
501238,1,6,16,16,2,18
501243,1,6,16,10,0,10
548347,1,6,16,4,0,4
548350,1,6,16,8,1,9
548362,1,6,16,6,0,6
548369,1,6,16,6,0,6
598003,1,6,16,2,0,2
598015,1,6,16,4,0,4
598022,1,6,16,11,0,11
598040,1,6,16,9,1,10
598049,1,6,16,2,0,2
598054,1,6,16,3,0,3
598064,1,6,16,1,2,3
729286,1,6,16,11,0,11
733980,1,6,16,9,0,9
733986,1,6,16,6,2,8
733990,1,6,16,3,0,3
733998,1,6,16,7,0,7
734024,1,6,16,13,0,13
734044,1,6,16,4,0,4
829720,1,6,16,17,0,17
829736,1,6,16,11,0,11
829744,1,6,16,2,0,2
829752,1,6,16,15,0,15
829762,1,6,16,4,1,5
829788,1,6,16,11,0,11
829818,1,6,16,3,0,3
980908,1,6,16,0,0,0
980938,1,6,16,8,0,8
980956,1,6,16,10,1,11
980970,1,6,16,18,0,18
981002,1,6,16,4,0,4
981016,1,6,16,9,0,9
1082599,1,6,16,6,0,6
1082605,1,6,16,9,2,11
1082608,1,6,16,9,0,9
1082622,1,6,16,9,0,9
1082626,1,6,16,3,2,5
1082642,1,6,16,6,0,6
335989,2,6,16,4,0,4
336006,2,6,16,5,0,5
336009,2,6,16,5,0,5
336022,2,6,16,4,0,4
336031,2,6,16,6,0,6
336037,2,6,16,7,0,7
336043,2,6,16,5,0,5
392199,2,6,16,8,0,8
392206,2,6,16,8,2,10
392211,2,6,16,7,0,7
392216,2,6,16,9,0,9
392220,2,6,16,19,0,19
392224,2,6,16,10,0,10
392240,2,6,16,2,0,2
419113,2,6,16,9,0,9
419116,2,6,16,1,0,1
419119,2,6,16,1,0,1
419125,2,6,16,15,0,15
419149,2,6,16,7,0,7
419157,2,6,16,5,0,5
419160,2,6,16,10,0,10
419165,2,6,16,13,0,13
501218,2,6,16,12,0,12
501221,2,6,16,5,0,5
501235,2,6,16,11,2,13
501248,2,6,16,3,0,3
501251,2,6,16,15,0,15
501258,2,6,16,10,0,10
501262,2,6,16,5,0,5
548315,2,6,16,14,0,14
548326,2,6,16,6,0,6
548334,2,6,16,16,0,16
548338,2,6,16,8,0,8
548342,2,6,16,14,0,14
548354,2,6,16,10,0,10
548374,2,6,16,0,0,0
548377,2,6,16,9,0,9
548379,2,6,16,11,0,11
548383,2,6,16,8,0,8
548385,2,6,16,8,0,8
598006,2,6,16,11,0,11
598011,2,6,16,6,0,6
598025,2,6,16,2,0,2
598029,2,6,16,8,0,8
598033,2,6,16,11,0,11
598045,2,6,16,14,0,14
598059,2,6,16,6,0,6
598067,2,6,16,7,0,7
598072,2,6,16,11,1,12
729294,2,6,16,4,0,4
729298,2,6,16,2,0,2
729306,2,6,16,10,0,10
729314,2,6,16,2,0,2
734010,2,6,16,4,0,4
734016,2,6,16,4,2,6
734036,2,6,16,11,0,11
829712,2,6,16,8,0,8
829730,2,6,16,15,0,15
829766,2,6,16,7,0,7
829782,2,6,16,6,0,6
829798,2,6,16,21,1,22
829806,2,6,16,17,0,17
980926,2,6,16,12,0,12
980950,2,6,16,7,0,7
980966,2,6,16,8,1,9
980976,2,6,16,5,1,6
980988,2,6,16,3,0,3
980998,2,6,16,2,1,3
981008,2,6,16,9,1,10
1082595,2,6,16,8,0,8
1082611,2,6,16,8,0,8
1082614,2,6,16,5,1,6
1082630,2,6,16,6,0,6
1082632,2,6,16,7,0,7
1082640,2,6,16,14,0,14
1082646,2,6,16,9,0,9
335990,1,7,16,12,1,13
335999,1,7,16,14,1,15
336009,1,7,16,6,0,6
336029,1,7,16,14,0,14
336037,1,7,16,5,0,5
336041,1,7,16,7,2,9
392186,1,7,16,6,1,7
392202,1,7,16,4,0,4
392208,1,7,16,7,2,9
392213,1,7,16,8,0,8
392220,1,7,16,15,1,16
392223,1,7,16,10,0,10
392232,1,7,16,9,0,9
392240,1,7,16,10,0,10
419112,1,7,16,11,0,11
419119,1,7,16,9,0,9
419124,1,7,16,5,1,6
419135,1,7,16,10,0,10
419143,1,7,16,11,0,11
419151,1,7,16,9,0,9
419155,1,7,16,9,0,9
419157,1,7,16,15,1,16
419162,1,7,16,4,0,4
419166,1,7,16,8,0,8
419167,1,7,16,17,0,17
501215,1,7,16,18,2,20
501226,1,7,16,17,0,17
501229,1,7,16,11,1,12
501236,1,7,16,4,0,4
501242,1,7,16,10,1,11
501246,1,7,16,16,0,16
501251,1,7,16,12,0,12
501268,1,7,16,5,0,5
548322,1,7,16,11,0,11
548330,1,7,16,0,1,1
548339,1,7,16,3,0,3
548356,1,7,16,1,0,1
548365,1,7,16,6,0,6
548368,1,7,16,7,0,7
598007,1,7,16,7,0,7
598011,1,7,16,9,2,11
598016,1,7,16,2,1,3
598029,1,7,16,11,0,11
598038,1,7,16,7,1,8
598042,1,7,16,12,0,12
598044,1,7,16,6,0,6
598051,1,7,16,8,0,8
598055,1,7,16,13,0,13
598068,1,7,16,6,1,7
598078,1,7,16,6,0,6
729292,1,7,16,6,0,6
729308,1,7,16,5,0,5
729314,1,7,16,11,0,11
733988,1,7,16,10,0,10
734000,1,7,16,12,0,12
734014,1,7,16,15,1,16
734022,1,7,16,12,0,12
734036,1,7,16,4,0,4
734050,1,7,16,13,0,13
829710,1,7,16,8,0,8
829726,1,7,16,16,0,16
829734,1,7,16,6,0,6
829742,1,7,16,18,1,19
829756,1,7,16,9,0,9
829774,1,7,16,6,0,6
829780,1,7,16,13,0,13
829810,1,7,16,11,2,13
829822,1,7,16,4,0,4
829828,1,7,16,4,0,4
980906,1,7,16,7,0,7
980922,1,7,16,6,0,6
980928,1,7,16,7,0,7
980946,1,7,16,16,0,16
980990,1,7,16,17,0,17
980998,1,7,16,17,0,17
981012,1,7,16,11,0,11
1082592,1,7,16,7,0,7
1082614,1,7,16,7,1,8
1082635,1,7,16,6,1,7
1082638,1,7,16,9,2,11
1082644,1,7,16,12,0,12
1082650,1,7,16,5,0,5
335994,2,7,16,13,0,13
335996,2,7,16,4,0,4
336002,2,7,16,11,0,11
336013,2,7,16,0,2,2
336017,2,7,16,9,0,9
336033,2,7,16,11,1,12
392197,2,7,16,11,0,11
392202,2,7,16,0,0,0
392205,2,7,16,6,1,7
392217,2,7,16,2,1,3
392227,2,7,16,2,2,4
392230,2,7,16,5,4,9
419119,2,7,16,0,0,0
419127,2,7,16,7,0,7
419130,2,7,16,19,0,19
419137,2,7,16,3,2,5
419147,2,7,16,8,3,11
419170,2,7,16,7,1,8
501206,2,7,16,5,0,5
501210,2,7,16,6,0,6
501223,2,7,16,6,0,6
501261,2,7,16,7,0,7
501272,2,7,16,13,0,13
501274,2,7,16,3,0,3
501275,2,7,16,8,0,8
548311,2,7,16,3,1,4
548313,2,7,16,3,0,3
548319,2,7,16,9,0,9
548344,2,7,16,10,1,11
548347,2,7,16,3,0,3
548351,2,7,16,4,0,4
548360,2,7,16,5,0,5
548372,2,7,16,7,2,9
548375,2,7,16,10,0,10
548382,2,7,16,8,1,9
548384,2,7,16,4,1,5
598004,2,7,16,10,0,10
598024,2,7,16,12,0,12
598034,2,7,16,8,0,8
598060,2,7,16,10,0,10
598065,2,7,16,3,1,4
598071,2,7,16,5,5,10
598075,2,7,16,2,0,2
598077,2,7,16,3,0,3
729284,2,7,16,11,0,11
729322,2,7,16,8,1,9
733978,2,7,16,5,1,6
734006,2,7,16,7,0,7
734030,2,7,16,8,1,9
829722,2,7,16,17,0,17
829752,2,7,16,11,0,11
829788,2,7,16,9,2,11
829794,2,7,16,7,0,7
829800,2,7,16,16,0,16
980914,2,7,16,18,0,18
980932,2,7,16,14,1,15
980938,2,7,16,4,0,4
980952,2,7,16,21,2,23
980962,2,7,16,12,0,12
980978,2,7,16,6,1,7
980986,2,7,16,9,2,11
1082597,2,7,16,4,0,4
1082600,2,7,16,13,0,13
1082602,2,7,16,16,3,19
1082606,2,7,16,9,0,9
1082612,2,7,16,8,0,8
1082618,2,7,16,9,0,9
1082625,2,7,16,9,0,9
1082628,2,7,16,9,2,11
1082641,2,7,16,26,1,27
1082647,2,7,16,3,1,4
335991,1,8,16,4,1,5
335993,1,8,16,8,1,9
335995,1,8,16,12,0,12
336004,1,8,16,8,0,8
336007,1,8,16,8,0,8
336016,1,8,16,2,0,2
336036,1,8,16,11,0,11
336042,1,8,16,10,1,11
392193,1,8,16,10,0,10
392197,1,8,16,5,0,5
392206,1,8,16,7,2,9
392210,1,8,16,7,0,7
392217,1,8,16,3,1,4
392221,1,8,16,11,2,13
392225,1,8,16,10,0,10
392244,1,8,16,8,0,8
419115,1,8,16,10,2,12
419122,1,8,16,9,0,9
419125,1,8,16,9,0,9
419131,1,8,16,4,1,5
419156,1,8,16,11,2,13
419165,1,8,16,4,0,4
419169,1,8,16,3,0,3
501204,1,8,16,15,0,15
501213,1,8,16,16,0,16
501217,1,8,16,8,1,9
501221,1,8,16,4,0,4
501234,1,8,16,14,1,15
501248,1,8,16,9,0,9
501255,1,8,16,7,0,7
501261,1,8,16,6,1,7
501269,1,8,16,11,0,11
548319,1,8,16,11,2,13
548326,1,8,16,5,0,5
548331,1,8,16,9,4,13
548334,1,8,16,13,0,13
548340,1,8,16,4,0,4
548346,1,8,16,19,0,19
548351,1,8,16,5,0,5
548353,1,8,16,12,0,12
548361,1,8,16,9,0,9
548371,1,8,16,10,1,11
548381,1,8,16,8,1,9
336012,2,8,16,10,0,10
336019,2,8,16,12,0,12
336025,2,8,16,9,0,9
336029,2,8,16,8,0,8
336039,2,8,16,3,0,3
392201,2,8,16,2,0,2
392228,2,8,16,11,0,11
392233,2,8,16,8,0,8
392234,2,8,16,4,0,4
392241,2,8,16,6,0,6
392242,2,8,16,2,0,2
419111,2,8,16,6,0,6
419135,2,8,16,7,0,7
419140,2,8,16,3,0,3
419143,2,8,16,9,1,10
419146,2,8,16,4,0,4
419150,2,8,16,11,0,11
419152,2,8,16,4,1,5
419161,2,8,16,7,2,9
419168,2,8,16,3,0,3
501208,2,8,16,11,1,12
501229,2,8,16,1,0,1
501241,2,8,16,4,0,4
501244,2,8,16,10,1,11
501264,2,8,16,3,1,4
548316,2,8,16,16,0,16
548357,2,8,16,4,0,4
548364,2,8,16,11,0,11
548378,2,8,16,5,0,5
501205,1,9,16,2,0,2
501212,1,9,16,2,0,2
501224,1,9,16,5,1,6
501230,1,9,16,2,0,2
501247,1,9,16,4,0,4
501252,1,9,16,6,0,6
501259,1,9,16,9,0,9
501215,2,9,16,9,0,9
501234,2,9,16,1,0,1
501238,2,9,16,7,0,7
501266,2,9,16,5,0,5
501218,1,10,16,13,0,13
501223,1,10,16,11,0,11
501233,1,10,16,10,0,10
501240,1,10,16,6,0,6
501264,1,10,16,6,1,7
501267,1,10,16,5,1,6
548313,1,10,16,9,0,9
548318,1,10,16,8,0,8
548324,1,10,16,3,0,3
548332,1,10,16,7,0,7
548338,1,10,16,11,0,11
548342,1,10,16,4,0,4
548363,1,10,16,8,0,8
598008,1,10,16,13,1,14
598020,1,10,16,12,0,12
598030,1,10,16,4,0,4
598052,1,10,16,8,0,8
598060,1,10,16,5,1,6
598066,1,10,16,4,0,4
598072,1,10,16,14,0,14
501212,2,10,16,3,1,4
501231,2,10,16,5,0,5
501237,2,10,16,19,0,19
501246,2,10,16,5,1,6
501253,2,10,16,1,2,3
501255,2,10,16,7,0,7
548327,2,10,16,10,1,11
548335,2,10,16,11,6,17
548346,2,10,16,10,0,10
548353,2,10,16,9,0,9
548356,2,10,16,9,0,9
548358,2,10,16,7,0,7
548367,2,10,16,4,0,4
548370,2,10,16,8,0,8
548380,2,10,16,5,0,5
598005,2,10,16,6,0,6
598014,2,10,16,11,0,11
598016,2,10,16,3,0,3
598023,2,10,16,8,0,8
598032,2,10,16,8,0,8
598040,2,10,16,8,1,9
598043,2,10,16,2,1,3
598047,2,10,16,21,0,21
598058,2,10,16,15,0,15
598005,1,11,16,5,0,5
598023,1,11,16,5,1,6
598035,1,11,16,4,0,4
598037,1,11,16,6,1,7
598053,1,11,16,18,0,18
598061,1,11,16,6,0,6
598065,1,11,16,14,0,14
598070,1,11,16,14,0,14
598076,1,11,16,10,1,11
729290,1,11,16,9,0,9
729306,1,11,16,10,0,10
729316,1,11,16,3,1,4
729322,1,11,16,12,1,13
733982,1,11,16,8,1,9
733994,1,11,16,3,1,4
734006,1,11,16,9,0,9
734012,1,11,16,11,0,11
734020,1,11,16,5,0,5
734042,1,11,16,3,1,4
829732,1,11,16,5,0,5
829748,1,11,16,10,0,10
829764,1,11,16,10,0,10
829778,1,11,16,12,1,13
829792,1,11,16,18,0,18
829798,1,11,16,15,0,15
829804,1,11,16,6,1,7
829820,1,11,16,5,0,5
980920,1,11,16,11,0,11
980948,1,11,16,6,0,6
980958,1,11,16,12,0,12
980978,1,11,16,12,2,14
980984,1,11,16,3,0,3
980988,1,11,16,4,1,5
981008,1,11,16,5,0,5
981020,1,11,16,15,0,15
981024,1,11,16,7,0,7
1082591,1,11,16,4,0,4
1082600,1,11,16,6,2,8
1082609,1,11,16,6,1,7
1082611,1,11,16,13,0,13
1082615,1,11,16,8,1,9
1082623,1,11,16,5,0,5
1082627,1,11,16,15,0,15
1082630,1,11,16,11,1,12
1082648,1,11,16,2,3,5
598009,2,11,16,8,0,8
598015,2,11,16,13,0,13
598018,2,11,16,6,0,6
598026,2,11,16,6,4,10
598044,2,11,16,12,1,13
598056,2,11,16,2,0,2
598074,2,11,16,2,0,2
729300,2,11,16,9,0,9
734026,2,11,16,9,1,10
734034,2,11,16,9,0,9
829716,2,11,16,17,0,17
829724,2,11,16,5,0,5
829736,2,11,16,10,0,10
829756,2,11,16,10,0,10
829786,2,11,16,4,0,4
980912,2,11,16,8,0,8
980928,2,11,16,14,0,14
980940,2,11,16,10,0,10
980972,2,11,16,7,0,7
980996,2,11,16,9,0,9
981014,2,11,16,4,2,6
981022,2,11,16,2,0,2
1082596,2,11,16,9,0,9
1082604,2,11,16,3,0,3
1082634,2,11,16,7,0,7
1082638,2,11,16,8,0,8
1082643,2,11,16,8,0,8
980916,1,12,16,13,0,13
980924,1,12,16,7,0,7
980944,1,12,16,8,0,8
980954,1,12,16,9,0,9
980962,1,12,16,3,1,4
980974,1,12,16,8,0,8
980994,1,12,16,2,0,2
1082594,1,12,16,15,0,15
1082603,1,12,16,9,0,9
1082607,1,12,16,10,0,10
1082618,1,12,16,6,0,6
1082620,1,12,16,11,0,11
1082624,1,12,16,4,0,4
1082634,1,12,16,5,0,5
1082647,1,12,16,5,0,5
980936,2,12,16,5,1,6
980970,2,12,16,3,1,4
980984,2,12,16,9,1,10
981010,2,12,16,16,0,16
1082592,2,12,16,9,0,9
1082599,2,12,16,2,0,2
1082615,2,12,16,6,0,6
1082629,2,12,16,14,2,16
1082631,2,12,16,5,0,5
1082642,2,12,16,8,1,9
1082650,2,12,16,14,0,14
980934,1,13,16,7,2,9
980950,1,13,16,2,0,2
980966,1,13,16,11,0,11
980972,1,13,16,8,0,8
981018,1,13,16,3,1,4
981022,1,13,16,11,0,11
1082593,1,13,16,5,0,5
1082596,1,13,16,8,0,8
1082606,1,13,16,5,1,6
1082625,1,13,16,2,0,2
1082629,1,13,16,5,0,5
1082632,1,13,16,6,1,7
1082640,1,13,16,10,4,14
1082643,1,13,16,8,0,8
980910,2,13,16,7,1,8
980916,2,13,16,15,0,15
980922,2,13,16,10,0,10
980942,2,13,16,6,0,6
980954,2,13,16,14,0,14
980960,2,13,16,12,0,12
980980,2,13,16,16,0,16
980992,2,13,16,1,0,1
981012,2,13,16,9,1,10
1082603,2,13,16,13,0,13
1082610,2,13,16,7,0,7
1082613,2,13,16,9,0,9
1082616,2,13,16,6,1,7
1082637,2,13,16,10,0,10
335987,1,1,17,14,0,14
335998,1,1,17,10,1,11
336002,1,1,17,10,1,11
336019,1,1,17,19,0,19
336022,1,1,17,4,1,5
336030,1,1,17,4,0,4
336032,1,1,17,10,0,10
392189,1,1,17,8,0,8
392204,1,1,17,5,1,6
392212,1,1,17,8,0,8
392216,1,1,17,17,0,17
392224,1,1,17,6,0,6
392226,1,1,17,20,0,20
392233,1,1,17,6,1,7
419111,1,1,17,18,0,18
419127,1,1,17,6,1,7
419132,1,1,17,9,2,11
419140,1,1,17,18,3,21
419144,1,1,17,6,0,6
419149,1,1,17,9,0,9
419153,1,1,17,3,0,3
419158,1,1,17,14,0,14
501208,1,1,17,5,1,6
501227,1,1,17,8,2,10
501235,1,1,17,7,1,8
501244,1,1,17,13,1,14
501272,1,1,17,11,2,13
501274,1,1,17,11,0,11
548320,1,1,17,7,0,7
548349,1,1,17,16,0,16
548358,1,1,17,2,0,2
548373,1,1,17,5,0,5
548375,1,1,17,11,1,12
548380,1,1,17,6,0,6
548383,1,1,17,9,0,9
598013,1,1,17,6,1,7
598018,1,1,17,12,1,13
598027,1,1,17,9,0,9
598034,1,1,17,7,1,8
598045,1,1,17,15,0,15
598058,1,1,17,17,0,17
598074,1,1,17,5,0,5
729284,1,1,17,6,4,10
729294,1,1,17,8,0,8
729304,1,1,17,16,0,16
734032,1,1,17,8,1,9
734048,1,1,17,14,0,14
829718,1,1,17,6,0,6
829766,1,1,17,11,5,16
829786,1,1,17,10,1,11
980914,1,1,17,12,0,12
980952,1,1,17,13,0,13
980968,1,1,17,10,0,10
980980,1,1,17,10,1,11
981000,1,1,17,8,0,8
981006,1,1,17,10,0,10
981014,1,1,17,9,0,9
1082597,1,1,17,5,0,5
1082604,1,1,17,14,0,14
1082613,1,1,17,5,0,5
1082617,1,1,17,6,0,6
1082631,1,1,17,1,0,1
1082649,1,1,17,7,2,9
335991,2,1,17,3,0,3
336005,2,1,17,6,1,7
336008,2,1,17,11,0,11
336040,2,1,17,18,0,18
392195,2,1,17,8,0,8
392208,2,1,17,6,1,7
392236,2,1,17,14,0,14
392238,2,1,17,5,1,6
419114,2,1,17,8,0,8
419118,2,1,17,3,0,3
419123,2,1,17,8,0,8
419136,2,1,17,7,1,8
419163,2,1,17,1,0,1
419166,2,1,17,6,5,11
501203,2,1,17,3,0,3
501214,2,1,17,10,0,10
501224,2,1,17,2,1,3
501239,2,1,17,2,0,2
501247,2,1,17,13,0,13
501267,2,1,17,2,0,2
548317,2,1,17,13,1,14
548325,2,1,17,6,0,6
548328,2,1,17,12,0,12
548333,2,1,17,10,0,10
548340,2,1,17,6,0,6
548352,2,1,17,6,0,6
548362,2,1,17,5,7,12
548368,2,1,17,7,0,7
548386,2,1,17,12,0,12
598003,2,1,17,5,3,8
598010,2,1,17,5,0,5
598021,2,1,17,6,0,6
598036,2,1,17,7,1,8
598039,2,1,17,12,1,13
598048,2,1,17,8,0,8
598055,2,1,17,3,0,3
598062,2,1,17,14,1,15
598066,2,1,17,7,0,7
729312,2,1,17,9,1,10
729320,2,1,17,14,1,15
733976,2,1,17,4,0,4
733984,2,1,17,6,0,6
733990,2,1,17,13,0,13
734002,2,1,17,8,0,8
734014,2,1,17,11,1,12
734020,2,1,17,6,0,6
734028,2,1,17,17,0,17
734054,2,1,17,17,1,18
829710,2,1,17,19,1,20
829728,2,1,17,15,0,15
829738,2,1,17,13,0,13
829744,2,1,17,5,0,5
829770,2,1,17,5,1,6
829796,2,1,17,5,0,5
829810,2,1,17,14,0,14
829816,2,1,17,4,2,6
980920,2,1,17,5,0,5
980930,2,1,17,12,1,13
980944,2,1,17,14,3,17
980956,2,1,17,15,0,15
980964,2,1,17,24,0,24
981020,2,1,17,7,1,8
1082601,2,1,17,7,0,7
1082608,2,1,17,6,0,6
1082620,2,1,17,5,0,5
1082622,2,1,17,4,1,5
1082627,2,1,17,8,0,8
1082639,2,1,17,7,0,7
1082644,2,1,17,13,1,14
335997,1,2,17,4,0,4
336011,1,2,17,13,0,13
336017,1,2,17,8,3,11
336021,1,2,17,5,0,5
336031,1,2,17,14,0,14
336034,1,2,17,11,0,11
336039,1,2,17,4,0,4
392187,1,2,17,10,0,10
392196,1,2,17,4,1,5
392199,1,2,17,10,0,10
392209,1,2,17,8,0,8
392218,1,2,17,10,0,10
392241,1,2,17,2,0,2
419114,1,2,17,9,0,9
419128,1,2,17,9,0,9
419138,1,2,17,7,0,7
419150,1,2,17,22,1,23
501210,1,2,17,7,1,8
501237,1,2,17,7,0,7
501249,1,2,17,13,0,13
501273,1,2,17,4,0,4
501275,1,2,17,4,0,4
548315,1,2,17,6,2,8
548323,1,2,17,8,4,12
548341,1,2,17,13,1,14
548355,1,2,17,6,0,6
548367,1,2,17,5,1,6
548372,1,2,17,5,1,6
548377,1,2,17,16,1,17
598004,1,2,17,5,4,9
598009,1,2,17,12,0,12
598017,1,2,17,10,0,10
598032,1,2,17,17,1,18
598041,1,2,17,13,1,14
598047,1,2,17,12,0,12
598050,1,2,17,3,1,4
598059,1,2,17,18,0,18
598062,1,2,17,6,0,6
598069,1,2,17,4,1,5
729318,1,2,17,1,4,5
734004,1,2,17,12,3,15
734010,1,2,17,21,0,21
734026,1,2,17,10,0,10
734040,1,2,17,10,1,11
829724,1,2,17,8,1,9
829768,1,2,17,13,2,15
829790,1,2,17,10,1,11
829800,1,2,17,24,1,25
829824,1,2,17,12,1,13
829826,1,2,17,9,1,10
980912,1,2,17,18,1,19
980926,1,2,17,9,0,9
980932,1,2,17,11,0,11
980936,1,2,17,7,0,7
980942,1,2,17,16,0,16
980964,1,2,17,6,0,6
980982,1,2,17,14,0,14
980986,1,2,17,7,0,7
980992,1,2,17,13,1,14
1082595,1,2,17,8,0,8
1082598,1,2,17,15,1,16
1082602,1,2,17,5,0,5
1082610,1,2,17,6,0,6
1082621,1,2,17,4,1,5
1082628,1,2,17,9,1,10
1082636,1,2,17,7,0,7
1082646,1,2,17,13,1,14
335990,2,2,17,10,0,10
336001,2,2,17,8,0,8
336003,2,2,17,4,0,4
336007,2,2,17,13,1,14
336028,2,2,17,18,0,18
392193,2,2,17,10,1,11
392204,2,2,17,8,0,8
392213,2,2,17,6,1,7
392223,2,2,17,6,1,7
392226,2,2,17,12,0,12
392229,2,2,17,10,1,11
392237,2,2,17,7,0,7
392243,2,2,17,14,1,15
392244,2,2,17,5,0,5
419117,2,2,17,11,0,11
419124,2,2,17,4,0,4
419133,2,2,17,10,0,10
419141,2,2,17,20,5,25
419145,2,2,17,9,0,9
419153,2,2,17,21,0,21
419156,2,2,17,3,1,4
419162,2,2,17,7,1,8
419167,2,2,17,6,0,6
501205,2,2,17,6,0,6
501213,2,2,17,10,0,10
501216,2,2,17,5,0,5
501227,2,2,17,7,0,7
501232,2,2,17,8,2,10
501257,2,2,17,12,0,12
501265,2,2,17,11,0,11
501271,2,2,17,4,0,4
501276,2,2,17,4,0,4
548320,2,2,17,8,0,8
548329,2,2,17,12,0,12
548332,2,2,17,11,0,11
548336,2,2,17,7,1,8
548349,2,2,17,13,0,13
548361,2,2,17,13,0,13
548365,2,2,17,5,0,5
548381,2,2,17,1,0,1
598013,2,2,17,9,1,10
598022,2,2,17,1,0,1
598028,2,2,17,6,0,6
598038,2,2,17,5,1,6
598053,2,2,17,15,1,16
729286,2,2,17,13,1,14
729292,2,2,17,14,0,14
729304,2,2,17,3,0,3
733982,2,2,17,3,0,3
733988,2,2,17,10,0,10
733996,2,2,17,7,0,7
734018,2,2,17,13,1,14
734032,2,2,17,5,0,5
829718,2,2,17,14,1,15
829742,2,2,17,16,0,16
829750,2,2,17,1,0,1
829754,2,2,17,4,0,4
829784,2,2,17,2,1,3
980958,2,2,17,10,0,10
980974,2,2,17,7,0,7
981000,2,2,17,13,0,13
981016,2,2,17,7,0,7
981018,2,2,17,11,1,12
981024,2,2,17,10,0,10
1082591,2,2,17,3,0,3
1082607,2,2,17,13,0,13
1082624,2,2,17,8,0,8
1082633,2,2,17,5,0,5
335988,1,3,17,14,0,14
335994,1,3,17,10,0,10
336001,1,3,17,16,0,16
336006,1,3,17,9,1,10
336010,1,3,17,1,0,1
336012,1,3,17,12,0,12
336018,1,3,17,5,0,5
336023,1,3,17,10,1,11
336045,1,3,17,3,0,3
392190,1,3,17,7,0,7
392201,1,3,17,13,0,13
392207,1,3,17,12,0,12
392211,1,3,17,6,0,6
392214,1,3,17,11,0,11
392219,1,3,17,18,4,22
392229,1,3,17,5,0,5
392236,1,3,17,12,0,12
392239,1,3,17,2,0,2
392243,1,3,17,10,0,10
419118,1,3,17,12,0,12
419130,1,3,17,13,2,15
419142,1,3,17,12,0,12
419147,1,3,17,6,1,7
419152,1,3,17,7,0,7
419160,1,3,17,1,1,2
419168,1,3,17,8,1,9
419170,1,3,17,10,2,12
501203,1,3,17,6,0,6
501211,1,3,17,9,0,9
501216,1,3,17,16,0,16
501220,1,3,17,14,0,14
501231,1,3,17,9,0,9
501241,1,3,17,14,1,15
501250,1,3,17,12,1,13
501254,1,3,17,18,0,18
501258,1,3,17,8,1,9
501266,1,3,17,6,0,6
501271,1,3,17,9,0,9
501276,1,3,17,5,0,5
548311,1,3,17,3,0,3
548316,1,3,17,12,0,12
548321,1,3,17,6,0,6
548327,1,3,17,4,0,4
548335,1,3,17,9,0,9
548352,1,3,17,11,0,11
548357,1,3,17,3,1,4
548360,1,3,17,11,0,11
548376,1,3,17,15,0,15
548384,1,3,17,13,0,13
548385,1,3,17,16,0,16
548386,1,3,17,14,0,14
598025,1,3,17,8,0,8
598039,1,3,17,9,1,10
598043,1,3,17,6,1,7
598046,1,3,17,18,0,18
598056,1,3,17,23,2,25
598063,1,3,17,8,0,8
598067,1,3,17,6,0,6
598075,1,3,17,14,0,14
729288,1,3,17,11,1,12
729298,1,3,17,15,1,16
729302,1,3,17,7,4,11
733976,1,3,17,14,1,15
734018,1,3,17,3,0,3
734028,1,3,17,4,0,4
734034,1,3,17,10,0,10
829712,1,3,17,1,0,1
829716,1,3,17,11,1,12
829728,1,3,17,8,0,8
829740,1,3,17,9,0,9
829750,1,3,17,15,0,15
829758,1,3,17,8,0,8
829770,1,3,17,9,0,9
829784,1,3,17,9,0,9
829794,1,3,17,13,1,14
829802,1,3,17,12,1,13
829806,1,3,17,12,1,13
335998,2,3,17,13,0,13
336014,2,3,17,7,0,7
336034,2,3,17,5,0,5
336038,2,3,17,12,0,12
336042,2,3,17,3,0,3
392186,2,3,17,13,0,13
392194,2,3,17,5,0,5
392207,2,3,17,5,0,5
392222,2,3,17,8,1,9
392232,2,3,17,7,4,11
419115,2,3,17,11,0,11
419121,2,3,17,10,1,11
419126,2,3,17,5,0,5
419128,2,3,17,3,2,5
419134,2,3,17,6,0,6
419138,2,3,17,4,1,5
419164,2,3,17,8,0,8
501226,2,3,17,10,2,12
501233,2,3,17,9,1,10
501245,2,3,17,12,1,13
501273,2,3,17,20,0,20
548323,2,3,17,13,2,15
548337,2,3,17,2,0,2
548348,2,3,17,10,1,11
548366,2,3,17,16,1,17
548373,2,3,17,3,0,3
598007,2,3,17,10,0,10
598012,2,3,17,13,0,13
598017,2,3,17,13,0,13
598020,2,3,17,10,0,10
598027,2,3,17,12,1,13
598031,2,3,17,3,0,3
598035,2,3,17,14,0,14
598078,2,3,17,3,1,4
729308,2,3,17,3,3,6
729316,2,3,17,4,0,4
733986,2,3,17,5,0,5
733992,2,3,17,17,0,17
734000,2,3,17,3,3,6
734008,2,3,17,4,1,5
734040,2,3,17,10,0,10
734050,2,3,17,8,0,8
734052,2,3,17,3,0,3
829734,2,3,17,15,1,16
829778,2,3,17,8,0,8
829814,2,3,17,17,0,17
829822,2,3,17,12,0,12
829826,2,3,17,4,3,7
829828,2,3,17,7,0,7
335992,1,4,17,8,0,8
335996,1,4,17,6,0,6
336008,1,4,17,11,1,12
336024,1,4,17,23,2,25
336033,1,4,17,4,5,9
336040,1,4,17,7,0,7
336044,1,4,17,6,0,6
392191,1,4,17,7,0,7
392200,1,4,17,2,2,4
392205,1,4,17,1,4,5
392227,1,4,17,3,1,4
392234,1,4,17,11,0,11
419113,1,4,17,2,5,7
419117,1,4,17,13,1,14
419126,1,4,17,7,0,7
419137,1,4,17,8,1,9
419141,1,4,17,6,2,8
419148,1,4,17,2,0,2
419161,1,4,17,20,1,21
419164,1,4,17,7,0,7
501207,1,4,17,4,0,4
501225,1,4,17,3,0,3
501239,1,4,17,7,0,7
501253,1,4,17,7,0,7
501256,1,4,17,14,0,14
501262,1,4,17,7,0,7
501265,1,4,17,7,1,8
548328,1,4,17,3,0,3
548333,1,4,17,6,1,7
548336,1,4,17,12,1,13
548344,1,4,17,8,0,8
548348,1,4,17,8,0,8
548364,1,4,17,3,0,3
548374,1,4,17,11,0,11
548379,1,4,17,21,1,22
598012,1,4,17,8,0,8
598019,1,4,17,8,0,8
598021,1,4,17,3,0,3
598026,1,4,17,3,0,3
598033,1,4,17,11,0,11
598036,1,4,17,5,1,6
598057,1,4,17,7,0,7
598071,1,4,17,13,0,13
729300,1,4,17,7,0,7
729312,1,4,17,4,0,4
733978,1,4,17,9,0,9
733992,1,4,17,6,2,8
733996,1,4,17,7,0,7
734002,1,4,17,4,0,4
734030,1,4,17,7,0,7
734038,1,4,17,6,1,7
734052,1,4,17,17,0,17
734054,1,4,17,15,4,19
829722,1,4,17,10,0,10
829730,1,4,17,5,1,6
829738,1,4,17,14,0,14
829772,1,4,17,5,0,5
829796,1,4,17,8,0,8
829814,1,4,17,6,0,6
980910,1,4,17,5,1,6
980918,1,4,17,4,1,5
980930,1,4,17,6,0,6
980940,1,4,17,9,1,10
980960,1,4,17,14,0,14
980976,1,4,17,12,0,12
980996,1,4,17,14,0,14
981010,1,4,17,16,0,16
1082601,1,4,17,7,0,7
1082612,1,4,17,3,1,4
1082616,1,4,17,8,1,9
1082633,1,4,17,11,0,11
1082637,1,4,17,17,0,17
1082639,1,4,17,6,0,6
1082641,1,4,17,8,0,8
335988,2,4,17,9,1,10
336000,2,4,17,9,0,9
336004,2,4,17,8,0,8
336011,2,4,17,7,0,7
336018,2,4,17,8,0,8
336036,2,4,17,9,1,10
392196,2,4,17,13,0,13
392209,2,4,17,13,1,14
392212,2,4,17,8,0,8
392215,2,4,17,6,0,6
392219,2,4,17,4,2,6
392221,2,4,17,16,0,16
392231,2,4,17,3,0,3
392239,2,4,17,7,1,8
419122,2,4,17,21,0,21
419129,2,4,17,4,0,4
419132,2,4,17,11,0,11
419144,2,4,17,19,0,19
419151,2,4,17,8,1,9
419154,2,4,17,13,0,13
501211,2,4,17,17,0,17
501217,2,4,17,5,0,5
501228,2,4,17,14,1,15
501242,2,4,17,3,1,4
501249,2,4,17,5,0,5
501259,2,4,17,11,1,12
501269,2,4,17,1,1,2
548314,2,4,17,4,1,5
548318,2,4,17,4,0,4
548324,2,4,17,10,0,10
548339,2,4,17,10,0,10
548355,2,4,17,1,0,1
548359,2,4,17,12,0,12
548371,2,4,17,9,0,9
548376,2,4,17,4,0,4
598030,2,4,17,8,0,8
598042,2,4,17,9,0,9
598046,2,4,17,12,0,12
598050,2,4,17,14,0,14
598061,2,4,17,5,1,6
598064,2,4,17,10,0,10
598069,2,4,17,17,1,18
729288,2,4,17,18,0,18
729296,2,4,17,11,1,12
729318,2,4,17,5,0,5
734012,2,4,17,5,0,5
734024,2,4,17,5,0,5
734048,2,4,17,12,0,12
829714,2,4,17,5,0,5
829746,2,4,17,14,0,14
829758,2,4,17,4,2,6
829764,2,4,17,11,0,11
829780,2,4,17,6,0,6
829804,2,4,17,13,0,13
980924,2,4,17,13,0,13
980946,2,4,17,6,0,6
980968,2,4,17,8,0,8
980982,2,4,17,3,0,3
980990,2,4,17,8,0,8
1082594,2,4,17,1,1,2
1082605,2,4,17,12,0,12
1082609,2,4,17,7,0,7
1082623,2,4,17,12,0,12
335989,1,5,17,4,0,4
336005,1,5,17,7,1,8
336013,1,5,17,0,0,0
336028,1,5,17,16,0,16
336038,1,5,17,12,0,12
336043,1,5,17,9,0,9
392195,1,5,17,8,0,8
392215,1,5,17,11,0,11
392222,1,5,17,9,0,9
392230,1,5,17,3,1,4
392238,1,5,17,7,0,7
419116,1,5,17,6,0,6
419120,1,5,17,4,1,5
419123,1,5,17,7,0,7
419129,1,5,17,1,2,3
419134,1,5,17,15,0,15
419146,1,5,17,6,0,6
419159,1,5,17,12,0,12
419163,1,5,17,8,0,8
501214,1,5,17,8,1,9
501245,1,5,17,7,1,8
501257,1,5,17,5,0,5
501263,1,5,17,1,0,1
548314,1,5,17,14,4,18
548317,1,5,17,2,0,2
548325,1,5,17,8,0,8
548329,1,5,17,24,0,24
548337,1,5,17,13,0,13
548354,1,5,17,7,1,8
548359,1,5,17,8,0,8
548366,1,5,17,4,0,4
548370,1,5,17,9,0,9
548378,1,5,17,11,0,11
548382,1,5,17,14,2,16
598006,1,5,17,7,0,7
598010,1,5,17,4,1,5
598014,1,5,17,6,0,6
598024,1,5,17,11,1,12
598028,1,5,17,2,0,2
598031,1,5,17,16,2,18
598048,1,5,17,7,0,7
598077,1,5,17,9,0,9
729296,1,5,17,13,0,13
729320,1,5,17,9,0,9
733984,1,5,17,3,1,4
734008,1,5,17,8,1,9
734016,1,5,17,9,1,10
734046,1,5,17,2,0,2
829714,1,5,17,13,0,13
829746,1,5,17,12,0,12
829754,1,5,17,10,0,10
829782,1,5,17,19,0,19
829816,1,5,17,17,1,18
335992,2,5,17,2,0,2
335995,2,5,17,10,0,10
335997,2,5,17,4,0,4
336020,2,5,17,6,0,6
336024,2,5,17,14,1,15
336032,2,5,17,14,2,16
336041,2,5,17,6,0,6
336045,2,5,17,14,0,14
392200,2,5,17,9,1,10
392203,2,5,17,17,1,18
392207,2,5,17,1,0,1
392210,2,5,17,11,1,12
392225,2,5,17,2,0,2
392235,2,5,17,7,1,8
419112,2,5,17,19,0,19
419139,2,5,17,8,0,8
419142,2,5,17,8,1,9
419155,2,5,17,13,0,13
501204,2,5,17,2,0,2
501209,2,5,17,12,0,12
501225,2,5,17,6,0,6
501236,2,5,17,7,1,8
501240,2,5,17,6,0,6
501254,2,5,17,6,0,6
548322,2,5,17,11,0,11
548331,2,5,17,17,0,17
548341,2,5,17,11,0,11
548350,2,5,17,11,0,11
548363,2,5,17,5,0,5
598019,2,5,17,7,0,7
598037,2,5,17,6,0,6
598041,2,5,17,12,0,12
598052,2,5,17,14,0,14
598054,2,5,17,17,0,17
598057,2,5,17,13,0,13
598063,2,5,17,5,0,5
598068,2,5,17,6,1,7
598070,2,5,17,10,0,10
598076,2,5,17,6,0,6
729290,2,5,17,2,0,2
729302,2,5,17,15,0,15
733980,2,5,17,12,0,12
733994,2,5,17,5,0,5
734004,2,5,17,19,2,21
734022,2,5,17,13,1,14
734038,2,5,17,22,0,22
829720,2,5,17,7,1,8
829726,2,5,17,15,0,15
829732,2,5,17,7,0,7
829740,2,5,17,3,0,3
829774,2,5,17,13,1,14
829792,2,5,17,8,2,10
829802,2,5,17,8,0,8
829824,2,5,17,8,0,8
336000,1,6,17,5,1,6
336003,1,6,17,7,1,8
336014,1,6,17,15,0,15
336020,1,6,17,8,0,8
336025,1,6,17,12,0,12
392194,1,6,17,14,0,14
392203,1,6,17,13,0,13
392228,1,6,17,10,1,11
392231,1,6,17,0,0,0
392235,1,6,17,5,0,5
392237,1,6,17,8,2,10
392242,1,6,17,12,1,13
419121,1,6,17,6,0,6
419133,1,6,17,2,3,5
419136,1,6,17,6,0,6
419139,1,6,17,17,0,17
419145,1,6,17,7,0,7
419154,1,6,17,7,1,8
501206,1,6,17,1,1,2
501209,1,6,17,6,0,6
501228,1,6,17,4,0,4
501232,1,6,17,8,1,9
501238,1,6,17,11,0,11
501243,1,6,17,8,0,8
548347,1,6,17,18,0,18
548350,1,6,17,2,2,4
548362,1,6,17,11,0,11
548369,1,6,17,2,2,4
598003,1,6,17,10,1,11
598015,1,6,17,14,3,17
598022,1,6,17,11,0,11
598040,1,6,17,13,0,13
598049,1,6,17,2,0,2
598054,1,6,17,10,2,12
598064,1,6,17,6,0,6
729286,1,6,17,7,1,8
733980,1,6,17,9,0,9
733986,1,6,17,4,0,4
733990,1,6,17,13,0,13
733998,1,6,17,4,0,4
734024,1,6,17,9,1,10
734044,1,6,17,3,0,3
829720,1,6,17,4,1,5
829736,1,6,17,3,1,4
829744,1,6,17,11,1,12
829752,1,6,17,8,1,9
829762,1,6,17,2,0,2
829788,1,6,17,15,0,15
829818,1,6,17,7,0,7
980908,1,6,17,1,0,1
980938,1,6,17,11,1,12
980956,1,6,17,14,0,14
980970,1,6,17,8,0,8
981002,1,6,17,4,0,4
981016,1,6,17,7,1,8
1082599,1,6,17,11,1,12
1082605,1,6,17,11,2,13
1082608,1,6,17,26,0,26
1082622,1,6,17,6,0,6
1082626,1,6,17,2,0,2
1082642,1,6,17,11,1,12
336006,2,6,17,7,0,7
336009,2,6,17,8,2,10
336022,2,6,17,3,0,3
336031,2,6,17,8,1,9
336037,2,6,17,15,0,15
336043,2,6,17,0,0,0
392199,2,6,17,18,1,19
392206,2,6,17,17,0,17
392211,2,6,17,1,0,1
392216,2,6,17,11,0,11
392220,2,6,17,11,0,11
392224,2,6,17,10,1,11
392240,2,6,17,5,1,6
419113,2,6,17,3,0,3
419116,2,6,17,7,1,8
419119,2,6,17,0,0,0
419125,2,6,17,2,2,4
419149,2,6,17,5,0,5
419157,2,6,17,6,1,7
419160,2,6,17,10,0,10
419165,2,6,17,10,0,10
501218,2,6,17,7,0,7
501221,2,6,17,8,0,8
501235,2,6,17,10,0,10
501248,2,6,17,4,1,5
501251,2,6,17,9,0,9
501258,2,6,17,10,0,10
501262,2,6,17,7,1,8
548315,2,6,17,9,1,10
548326,2,6,17,15,0,15
548334,2,6,17,10,0,10
548338,2,6,17,2,1,3
548374,2,6,17,8,0,8
548377,2,6,17,7,0,7
548379,2,6,17,6,0,6
548383,2,6,17,2,1,3
548385,2,6,17,0,0,0
598006,2,6,17,13,0,13
598011,2,6,17,5,0,5
598025,2,6,17,1,0,1
598029,2,6,17,11,2,13
598033,2,6,17,11,0,11
598045,2,6,17,12,0,12
598059,2,6,17,4,0,4
598067,2,6,17,10,2,12
598072,2,6,17,3,0,3
729294,2,6,17,8,0,8
729306,2,6,17,7,0,7
729314,2,6,17,7,0,7
734010,2,6,17,16,2,18
734016,2,6,17,10,0,10
734036,2,6,17,14,0,14
829712,2,6,17,9,0,9
829730,2,6,17,13,1,14
829766,2,6,17,17,0,17
829782,2,6,17,12,0,12
829798,2,6,17,9,0,9
829806,2,6,17,6,0,6
980926,2,6,17,13,0,13
980950,2,6,17,21,0,21
980966,2,6,17,12,0,12
980976,2,6,17,3,1,4
980988,2,6,17,12,2,14
980998,2,6,17,8,0,8
981008,2,6,17,14,0,14
1082595,2,6,17,5,0,5
1082611,2,6,17,9,1,10
1082614,2,6,17,4,0,4
1082630,2,6,17,14,0,14
1082632,2,6,17,15,1,16
1082640,2,6,17,21,0,21
1082646,2,6,17,14,0,14
335990,1,7,17,10,1,11
335999,1,7,17,9,1,10
336009,1,7,17,6,0,6
336029,1,7,17,13,1,14
336037,1,7,17,8,1,9
336041,1,7,17,2,0,2
392186,1,7,17,14,0,14
392202,1,7,17,6,1,7
392208,1,7,17,8,1,9
392213,1,7,17,6,1,7
392220,1,7,17,1,0,1
392223,1,7,17,11,0,11
392232,1,7,17,12,0,12
392240,1,7,17,13,0,13
419112,1,7,17,9,1,10
419119,1,7,17,12,1,13
419124,1,7,17,14,1,15
419135,1,7,17,10,0,10
419143,1,7,17,10,0,10
419151,1,7,17,8,1,9
419155,1,7,17,14,1,15
419157,1,7,17,8,1,9
419162,1,7,17,10,0,10
419166,1,7,17,12,0,12
419167,1,7,17,14,3,17
501215,1,7,17,6,1,7
501226,1,7,17,11,0,11
501229,1,7,17,10,0,10
501236,1,7,17,10,0,10
501242,1,7,17,6,0,6
501246,1,7,17,1,0,1
501251,1,7,17,7,1,8
501268,1,7,17,12,0,12
548322,1,7,17,16,0,16
548330,1,7,17,1,2,3
548339,1,7,17,8,0,8
548356,1,7,17,4,0,4
548365,1,7,17,4,0,4
548368,1,7,17,16,1,17
598007,1,7,17,8,1,9
598011,1,7,17,11,0,11
598016,1,7,17,18,1,19
598029,1,7,17,2,0,2
598038,1,7,17,16,1,17
598042,1,7,17,13,1,14
598044,1,7,17,5,0,5
598051,1,7,17,9,0,9
598055,1,7,17,11,0,11
598068,1,7,17,7,1,8
598078,1,7,17,6,0,6
729292,1,7,17,3,0,3
729308,1,7,17,7,0,7
729314,1,7,17,10,4,14
733988,1,7,17,9,1,10
734000,1,7,17,7,0,7
734014,1,7,17,8,0,8
734022,1,7,17,7,0,7
734036,1,7,17,7,0,7
734050,1,7,17,5,0,5
829710,1,7,17,13,0,13
829726,1,7,17,16,1,17
829734,1,7,17,17,0,17
829742,1,7,17,24,0,24
829756,1,7,17,5,0,5
829774,1,7,17,11,2,13
829780,1,7,17,9,1,10
829810,1,7,17,18,0,18
829822,1,7,17,2,0,2
829828,1,7,17,23,0,23
980906,1,7,17,5,0,5
980922,1,7,17,10,1,11
980928,1,7,17,4,1,5
980946,1,7,17,8,1,9
980990,1,7,17,7,0,7
980998,1,7,17,10,0,10
981012,1,7,17,5,3,8
1082592,1,7,17,10,0,10
1082614,1,7,17,10,0,10
1082635,1,7,17,10,1,11
1082638,1,7,17,2,0,2
1082644,1,7,17,9,0,9
1082650,1,7,17,4,2,6
335994,2,7,17,21,0,21
335996,2,7,17,1,0,1
336002,2,7,17,7,1,8
336033,2,7,17,3,0,3
392197,2,7,17,11,1,12
392205,2,7,17,6,0,6
392217,2,7,17,5,0,5
392227,2,7,17,5,0,5
392230,2,7,17,10,1,11
419119,2,7,17,0,0,0
419127,2,7,17,10,0,10
419130,2,7,17,7,0,7
419137,2,7,17,10,0,10
419147,2,7,17,8,3,11
419170,2,7,17,5,0,5
501206,2,7,17,7,2,9
501210,2,7,17,9,0,9
501223,2,7,17,4,0,4
501261,2,7,17,3,0,3
501272,2,7,17,7,2,9
501274,2,7,17,6,1,7
501275,2,7,17,6,1,7
548311,2,7,17,11,0,11
548313,2,7,17,7,1,8
548319,2,7,17,8,0,8
548344,2,7,17,11,1,12
548347,2,7,17,5,1,6
548351,2,7,17,2,0,2
548360,2,7,17,11,0,11
548372,2,7,17,15,1,16
548375,2,7,17,7,0,7
548382,2,7,17,6,0,6
548384,2,7,17,6,2,8
598004,2,7,17,23,1,24
598024,2,7,17,0,0,0
598034,2,7,17,8,0,8
598060,2,7,17,7,0,7
598065,2,7,17,29,0,29
598071,2,7,17,3,0,3
598075,2,7,17,7,1,8
598077,2,7,17,11,0,11
729284,2,7,17,3,0,3
729322,2,7,17,26,1,27
733978,2,7,17,4,0,4
734006,2,7,17,7,3,10
734030,2,7,17,4,0,4
829722,2,7,17,19,1,20
829752,2,7,17,4,0,4
829788,2,7,17,11,0,11
829794,2,7,17,17,0,17
829800,2,7,17,15,0,15
980914,2,7,17,9,0,9
980932,2,7,17,14,0,14
980938,2,7,17,4,1,5
980952,2,7,17,7,0,7
980962,2,7,17,8,3,11
980978,2,7,17,0,0,0
980986,2,7,17,16,2,18
1082597,2,7,17,11,0,11
1082600,2,7,17,15,0,15
1082602,2,7,17,10,0,10
1082606,2,7,17,13,0,13
1082618,2,7,17,4,0,4
1082625,2,7,17,7,0,7
1082628,2,7,17,8,0,8
1082641,2,7,17,16,1,17
1082647,2,7,17,4,0,4
335991,1,8,17,19,1,20
335993,1,8,17,8,0,8
335995,1,8,17,11,0,11
336004,1,8,17,9,0,9
336007,1,8,17,17,1,18
336016,1,8,17,6,0,6
336036,1,8,17,21,0,21
336042,1,8,17,8,0,8
392193,1,8,17,9,0,9
392197,1,8,17,8,1,9
392206,1,8,17,7,0,7
392210,1,8,17,9,0,9
392217,1,8,17,15,0,15
392221,1,8,17,20,0,20
392225,1,8,17,12,0,12
392244,1,8,17,6,0,6
419115,1,8,17,10,0,10
419122,1,8,17,10,0,10
419125,1,8,17,18,0,18
419131,1,8,17,5,0,5
419156,1,8,17,4,1,5
419165,1,8,17,2,1,3
419169,1,8,17,1,0,1
501204,1,8,17,8,0,8
501213,1,8,17,15,0,15
501217,1,8,17,7,0,7
501221,1,8,17,13,0,13
501234,1,8,17,5,0,5
501248,1,8,17,15,0,15
501255,1,8,17,5,0,5
501261,1,8,17,8,0,8
501269,1,8,17,11,0,11
548319,1,8,17,10,0,10
548326,1,8,17,5,0,5
548331,1,8,17,11,0,11
548334,1,8,17,17,0,17
548340,1,8,17,1,0,1
548346,1,8,17,10,0,10
548351,1,8,17,3,0,3
548353,1,8,17,2,6,8
548361,1,8,17,16,0,16
548371,1,8,17,8,0,8
548381,1,8,17,15,0,15
336012,2,8,17,1,1,2
336019,2,8,17,16,1,17
336025,2,8,17,15,0,15
336029,2,8,17,14,2,16
336039,2,8,17,13,0,13
392201,2,8,17,5,5,10
392228,2,8,17,4,0,4
392233,2,8,17,14,0,14
392234,2,8,17,2,0,2
392241,2,8,17,6,0,6
392242,2,8,17,3,1,4
419111,2,8,17,5,0,5
419135,2,8,17,2,0,2
419140,2,8,17,6,0,6
419143,2,8,17,3,1,4
419146,2,8,17,15,0,15
419150,2,8,17,20,1,21
419152,2,8,17,10,0,10
419161,2,8,17,6,0,6
419168,2,8,17,17,0,17
501208,2,8,17,14,0,14
501229,2,8,17,15,0,15
501241,2,8,17,8,0,8
501244,2,8,17,7,0,7
501264,2,8,17,12,0,12
548316,2,8,17,2,0,2
548357,2,8,17,8,0,8
548364,2,8,17,10,0,10
548378,2,8,17,6,0,6
501205,1,9,17,9,0,9
501212,1,9,17,4,0,4
501224,1,9,17,5,1,6
501230,1,9,17,2,0,2
501247,1,9,17,12,0,12
501252,1,9,17,3,0,3
501259,1,9,17,13,2,15
501215,2,9,17,13,0,13
501234,2,9,17,0,0,0
501238,2,9,17,10,0,10
501266,2,9,17,7,1,8
501218,1,10,17,5,0,5
501223,1,10,17,7,0,7
501233,1,10,17,11,1,12
501240,1,10,17,5,0,5
501264,1,10,17,3,0,3
501267,1,10,17,6,0,6
548313,1,10,17,5,0,5
548318,1,10,17,1,0,1
548324,1,10,17,3,0,3
548332,1,10,17,14,0,14
548338,1,10,17,11,1,12
548342,1,10,17,11,0,11
548363,1,10,17,6,1,7
598008,1,10,17,2,0,2
598020,1,10,17,9,1,10
598030,1,10,17,13,1,14
598052,1,10,17,9,0,9
598060,1,10,17,5,0,5
598066,1,10,17,9,0,9
598072,1,10,17,9,0,9
501212,2,10,17,3,2,5
501231,2,10,17,4,0,4
501237,2,10,17,5,1,6
501246,2,10,17,10,0,10
501253,2,10,17,2,0,2
501255,2,10,17,12,1,13
548327,2,10,17,5,0,5
548335,2,10,17,6,0,6
548346,2,10,17,16,2,18
548353,2,10,17,9,1,10
548356,2,10,17,7,2,9
548358,2,10,17,4,0,4
548367,2,10,17,7,1,8
548370,2,10,17,4,0,4
548380,2,10,17,5,0,5
598005,2,10,17,10,0,10
598014,2,10,17,2,1,3
598016,2,10,17,6,0,6
598023,2,10,17,6,0,6
598032,2,10,17,5,0,5
598040,2,10,17,8,1,9
598043,2,10,17,14,0,14
598047,2,10,17,8,1,9
598058,2,10,17,3,0,3
598005,1,11,17,15,0,15
598023,1,11,17,5,0,5
598035,1,11,17,15,0,15
598037,1,11,17,9,0,9
598053,1,11,17,18,1,19
598061,1,11,17,10,0,10
598065,1,11,17,7,0,7
598070,1,11,17,6,1,7
598076,1,11,17,15,1,16
729290,1,11,17,8,1,9
729306,1,11,17,11,0,11
729316,1,11,17,5,1,6
729322,1,11,17,7,0,7
733982,1,11,17,8,1,9
733994,1,11,17,5,0,5
734006,1,11,17,6,0,6
734012,1,11,17,11,0,11
734020,1,11,17,12,0,12
734042,1,11,17,2,0,2
829732,1,11,17,3,0,3
829748,1,11,17,6,0,6
829764,1,11,17,9,0,9
829778,1,11,17,3,0,3
829792,1,11,17,18,1,19
829798,1,11,17,8,0,8
829804,1,11,17,10,0,10
829820,1,11,17,5,0,5
980920,1,11,17,9,1,10
980948,1,11,17,3,0,3
980958,1,11,17,8,0,8
980978,1,11,17,13,0,13
980984,1,11,17,12,0,12
980988,1,11,17,8,0,8
981008,1,11,17,4,0,4
981020,1,11,17,9,0,9
981024,1,11,17,7,2,9
1082591,1,11,17,7,0,7
1082600,1,11,17,13,1,14
1082609,1,11,17,9,0,9
1082611,1,11,17,10,0,10
1082615,1,11,17,12,0,12
1082623,1,11,17,11,0,11
1082627,1,11,17,6,0,6
1082630,1,11,17,7,0,7
1082648,1,11,17,2,0,2
598009,2,11,17,4,0,4
598015,2,11,17,7,1,8
598018,2,11,17,4,1,5
598026,2,11,17,2,0,2
598044,2,11,17,8,0,8
598056,2,11,17,4,0,4
598074,2,11,17,0,0,0
729300,2,11,17,5,0,5
734026,2,11,17,7,1,8
734034,2,11,17,11,0,11
829716,2,11,17,4,2,6
829724,2,11,17,13,7,20
829736,2,11,17,9,0,9
829756,2,11,17,9,1,10
829786,2,11,17,4,0,4
980912,2,11,17,5,0,5
980928,2,11,17,11,0,11
980940,2,11,17,8,2,10
980972,2,11,17,6,2,8
980996,2,11,17,1,1,2
981014,2,11,17,4,4,8
981022,2,11,17,11,0,11
1082604,2,11,17,12,1,13
1082634,2,11,17,9,0,9
1082638,2,11,17,7,1,8
1082643,2,11,17,5,2,7
980916,1,12,17,1,1,2
980924,1,12,17,15,0,15
980944,1,12,17,10,1,11
980954,1,12,17,14,2,16
980962,1,12,17,11,0,11
980974,1,12,17,16,0,16
980994,1,12,17,6,0,6
1082594,1,12,17,5,0,5
1082603,1,12,17,14,0,14
1082607,1,12,17,3,0,3
1082618,1,12,17,11,0,11
1082620,1,12,17,7,0,7
1082624,1,12,17,13,1,14
1082634,1,12,17,10,1,11
1082647,1,12,17,4,1,5
980936,2,12,17,13,2,15
980970,2,12,17,6,0,6
980984,2,12,17,5,0,5
981010,2,12,17,10,0,10
1082592,2,12,17,10,0,10
1082599,2,12,17,0,0,0
1082615,2,12,17,9,0,9
1082629,2,12,17,8,0,8
1082631,2,12,17,7,0,7
1082642,2,12,17,4,1,5
1082650,2,12,17,3,0,3
980934,1,13,17,4,0,4
980950,1,13,17,8,1,9
980966,1,13,17,12,1,13
980972,1,13,17,6,0,6
981018,1,13,17,13,0,13
981022,1,13,17,9,0,9
1082593,1,13,17,11,0,11
1082596,1,13,17,3,0,3
1082606,1,13,17,18,1,19
1082625,1,13,17,8,0,8
1082629,1,13,17,5,1,6
1082632,1,13,17,7,0,7
1082640,1,13,17,16,0,16
1082643,1,13,17,8,0,8
980910,2,13,17,13,0,13
980916,2,13,17,3,1,4
980922,2,13,17,8,4,12
980942,2,13,17,11,1,12
980954,2,13,17,9,2,11
980960,2,13,17,7,0,7
980980,2,13,17,5,0,5
980992,2,13,17,3,0,3
981012,2,13,17,9,1,10
1082603,2,13,17,5,0,5
1082610,2,13,17,10,0,10
1082613,2,13,17,16,0,16
1082616,2,13,17,14,0,14
1082637,2,13,17,4,0,4
335987,1,1,18,7,0,7
335998,1,1,18,7,0,7
336002,1,1,18,14,0,14
336019,1,1,18,20,0,20
336022,1,1,18,10,0,10
336030,1,1,18,11,1,12
336032,1,1,18,7,0,7
392189,1,1,18,11,0,11
392204,1,1,18,8,0,8
392212,1,1,18,8,1,9
392216,1,1,18,11,0,11
392224,1,1,18,13,0,13
392226,1,1,18,4,0,4
392233,1,1,18,7,0,7
419111,1,1,18,15,1,16
419127,1,1,18,14,0,14
419132,1,1,18,11,1,12
419140,1,1,18,12,1,13
419144,1,1,18,13,0,13
419149,1,1,18,15,0,15
419153,1,1,18,3,1,4
419158,1,1,18,4,6,10
501208,1,1,18,14,1,15
501227,1,1,18,16,0,16
501235,1,1,18,9,2,11
501244,1,1,18,11,2,13
501272,1,1,18,19,0,19
501274,1,1,18,4,0,4
548320,1,1,18,6,2,8
548349,1,1,18,6,1,7
548358,1,1,18,5,2,7
548373,1,1,18,11,0,11
548375,1,1,18,11,2,13
548380,1,1,18,4,0,4
548383,1,1,18,10,1,11
598013,1,1,18,4,1,5
598018,1,1,18,20,2,22
598027,1,1,18,7,0,7
598034,1,1,18,13,0,13
598045,1,1,18,3,1,4
598058,1,1,18,10,0,10
598074,1,1,18,10,1,11
729284,1,1,18,9,0,9
729294,1,1,18,12,0,12
729304,1,1,18,3,1,4
734032,1,1,18,15,1,16
734048,1,1,18,17,0,17
829718,1,1,18,12,0,12
829766,1,1,18,8,0,8
829786,1,1,18,13,0,13
980914,1,1,18,7,0,7
980952,1,1,18,13,0,13
980968,1,1,18,9,3,12
980980,1,1,18,14,0,14
981000,1,1,18,16,0,16
981006,1,1,18,12,1,13
981014,1,1,18,6,0,6
1082597,1,1,18,8,0,8
1082604,1,1,18,4,0,4
1082613,1,1,18,14,0,14
1082617,1,1,18,3,1,4
1082631,1,1,18,10,0,10
1082649,1,1,18,5,0,5
335991,2,1,18,12,1,13
336005,2,1,18,4,0,4
336008,2,1,18,18,0,18
336040,2,1,18,12,4,16
392195,2,1,18,7,0,7
392208,2,1,18,8,0,8
392236,2,1,18,13,0,13
392238,2,1,18,10,0,10
419114,2,1,18,7,0,7
419118,2,1,18,3,0,3
419123,2,1,18,9,1,10
419136,2,1,18,9,0,9
419166,2,1,18,6,0,6
501203,2,1,18,7,0,7
501214,2,1,18,7,0,7
501224,2,1,18,4,2,6
501239,2,1,18,5,0,5
501247,2,1,18,7,0,7
548317,2,1,18,19,0,19
548325,2,1,18,8,1,9
548328,2,1,18,11,0,11
548340,2,1,18,9,0,9
548352,2,1,18,5,1,6
548362,2,1,18,5,0,5
548368,2,1,18,15,0,15
548386,2,1,18,7,0,7
598003,2,1,18,12,0,12
598010,2,1,18,13,0,13
598021,2,1,18,5,0,5
598036,2,1,18,13,0,13
598039,2,1,18,20,1,21
598048,2,1,18,4,0,4
598055,2,1,18,1,3,4
598062,2,1,18,3,0,3
598066,2,1,18,15,0,15
729312,2,1,18,12,0,12
729320,2,1,18,11,0,11
733984,2,1,18,12,3,15
733990,2,1,18,5,0,5
734002,2,1,18,11,0,11
734014,2,1,18,8,0,8
734020,2,1,18,14,0,14
734028,2,1,18,11,0,11
734054,2,1,18,5,1,6
829710,2,1,18,14,0,14
829728,2,1,18,8,0,8
829738,2,1,18,7,0,7
829744,2,1,18,9,0,9
829770,2,1,18,3,1,4
829796,2,1,18,10,1,11
829810,2,1,18,7,0,7
829816,2,1,18,5,2,7
980920,2,1,18,14,0,14
980930,2,1,18,4,0,4
980944,2,1,18,7,0,7
980956,2,1,18,5,0,5
980964,2,1,18,6,0,6
981020,2,1,18,6,0,6
1082608,2,1,18,5,1,6
1082620,2,1,18,2,0,2
1082627,2,1,18,11,0,11
1082639,2,1,18,8,0,8
1082644,2,1,18,4,0,4
335997,1,2,18,8,1,9
336011,1,2,18,2,0,2
336017,1,2,18,7,0,7
336021,1,2,18,3,2,5
336031,1,2,18,5,0,5
336034,1,2,18,11,0,11
336039,1,2,18,4,0,4
392187,1,2,18,8,0,8
392196,1,2,18,8,1,9
392199,1,2,18,2,5,7
392209,1,2,18,21,0,21
392218,1,2,18,1,0,1
392241,1,2,18,5,0,5
419114,1,2,18,6,0,6
419128,1,2,18,11,0,11
419138,1,2,18,8,0,8
419150,1,2,18,16,0,16
501210,1,2,18,5,0,5
501237,1,2,18,23,1,24
501249,1,2,18,10,0,10
501273,1,2,18,13,0,13
501275,1,2,18,6,0,6
548315,1,2,18,8,0,8
548323,1,2,18,16,1,17
548341,1,2,18,12,5,17
548355,1,2,18,4,1,5
548367,1,2,18,11,0,11
548372,1,2,18,6,0,6
548377,1,2,18,13,0,13
598004,1,2,18,17,0,17
598009,1,2,18,5,1,6
598017,1,2,18,3,2,5
598032,1,2,18,15,0,15
598041,1,2,18,6,1,7
598047,1,2,18,12,0,12
598050,1,2,18,18,2,20
598059,1,2,18,24,0,24
598062,1,2,18,3,0,3
598069,1,2,18,12,0,12
729318,1,2,18,5,0,5
734004,1,2,18,13,0,13
734010,1,2,18,13,1,14
734026,1,2,18,11,1,12
734040,1,2,18,11,0,11
829724,1,2,18,12,2,14
829768,1,2,18,18,0,18
829790,1,2,18,12,0,12
829800,1,2,18,19,0,19
829824,1,2,18,17,0,17
829826,1,2,18,11,0,11
980912,1,2,18,3,0,3
980926,1,2,18,4,0,4
980932,1,2,18,9,0,9
980936,1,2,18,12,1,13
980942,1,2,18,8,0,8
980964,1,2,18,20,3,23
980982,1,2,18,12,0,12
980986,1,2,18,22,1,23
980992,1,2,18,29,1,30
1082595,1,2,18,2,0,2
1082598,1,2,18,19,0,19
1082602,1,2,18,6,2,8
1082610,1,2,18,12,0,12
1082621,1,2,18,3,1,4
1082628,1,2,18,15,0,15
1082636,1,2,18,10,0,10
1082646,1,2,18,8,1,9
335990,2,2,18,19,0,19
336001,2,2,18,6,0,6
336003,2,2,18,12,1,13
336007,2,2,18,13,0,13
336028,2,2,18,7,0,7
392193,2,2,18,8,0,8
392204,2,2,18,11,0,11
392213,2,2,18,15,0,15
392223,2,2,18,5,0,5
392226,2,2,18,18,1,19
392229,2,2,18,5,4,9
392237,2,2,18,14,0,14
392243,2,2,18,8,0,8
392244,2,2,18,3,1,4
419117,2,2,18,23,0,23
419124,2,2,18,6,0,6
419133,2,2,18,2,4,6
419141,2,2,18,11,0,11
419145,2,2,18,9,0,9
419153,2,2,18,4,0,4
419156,2,2,18,19,2,21
419162,2,2,18,4,0,4
419167,2,2,18,4,1,5
501205,2,2,18,20,0,20
501213,2,2,18,14,0,14
501216,2,2,18,15,0,15
501227,2,2,18,4,1,5
501232,2,2,18,10,0,10
501271,2,2,18,13,0,13
501276,2,2,18,8,0,8
548320,2,2,18,6,1,7
548329,2,2,18,1,0,1
548332,2,2,18,16,0,16
548336,2,2,18,15,2,17
548349,2,2,18,4,0,4
548361,2,2,18,23,0,23
548365,2,2,18,16,0,16
548381,2,2,18,7,0,7
598013,2,2,18,12,1,13
598022,2,2,18,6,0,6
598028,2,2,18,15,0,15
598038,2,2,18,2,0,2
598053,2,2,18,8,0,8
729292,2,2,18,7,0,7
729304,2,2,18,7,0,7
733982,2,2,18,9,0,9
733988,2,2,18,9,0,9
733996,2,2,18,8,0,8
734018,2,2,18,13,2,15
734032,2,2,18,8,1,9
829718,2,2,18,17,0,17
829742,2,2,18,14,1,15
829750,2,2,18,6,4,10
829784,2,2,18,5,0,5
980958,2,2,18,10,0,10
980974,2,2,18,18,0,18
981000,2,2,18,15,1,16
981016,2,2,18,7,5,12
981018,2,2,18,13,5,18
981024,2,2,18,6,1,7
1082591,2,2,18,2,0,2
1082607,2,2,18,10,0,10
1082624,2,2,18,4,0,4
1082633,2,2,18,4,0,4
335988,1,3,18,17,0,17
335994,1,3,18,14,0,14
336001,1,3,18,8,0,8
336006,1,3,18,7,0,7
336010,1,3,18,0,1,1
336012,1,3,18,14,0,14
336018,1,3,18,4,1,5
336023,1,3,18,14,0,14
336045,1,3,18,9,0,9
392190,1,3,18,7,0,7
392201,1,3,18,20,0,20
392207,1,3,18,23,1,24
392211,1,3,18,3,1,4
392214,1,3,18,5,0,5
392219,1,3,18,9,0,9
392229,1,3,18,6,0,6
392236,1,3,18,8,2,10
392239,1,3,18,6,1,7
392243,1,3,18,3,3,6
419118,1,3,18,16,0,16
419130,1,3,18,10,0,10
419142,1,3,18,18,0,18
419147,1,3,18,6,0,6
419152,1,3,18,4,0,4
419160,1,3,18,10,0,10
419168,1,3,18,3,1,4
419170,1,3,18,7,0,7
501203,1,3,18,5,0,5
501211,1,3,18,22,0,22
501216,1,3,18,15,0,15
501231,1,3,18,7,1,8
501241,1,3,18,10,0,10
501250,1,3,18,3,1,4
501254,1,3,18,17,0,17
501258,1,3,18,11,2,13
501266,1,3,18,7,0,7
501271,1,3,18,10,1,11
501276,1,3,18,15,1,16
548311,1,3,18,2,0,2
548316,1,3,18,5,3,8
548321,1,3,18,5,0,5
548327,1,3,18,11,0,11
548335,1,3,18,12,0,12
548352,1,3,18,5,0,5
548357,1,3,18,6,0,6
548360,1,3,18,11,0,11
548376,1,3,18,8,0,8
548384,1,3,18,9,0,9
548385,1,3,18,7,0,7
548386,1,3,18,11,0,11
598025,1,3,18,19,0,19
598039,1,3,18,10,1,11
598043,1,3,18,17,0,17
598046,1,3,18,11,0,11
598056,1,3,18,15,1,16
598063,1,3,18,2,1,3
598067,1,3,18,11,0,11
598075,1,3,18,10,0,10
729288,1,3,18,8,0,8
729298,1,3,18,15,0,15
729302,1,3,18,3,0,3
734018,1,3,18,6,0,6
734028,1,3,18,10,0,10
734034,1,3,18,14,0,14
829712,1,3,18,4,1,5
829716,1,3,18,20,0,20
829728,1,3,18,13,4,17
829740,1,3,18,17,0,17
829750,1,3,18,7,1,8
829758,1,3,18,10,0,10
829770,1,3,18,4,2,6
829784,1,3,18,15,0,15
829794,1,3,18,11,0,11
829802,1,3,18,4,0,4
829806,1,3,18,11,0,11
336014,2,3,18,10,1,11
336034,2,3,18,9,2,11
336038,2,3,18,8,0,8
336042,2,3,18,11,0,11
392186,2,3,18,8,0,8
392194,2,3,18,5,0,5
392207,2,3,18,2,1,3
392222,2,3,18,12,0,12
392232,2,3,18,15,2,17
419115,2,3,18,7,1,8
419121,2,3,18,3,0,3
419126,2,3,18,7,0,7
419128,2,3,18,5,0,5
419134,2,3,18,20,0,20
419138,2,3,18,3,2,5
419164,2,3,18,14,1,15
501226,2,3,18,2,0,2
501233,2,3,18,14,0,14
501245,2,3,18,4,0,4
501273,2,3,18,4,1,5
548323,2,3,18,6,1,7
548337,2,3,18,13,0,13
548348,2,3,18,7,0,7
548366,2,3,18,18,0,18
548373,2,3,18,5,0,5
598007,2,3,18,15,2,17
598012,2,3,18,7,0,7
598017,2,3,18,11,1,12
598020,2,3,18,4,0,4
598027,2,3,18,9,1,10
598031,2,3,18,12,0,12
598035,2,3,18,4,0,4
598078,2,3,18,2,0,2
729308,2,3,18,12,1,13
729316,2,3,18,5,0,5
733986,2,3,18,17,0,17
733992,2,3,18,15,0,15
734000,2,3,18,9,1,10
734008,2,3,18,5,2,7
734040,2,3,18,17,0,17
734050,2,3,18,8,2,10
734052,2,3,18,3,3,6
829778,2,3,18,11,0,11
829822,2,3,18,15,1,16
829826,2,3,18,13,1,14
829828,2,3,18,4,1,5
335992,1,4,18,2,0,2
335996,1,4,18,4,1,5
336008,1,4,18,8,2,10
336024,1,4,18,19,0,19
336033,1,4,18,10,0,10
336040,1,4,18,15,1,16
336044,1,4,18,5,0,5
392191,1,4,18,4,0,4
392200,1,4,18,12,0,12
392205,1,4,18,4,0,4
392227,1,4,18,8,3,11
392234,1,4,18,6,0,6
419113,1,4,18,5,0,5
419117,1,4,18,14,2,16
419126,1,4,18,8,0,8
419137,1,4,18,2,4,6
419141,1,4,18,12,0,12
419148,1,4,18,7,0,7
419161,1,4,18,9,0,9
419164,1,4,18,10,1,11
501207,1,4,18,5,2,7
501225,1,4,18,3,2,5
501239,1,4,18,3,0,3
501253,1,4,18,1,0,1
501256,1,4,18,5,0,5
501262,1,4,18,7,0,7
501265,1,4,18,11,5,16
548328,1,4,18,3,0,3
548333,1,4,18,4,0,4
548336,1,4,18,14,0,14
548344,1,4,18,16,0,16
548348,1,4,18,2,0,2
548364,1,4,18,10,0,10
548374,1,4,18,8,1,9
548379,1,4,18,8,0,8
598012,1,4,18,2,0,2
598019,1,4,18,11,5,16
598021,1,4,18,14,1,15
598026,1,4,18,9,1,10
598033,1,4,18,18,0,18
598036,1,4,18,3,0,3
598057,1,4,18,6,1,7
598071,1,4,18,8,0,8
729300,1,4,18,16,1,17
729312,1,4,18,8,0,8
733978,1,4,18,5,0,5
733992,1,4,18,10,0,10
733996,1,4,18,11,0,11
734002,1,4,18,4,0,4
734030,1,4,18,10,0,10
734038,1,4,18,13,0,13
734052,1,4,18,18,0,18
734054,1,4,18,11,0,11
829722,1,4,18,3,0,3
829730,1,4,18,6,0,6
829738,1,4,18,11,0,11
829772,1,4,18,5,0,5
829796,1,4,18,3,1,4
829814,1,4,18,7,1,8
980910,1,4,18,10,0,10
980918,1,4,18,6,0,6
980930,1,4,18,7,0,7
980940,1,4,18,7,0,7
980960,1,4,18,8,0,8
980976,1,4,18,4,1,5
980996,1,4,18,12,0,12
981010,1,4,18,14,0,14
1082601,1,4,18,11,0,11
1082612,1,4,18,4,1,5
1082616,1,4,18,6,0,6
1082633,1,4,18,9,0,9
1082637,1,4,18,9,0,9
1082639,1,4,18,13,1,14
1082641,1,4,18,9,0,9
335988,2,4,18,4,1,5
336000,2,4,18,11,2,13
336004,2,4,18,9,1,10
336011,2,4,18,2,1,3
336018,2,4,18,19,0,19
336036,2,4,18,5,1,6
392196,2,4,18,16,1,17
392209,2,4,18,7,6,13
392212,2,4,18,7,0,7
392215,2,4,18,5,2,7
392219,2,4,18,11,0,11
392221,2,4,18,9,1,10
392231,2,4,18,15,0,15
392239,2,4,18,7,1,8
419122,2,4,18,9,4,13
419129,2,4,18,3,0,3
419132,2,4,18,6,0,6
419144,2,4,18,8,0,8
419151,2,4,18,8,0,8
419154,2,4,18,3,0,3
501211,2,4,18,8,0,8
501217,2,4,18,9,1,10
501228,2,4,18,12,0,12
501242,2,4,18,9,0,9
501249,2,4,18,3,0,3
501259,2,4,18,7,1,8
501269,2,4,18,0,0,0
548314,2,4,18,10,0,10
548318,2,4,18,14,0,14
548324,2,4,18,7,0,7
548339,2,4,18,9,5,14
548355,2,4,18,5,0,5
548359,2,4,18,5,0,5
548371,2,4,18,13,4,17
598030,2,4,18,8,0,8
598042,2,4,18,11,0,11
598046,2,4,18,11,1,12
598050,2,4,18,10,0,10
598061,2,4,18,4,1,5
598069,2,4,18,21,1,22
729288,2,4,18,4,0,4
729296,2,4,18,27,0,27
729318,2,4,18,5,0,5
734012,2,4,18,22,0,22
734024,2,4,18,10,0,10
734048,2,4,18,21,0,21
829714,2,4,18,1,3,4
829746,2,4,18,15,0,15
829758,2,4,18,1,0,1
829764,2,4,18,7,0,7
829780,2,4,18,5,0,5
829804,2,4,18,18,0,18
980924,2,4,18,13,0,13
980946,2,4,18,2,0,2
980968,2,4,18,13,0,13
980982,2,4,18,13,0,13
1082594,2,4,18,12,0,12
1082605,2,4,18,6,0,6
1082609,2,4,18,12,0,12
1082623,2,4,18,9,0,9
335989,1,5,18,1,0,1
336005,1,5,18,15,1,16
336028,1,5,18,10,0,10
336038,1,5,18,12,0,12
336043,1,5,18,8,0,8
392195,1,5,18,4,2,6
392215,1,5,18,15,0,15
392222,1,5,18,10,0,10
392230,1,5,18,7,1,8
392238,1,5,18,4,0,4
419116,1,5,18,7,0,7
419120,1,5,18,3,0,3
419123,1,5,18,2,1,3
419129,1,5,18,13,0,13
419134,1,5,18,10,0,10
419146,1,5,18,4,0,4
419159,1,5,18,2,0,2
419163,1,5,18,5,0,5
501214,1,5,18,11,0,11
501245,1,5,18,9,1,10
501257,1,5,18,6,0,6
501263,1,5,18,1,0,1
548314,1,5,18,9,0,9
548317,1,5,18,14,0,14
548325,1,5,18,2,2,4
548329,1,5,18,17,0,17
548337,1,5,18,2,2,4
548354,1,5,18,5,0,5
548359,1,5,18,8,1,9
548366,1,5,18,10,0,10
548370,1,5,18,11,0,11
548378,1,5,18,7,0,7
548382,1,5,18,6,1,7
598006,1,5,18,10,0,10
598010,1,5,18,7,1,8
598014,1,5,18,12,2,14
598024,1,5,18,9,0,9
598028,1,5,18,2,0,2
598031,1,5,18,11,1,12
598048,1,5,18,4,0,4
598077,1,5,18,13,0,13
729296,1,5,18,15,0,15
729320,1,5,18,6,0,6
733984,1,5,18,10,1,11
734008,1,5,18,7,0,7
734016,1,5,18,2,0,2
734046,1,5,18,18,0,18
829714,1,5,18,9,1,10
829746,1,5,18,9,2,11
829754,1,5,18,3,0,3
829782,1,5,18,10,0,10
829816,1,5,18,11,0,11
335992,2,5,18,9,1,10
335995,2,5,18,5,1,6
335997,2,5,18,4,0,4
336020,2,5,18,6,0,6
336024,2,5,18,10,0,10
336041,2,5,18,7,4,11
336045,2,5,18,4,3,7
392200,2,5,18,6,0,6
392203,2,5,18,14,0,14
392207,2,5,18,1,0,1
392210,2,5,18,6,0,6
392225,2,5,18,5,0,5
392235,2,5,18,11,1,12
419112,2,5,18,21,0,21
419139,2,5,18,2,0,2
419142,2,5,18,13,3,16
419155,2,5,18,13,0,13
501204,2,5,18,13,2,15
501209,2,5,18,5,0,5
501225,2,5,18,6,0,6
501236,2,5,18,6,0,6
501240,2,5,18,8,2,10
501254,2,5,18,5,0,5
548322,2,5,18,6,2,8
548331,2,5,18,13,0,13
548341,2,5,18,9,0,9
548350,2,5,18,10,0,10
598019,2,5,18,11,0,11
598037,2,5,18,16,0,16
598041,2,5,18,17,0,17
598052,2,5,18,11,0,11
598054,2,5,18,5,0,5
598057,2,5,18,4,1,5
598063,2,5,18,6,0,6
598068,2,5,18,5,0,5
598070,2,5,18,2,1,3
598076,2,5,18,6,4,10
729290,2,5,18,7,0,7
729302,2,5,18,5,0,5
733980,2,5,18,12,0,12
733994,2,5,18,2,0,2
734004,2,5,18,22,1,23
734022,2,5,18,10,1,11
734038,2,5,18,6,0,6
829720,2,5,18,16,1,17
829726,2,5,18,12,0,12
829732,2,5,18,8,0,8
829740,2,5,18,9,0,9
829774,2,5,18,8,0,8
829792,2,5,18,17,0,17
829802,2,5,18,10,0,10
829824,2,5,18,1,1,2
336000,1,6,18,11,0,11
336003,1,6,18,11,0,11
336014,1,6,18,13,0,13
336020,1,6,18,13,0,13
336025,1,6,18,12,1,13
392194,1,6,18,13,0,13
392203,1,6,18,12,0,12
392228,1,6,18,10,0,10
392231,1,6,18,7,0,7
392235,1,6,18,11,0,11
392237,1,6,18,5,0,5
392242,1,6,18,3,0,3
419121,1,6,18,8,1,9
419133,1,6,18,13,1,14
419136,1,6,18,4,0,4
419139,1,6,18,14,6,20
419145,1,6,18,9,0,9
419154,1,6,18,7,0,7
501206,1,6,18,5,0,5
501209,1,6,18,10,1,11
501228,1,6,18,13,0,13
501232,1,6,18,9,0,9
501238,1,6,18,15,0,15
501243,1,6,18,10,0,10
548347,1,6,18,20,0,20
548350,1,6,18,7,0,7
548362,1,6,18,3,0,3
548369,1,6,18,5,1,6
598003,1,6,18,4,0,4
598015,1,6,18,4,0,4
598022,1,6,18,6,0,6
598040,1,6,18,5,1,6
598049,1,6,18,4,0,4
598054,1,6,18,11,1,12
598064,1,6,18,7,0,7
729286,1,6,18,14,0,14
733980,1,6,18,10,1,11
733986,1,6,18,17,0,17
733990,1,6,18,17,0,17
733998,1,6,18,5,0,5
734024,1,6,18,11,0,11
734044,1,6,18,5,0,5
829720,1,6,18,17,0,17
829736,1,6,18,6,0,6
829744,1,6,18,4,2,6
829752,1,6,18,12,1,13
829762,1,6,18,2,0,2
829788,1,6,18,15,1,16
829818,1,6,18,9,0,9
980908,1,6,18,5,0,5
980938,1,6,18,10,1,11
980956,1,6,18,18,0,18
980970,1,6,18,4,2,6
981002,1,6,18,8,2,10
981016,1,6,18,10,0,10
1082599,1,6,18,19,0,19
1082605,1,6,18,9,0,9
1082608,1,6,18,6,1,7
1082622,1,6,18,3,0,3
1082626,1,6,18,0,0,0
1082642,1,6,18,19,0,19
336006,2,6,18,2,0,2
336009,2,6,18,3,0,3
336022,2,6,18,1,5,6
336031,2,6,18,10,0,10
336037,2,6,18,9,0,9
392199,2,6,18,9,0,9
392206,2,6,18,4,0,4
392211,2,6,18,5,0,5
392216,2,6,18,10,0,10
392220,2,6,18,3,0,3
392224,2,6,18,4,0,4
392240,2,6,18,12,0,12
419113,2,6,18,9,0,9
419116,2,6,18,2,0,2
419125,2,6,18,16,1,17
419149,2,6,18,4,0,4
419157,2,6,18,5,0,5
419160,2,6,18,9,0,9
419165,2,6,18,9,1,10
501218,2,6,18,18,2,20
501221,2,6,18,11,0,11
501235,2,6,18,13,1,14
501248,2,6,18,11,0,11
501251,2,6,18,4,2,6
501258,2,6,18,6,0,6
501262,2,6,18,14,1,15
548315,2,6,18,7,1,8
548326,2,6,18,14,0,14
548338,2,6,18,10,0,10
548374,2,6,18,15,0,15
548377,2,6,18,7,0,7
548379,2,6,18,6,0,6
548383,2,6,18,10,0,10
598006,2,6,18,4,1,5
598011,2,6,18,3,0,3
598025,2,6,18,0,0,0
598033,2,6,18,9,0,9
598045,2,6,18,11,0,11
598059,2,6,18,17,0,17
598067,2,6,18,3,0,3
598072,2,6,18,3,0,3
729294,2,6,18,20,1,21
729306,2,6,18,17,1,18
729314,2,6,18,6,0,6
734010,2,6,18,6,0,6
734016,2,6,18,11,0,11
734036,2,6,18,12,0,12
829712,2,6,18,4,1,5
829730,2,6,18,8,2,10
829766,2,6,18,6,1,7
829782,2,6,18,7,0,7
829798,2,6,18,7,0,7
980926,2,6,18,11,1,12
980950,2,6,18,10,1,11
980966,2,6,18,8,0,8
980976,2,6,18,12,0,12
980988,2,6,18,13,0,13
980998,2,6,18,4,0,4
981008,2,6,18,9,3,12
1082595,2,6,18,11,0,11
1082611,2,6,18,13,0,13
1082614,2,6,18,12,0,12
1082630,2,6,18,12,0,12
1082632,2,6,18,6,3,9
1082640,2,6,18,8,0,8
1082646,2,6,18,8,0,8
335990,1,7,18,20,0,20
335999,1,7,18,11,0,11
336009,1,7,18,10,0,10
336029,1,7,18,14,0,14
336037,1,7,18,8,0,8
336041,1,7,18,9,1,10
392186,1,7,18,22,0,22
392202,1,7,18,7,0,7
392208,1,7,18,16,0,16
392213,1,7,18,13,1,14
392220,1,7,18,14,0,14
392223,1,7,18,9,0,9
392232,1,7,18,12,2,14
392240,1,7,18,11,1,12
419112,1,7,18,6,5,11
419119,1,7,18,10,1,11
419124,1,7,18,4,0,4
419135,1,7,18,13,0,13
419143,1,7,18,9,0,9
419151,1,7,18,8,0,8
419155,1,7,18,12,1,13
419157,1,7,18,14,0,14
419162,1,7,18,19,0,19
419166,1,7,18,10,1,11
419167,1,7,18,10,0,10
501215,1,7,18,5,0,5
501226,1,7,18,8,0,8
501229,1,7,18,8,0,8
501236,1,7,18,2,0,2
501242,1,7,18,13,0,13
501246,1,7,18,11,0,11
501251,1,7,18,14,0,14
501268,1,7,18,5,2,7
548322,1,7,18,10,1,11
548330,1,7,18,5,1,6
548339,1,7,18,6,0,6
548356,1,7,18,1,1,2
548365,1,7,18,8,0,8
548368,1,7,18,13,1,14
598007,1,7,18,8,0,8
598011,1,7,18,7,0,7
598016,1,7,18,21,0,21
598029,1,7,18,14,1,15
598038,1,7,18,2,0,2
598042,1,7,18,9,2,11
598044,1,7,18,8,0,8
598051,1,7,18,13,0,13
598055,1,7,18,5,0,5
598068,1,7,18,8,0,8
598078,1,7,18,16,1,17
729292,1,7,18,1,0,1
729308,1,7,18,5,0,5
729314,1,7,18,5,1,6
733988,1,7,18,13,0,13
734000,1,7,18,9,2,11
734014,1,7,18,5,0,5
734022,1,7,18,7,1,8
734036,1,7,18,7,0,7
734050,1,7,18,8,0,8
829710,1,7,18,10,1,11
829726,1,7,18,13,0,13
829734,1,7,18,4,1,5
829742,1,7,18,8,0,8
829756,1,7,18,12,3,15
829774,1,7,18,19,1,20
829780,1,7,18,8,0,8
829810,1,7,18,10,1,11
829822,1,7,18,15,0,15
829828,1,7,18,10,0,10
980906,1,7,18,10,0,10
980922,1,7,18,12,1,13
980928,1,7,18,6,1,7
980946,1,7,18,11,0,11
980990,1,7,18,9,0,9
980998,1,7,18,7,0,7
981012,1,7,18,7,0,7
1082592,1,7,18,7,1,8
1082614,1,7,18,3,0,3
1082635,1,7,18,14,2,16
1082638,1,7,18,12,2,14
1082644,1,7,18,18,0,18
1082650,1,7,18,12,1,13
335994,2,7,18,13,0,13
335996,2,7,18,6,1,7
336002,2,7,18,3,0,3
336033,2,7,18,3,1,4
392197,2,7,18,12,0,12
392205,2,7,18,7,0,7
392217,2,7,18,4,0,4
392230,2,7,18,14,0,14
419127,2,7,18,13,0,13
419130,2,7,18,9,0,9
419137,2,7,18,12,0,12
419147,2,7,18,14,0,14
419170,2,7,18,22,0,22
501210,2,7,18,7,0,7
501223,2,7,18,9,0,9
501261,2,7,18,8,0,8
501272,2,7,18,13,1,14
501274,2,7,18,3,0,3
501275,2,7,18,6,0,6
548313,2,7,18,6,0,6
548319,2,7,18,14,0,14
548344,2,7,18,8,0,8
548347,2,7,18,10,1,11
548351,2,7,18,12,2,14
548360,2,7,18,2,0,2
548372,2,7,18,18,0,18
548375,2,7,18,8,0,8
548382,2,7,18,7,0,7
548384,2,7,18,4,0,4
598004,2,7,18,10,0,10
598024,2,7,18,4,1,5
598034,2,7,18,10,0,10
598060,2,7,18,12,0,12
598065,2,7,18,20,1,21
598071,2,7,18,10,0,10
598075,2,7,18,3,0,3
598077,2,7,18,2,1,3
729284,2,7,18,3,1,4
729322,2,7,18,4,0,4
733978,2,7,18,16,0,16
734006,2,7,18,9,0,9
734030,2,7,18,3,1,4
829722,2,7,18,14,1,15
829752,2,7,18,8,1,9
829788,2,7,18,10,0,10
829794,2,7,18,4,0,4
829800,2,7,18,9,1,10
980914,2,7,18,4,0,4
980932,2,7,18,14,0,14
980938,2,7,18,9,1,10
980952,2,7,18,21,1,22
980962,2,7,18,14,1,15
980986,2,7,18,16,0,16
1082597,2,7,18,18,1,19
1082600,2,7,18,6,0,6
1082602,2,7,18,10,3,13
1082606,2,7,18,6,0,6
1082618,2,7,18,9,2,11
1082625,2,7,18,9,0,9
1082628,2,7,18,11,1,12
1082641,2,7,18,16,0,16
1082647,2,7,18,13,0,13
335991,1,8,18,3,0,3
335993,1,8,18,26,0,26
335995,1,8,18,15,0,15
336004,1,8,18,8,1,9
336007,1,8,18,9,0,9
336016,1,8,18,10,0,10
336036,1,8,18,12,0,12
336042,1,8,18,12,3,15
392193,1,8,18,12,0,12
392197,1,8,18,6,0,6
392206,1,8,18,5,0,5
392210,1,8,18,9,0,9
392217,1,8,18,4,1,5
392221,1,8,18,18,1,19
392225,1,8,18,17,0,17
392244,1,8,18,9,1,10
419115,1,8,18,11,0,11
419122,1,8,18,13,0,13
419125,1,8,18,14,0,14
419131,1,8,18,9,1,10
419156,1,8,18,4,0,4
419165,1,8,18,4,0,4
419169,1,8,18,0,0,0
501204,1,8,18,3,0,3
501213,1,8,18,11,0,11
501217,1,8,18,14,1,15
501221,1,8,18,6,1,7
501234,1,8,18,5,0,5
501248,1,8,18,11,0,11
501255,1,8,18,7,0,7
501261,1,8,18,7,0,7
501269,1,8,18,12,0,12
548319,1,8,18,4,0,4
548326,1,8,18,4,1,5
548331,1,8,18,17,0,17
548334,1,8,18,13,0,13
548340,1,8,18,8,0,8
548346,1,8,18,10,1,11
548351,1,8,18,8,1,9
548353,1,8,18,24,1,25
548361,1,8,18,14,0,14
548371,1,8,18,14,0,14
548381,1,8,18,20,0,20
336012,2,8,18,21,0,21
336019,2,8,18,7,0,7
336025,2,8,18,18,0,18
336029,2,8,18,7,0,7
336039,2,8,18,3,1,4
392201,2,8,18,8,1,9
392228,2,8,18,3,0,3
392233,2,8,18,6,1,7
392234,2,8,18,18,0,18
392241,2,8,18,7,0,7
392242,2,8,18,2,0,2
419111,2,8,18,8,0,8
419135,2,8,18,0,0,0
419140,2,8,18,7,1,8
419143,2,8,18,0,1,1
419146,2,8,18,4,0,4
419150,2,8,18,9,0,9
419152,2,8,18,9,0,9
419161,2,8,18,10,0,10
419168,2,8,18,2,0,2
501208,2,8,18,7,1,8
501229,2,8,18,2,5,7
501241,2,8,18,7,0,7
501244,2,8,18,5,0,5
501264,2,8,18,2,0,2
548316,2,8,18,0,0,0
548357,2,8,18,17,1,18
548364,2,8,18,6,0,6
548378,2,8,18,8,0,8
501205,1,9,18,12,0,12
501212,1,9,18,2,1,3
501224,1,9,18,7,0,7
501230,1,9,18,7,0,7
501247,1,9,18,9,2,11
501252,1,9,18,5,1,6
501259,1,9,18,8,2,10
501215,2,9,18,8,0,8
501238,2,9,18,9,0,9
501266,2,9,18,12,0,12
501218,1,10,18,5,0,5
501223,1,10,18,0,0,0
501233,1,10,18,8,2,10
501240,1,10,18,8,0,8
501264,1,10,18,10,0,10
501267,1,10,18,11,0,11
548313,1,10,18,11,0,11
548318,1,10,18,9,0,9
548324,1,10,18,9,1,10
548332,1,10,18,9,0,9
548338,1,10,18,22,1,23
548342,1,10,18,13,0,13
548363,1,10,18,7,0,7
598008,1,10,18,3,1,4
598020,1,10,18,3,0,3
598030,1,10,18,17,0,17
598052,1,10,18,9,0,9
598060,1,10,18,2,0,2
598066,1,10,18,18,0,18
598072,1,10,18,10,0,10
501212,2,10,18,11,0,11
501231,2,10,18,4,0,4
501237,2,10,18,3,0,3
501246,2,10,18,12,0,12
501253,2,10,18,1,0,1
501255,2,10,18,4,0,4
548327,2,10,18,12,0,12
548335,2,10,18,10,0,10
548346,2,10,18,12,0,12
548353,2,10,18,11,1,12
548356,2,10,18,10,1,11
548358,2,10,18,9,0,9
548367,2,10,18,4,1,5
548370,2,10,18,2,1,3
548380,2,10,18,3,0,3
598005,2,10,18,9,0,9
598014,2,10,18,7,0,7
598016,2,10,18,5,0,5
598023,2,10,18,5,0,5
598032,2,10,18,2,0,2
598040,2,10,18,2,0,2
598043,2,10,18,4,0,4
598047,2,10,18,8,0,8
598058,2,10,18,5,0,5
598005,1,11,18,6,0,6
598023,1,11,18,7,0,7
598035,1,11,18,11,0,11
598037,1,11,18,10,0,10
598053,1,11,18,7,2,9
598061,1,11,18,14,0,14
598065,1,11,18,12,0,12
598070,1,11,18,11,0,11
598076,1,11,18,8,1,9
729290,1,11,18,7,1,8
729306,1,11,18,21,0,21
729316,1,11,18,5,0,5
729322,1,11,18,6,0,6
733982,1,11,18,16,0,16
733994,1,11,18,4,0,4
734006,1,11,18,6,0,6
734012,1,11,18,18,0,18
734020,1,11,18,3,0,3
734042,1,11,18,3,0,3
829732,1,11,18,6,0,6
829748,1,11,18,9,0,9
829764,1,11,18,8,0,8
829778,1,11,18,11,0,11
829792,1,11,18,14,0,14
829798,1,11,18,8,1,9
829804,1,11,18,2,0,2
829820,1,11,18,3,0,3
980920,1,11,18,10,0,10
980948,1,11,18,11,0,11
980958,1,11,18,13,0,13
980978,1,11,18,14,0,14
980984,1,11,18,3,0,3
980988,1,11,18,9,1,10
981008,1,11,18,10,1,11
981020,1,11,18,9,1,10
981024,1,11,18,10,2,12
1082591,1,11,18,15,2,17
1082600,1,11,18,7,0,7
1082609,1,11,18,10,0,10
1082611,1,11,18,12,0,12
1082615,1,11,18,12,0,12
1082623,1,11,18,5,0,5
1082627,1,11,18,11,0,11
1082630,1,11,18,20,0,20
1082648,1,11,18,13,0,13
598009,2,11,18,14,0,14
598015,2,11,18,6,0,6
598018,2,11,18,7,0,7
598026,2,11,18,7,0,7
598044,2,11,18,2,1,3
598056,2,11,18,12,0,12
598074,2,11,18,8,0,8
729300,2,11,18,3,0,3
734026,2,11,18,7,0,7
734034,2,11,18,8,0,8
829716,2,11,18,5,2,7
829724,2,11,18,10,0,10
829736,2,11,18,16,0,16
829756,2,11,18,3,0,3
829786,2,11,18,20,1,21
980912,2,11,18,11,1,12
980928,2,11,18,12,0,12
980940,2,11,18,7,0,7
980972,2,11,18,7,0,7
980996,2,11,18,18,1,19
981014,2,11,18,8,0,8
981022,2,11,18,10,0,10
1082604,2,11,18,3,0,3
1082634,2,11,18,10,0,10
1082638,2,11,18,7,0,7
1082643,2,11,18,12,0,12
980916,1,12,18,5,0,5
980924,1,12,18,8,1,9
980944,1,12,18,14,0,14
980954,1,12,18,9,0,9
980962,1,12,18,7,0,7
980974,1,12,18,9,0,9
980994,1,12,18,1,0,1
1082594,1,12,18,2,3,5
1082603,1,12,18,5,1,6
1082607,1,12,18,2,0,2
1082618,1,12,18,5,0,5
1082620,1,12,18,5,0,5
1082624,1,12,18,10,0,10
1082634,1,12,18,6,1,7
1082647,1,12,18,6,1,7
980936,2,12,18,25,0,25
980970,2,12,18,15,5,20
980984,2,12,18,14,1,15
981010,2,12,18,13,2,15
1082592,2,12,18,7,0,7
1082615,2,12,18,17,0,17
1082629,2,12,18,11,0,11
1082631,2,12,18,2,0,2
1082642,2,12,18,5,0,5
1082650,2,12,18,7,0,7
980934,1,13,18,8,0,8
980950,1,13,18,10,1,11
980966,1,13,18,7,0,7
980972,1,13,18,7,0,7
981018,1,13,18,7,5,12
981022,1,13,18,10,0,10
1082593,1,13,18,11,1,12
1082596,1,13,18,4,0,4
1082606,1,13,18,9,0,9
1082625,1,13,18,19,0,19
1082629,1,13,18,2,0,2
1082632,1,13,18,6,0,6
1082640,1,13,18,11,0,11
1082643,1,13,18,6,2,8
980910,2,13,18,7,0,7
980916,2,13,18,10,2,12
980922,2,13,18,9,1,10
980942,2,13,18,5,1,6
980954,2,13,18,4,0,4
980960,2,13,18,11,1,12
980980,2,13,18,8,0,8
980992,2,13,18,1,1,2
981012,2,13,18,6,0,6
1082603,2,13,18,20,1,21
1082610,2,13,18,11,0,11
1082613,2,13,18,12,0,12
1082616,2,13,18,4,2,6
1082637,2,13,18,4,0,4
335987,1,1,19,21,0,21
335998,1,1,19,8,0,8
336002,1,1,19,4,4,8
336019,1,1,19,9,1,10
336022,1,1,19,10,0,10
336030,1,1,19,7,1,8
336032,1,1,19,13,0,13
392189,1,1,19,4,1,5
392204,1,1,19,11,1,12
392212,1,1,19,9,1,10
392216,1,1,19,8,0,8
392224,1,1,19,7,0,7
392226,1,1,19,16,0,16
392233,1,1,19,26,2,28
419111,1,1,19,12,1,13
419127,1,1,19,8,1,9
419132,1,1,19,9,0,9
419140,1,1,19,10,0,10
419144,1,1,19,10,0,10
419149,1,1,19,13,0,13
419153,1,1,19,15,0,15
419158,1,1,19,6,0,6
501208,1,1,19,7,0,7
501227,1,1,19,10,0,10
501235,1,1,19,12,0,12
501244,1,1,19,9,1,10
501272,1,1,19,10,0,10
501274,1,1,19,8,1,9
548320,1,1,19,3,0,3
548349,1,1,19,14,0,14
548358,1,1,19,7,0,7
548373,1,1,19,9,2,11
548375,1,1,19,7,1,8
548380,1,1,19,10,0,10
548383,1,1,19,15,0,15
598013,1,1,19,13,0,13
598018,1,1,19,14,1,15
598027,1,1,19,8,0,8
598034,1,1,19,10,0,10
598045,1,1,19,10,0,10
598058,1,1,19,9,2,11
598074,1,1,19,10,0,10
729284,1,1,19,4,1,5
729294,1,1,19,10,0,10
729304,1,1,19,8,1,9
734032,1,1,19,8,0,8
734048,1,1,19,3,0,3
829718,1,1,19,13,1,14
829766,1,1,19,10,0,10
829786,1,1,19,9,0,9
980914,1,1,19,9,1,10
980952,1,1,19,10,0,10
980968,1,1,19,10,0,10
980980,1,1,19,12,0,12
981000,1,1,19,9,1,10
981006,1,1,19,4,0,4
981014,1,1,19,3,0,3
1082597,1,1,19,11,0,11
1082604,1,1,19,7,2,9
1082613,1,1,19,12,0,12
1082617,1,1,19,5,0,5
1082631,1,1,19,21,0,21
1082649,1,1,19,1,0,1
335991,2,1,19,8,1,9
336005,2,1,19,3,1,4
336008,2,1,19,18,0,18
336040,2,1,19,8,0,8
392195,2,1,19,8,1,9
392208,2,1,19,4,0,4
392236,2,1,19,19,0,19
392238,2,1,19,6,1,7
419114,2,1,19,2,0,2
419118,2,1,19,6,0,6
419123,2,1,19,4,1,5
419136,2,1,19,9,0,9
501203,2,1,19,17,0,17
501214,2,1,19,3,0,3
501224,2,1,19,12,0,12
501247,2,1,19,6,0,6
548317,2,1,19,3,0,3
548325,2,1,19,12,2,14
548328,2,1,19,4,0,4
548340,2,1,19,9,1,10
548352,2,1,19,10,0,10
548362,2,1,19,1,2,3
548368,2,1,19,6,0,6
548386,2,1,19,10,1,11
598003,2,1,19,3,0,3
598010,2,1,19,3,0,3
598021,2,1,19,19,0,19
598036,2,1,19,1,1,2
598039,2,1,19,8,2,10
598055,2,1,19,1,0,1
598062,2,1,19,6,0,6
598066,2,1,19,4,0,4
729312,2,1,19,1,1,2
729320,2,1,19,3,1,4
733984,2,1,19,5,2,7
733990,2,1,19,5,0,5
734014,2,1,19,6,0,6
734020,2,1,19,6,0,6
734054,2,1,19,10,0,10
829710,2,1,19,5,0,5
829728,2,1,19,5,0,5
829744,2,1,19,2,0,2
829770,2,1,19,13,0,13
829796,2,1,19,5,0,5
829810,2,1,19,8,1,9
829816,2,1,19,19,1,20
980920,2,1,19,4,0,4
980944,2,1,19,10,1,11
980956,2,1,19,2,1,3
980964,2,1,19,16,0,16
981020,2,1,19,7,1,8
1082608,2,1,19,7,0,7
1082620,2,1,19,4,0,4
1082627,2,1,19,4,1,5
1082639,2,1,19,9,0,9
1082644,2,1,19,7,0,7
335997,1,2,19,9,0,9
336011,1,2,19,9,0,9
336021,1,2,19,2,1,3
336031,1,2,19,6,0,6
336034,1,2,19,13,0,13
336039,1,2,19,13,0,13
392187,1,2,19,11,0,11
392196,1,2,19,16,1,17
392199,1,2,19,13,0,13
392209,1,2,19,2,0,2
392218,1,2,19,9,0,9
392241,1,2,19,7,1,8
419114,1,2,19,9,0,9
419128,1,2,19,24,0,24
419138,1,2,19,18,0,18
419150,1,2,19,13,0,13
501210,1,2,19,8,0,8
501237,1,2,19,10,0,10
501249,1,2,19,10,1,11
501273,1,2,19,19,0,19
501275,1,2,19,11,2,13
548315,1,2,19,18,0,18
548323,1,2,19,8,0,8
548341,1,2,19,19,2,21
548355,1,2,19,13,1,14
548367,1,2,19,8,1,9
548372,1,2,19,13,0,13
548377,1,2,19,13,1,14
598004,1,2,19,6,2,8
598009,1,2,19,11,0,11
598017,1,2,19,20,0,20
598032,1,2,19,17,2,19
598041,1,2,19,5,0,5
598047,1,2,19,7,0,7
598050,1,2,19,13,1,14
598059,1,2,19,12,0,12
598062,1,2,19,4,0,4
598069,1,2,19,12,0,12
729318,1,2,19,6,4,10
734004,1,2,19,21,0,21
734010,1,2,19,8,1,9
734026,1,2,19,6,0,6
734040,1,2,19,11,0,11
829724,1,2,19,10,1,11
829768,1,2,19,12,1,13
829790,1,2,19,15,0,15
829800,1,2,19,13,1,14
829824,1,2,19,15,0,15
829826,1,2,19,7,0,7
980912,1,2,19,27,1,28
980926,1,2,19,4,2,6
980932,1,2,19,17,1,18
980936,1,2,19,15,1,16
980942,1,2,19,11,0,11
980964,1,2,19,13,0,13
980982,1,2,19,6,2,8
980986,1,2,19,5,2,7
980992,1,2,19,30,0,30
1082595,1,2,19,6,0,6
1082598,1,2,19,18,1,19
1082602,1,2,19,5,0,5
1082610,1,2,19,18,0,18
1082621,1,2,19,10,0,10
1082628,1,2,19,10,0,10
1082636,1,2,19,11,1,12
1082646,1,2,19,7,3,10
335990,2,2,19,8,0,8
336001,2,2,19,8,0,8
336003,2,2,19,5,0,5
336007,2,2,19,21,0,21
336028,2,2,19,4,0,4
392193,2,2,19,15,1,16
392204,2,2,19,3,1,4
392213,2,2,19,1,0,1
392223,2,2,19,7,0,7
392226,2,2,19,16,0,16
392229,2,2,19,12,0,12
392237,2,2,19,7,2,9
392243,2,2,19,13,1,14
392244,2,2,19,12,0,12
419117,2,2,19,10,1,11
419124,2,2,19,9,0,9
419133,2,2,19,11,0,11
419141,2,2,19,9,0,9
419145,2,2,19,6,0,6
419156,2,2,19,1,0,1
419162,2,2,19,7,1,8
419167,2,2,19,12,0,12
501205,2,2,19,12,1,13
501213,2,2,19,3,2,5
501216,2,2,19,9,1,10
501227,2,2,19,4,0,4
501232,2,2,19,8,1,9
501276,2,2,19,5,1,6
548320,2,2,19,10,2,12
548329,2,2,19,6,0,6
548332,2,2,19,7,0,7
548336,2,2,19,3,0,3
548349,2,2,19,23,0,23
548361,2,2,19,19,0,19
548381,2,2,19,8,0,8
598022,2,2,19,5,0,5
598038,2,2,19,14,0,14
729304,2,2,19,8,1,9
733982,2,2,19,23,1,24
733988,2,2,19,8,0,8
733996,2,2,19,6,0,6
734018,2,2,19,4,0,4
734032,2,2,19,12,1,13
829718,2,2,19,15,0,15
829742,2,2,19,6,1,7
829750,2,2,19,13,0,13
829784,2,2,19,7,0,7
980958,2,2,19,10,1,11
980974,2,2,19,17,1,18
981000,2,2,19,13,0,13
981016,2,2,19,1,0,1
981018,2,2,19,3,0,3
981024,2,2,19,11,1,12
1082591,2,2,19,8,1,9
1082607,2,2,19,6,0,6
1082624,2,2,19,2,0,2
1082633,2,2,19,4,0,4
335988,1,3,19,15,0,15
335994,1,3,19,11,1,12
336001,1,3,19,23,1,24
336006,1,3,19,14,0,14
336010,1,3,19,11,0,11
336012,1,3,19,3,0,3
336018,1,3,19,15,2,17
336023,1,3,19,14,0,14
336045,1,3,19,6,3,9
392190,1,3,19,7,0,7
392201,1,3,19,6,0,6
392207,1,3,19,8,1,9
392211,1,3,19,5,0,5
392214,1,3,19,12,0,12
392229,1,3,19,5,0,5
392236,1,3,19,7,0,7
392239,1,3,19,1,0,1
392243,1,3,19,10,0,10
419118,1,3,19,17,0,17
419130,1,3,19,12,0,12
419142,1,3,19,8,1,9
419147,1,3,19,11,0,11
419152,1,3,19,7,0,7
419160,1,3,19,9,2,11
419168,1,3,19,8,4,12
419170,1,3,19,11,0,11
501203,1,3,19,5,0,5
501211,1,3,19,9,1,10
501216,1,3,19,8,0,8
501231,1,3,19,7,0,7
501241,1,3,19,20,1,21
501250,1,3,19,9,0,9
501254,1,3,19,13,0,13
501258,1,3,19,20,0,20
501266,1,3,19,12,2,14
501271,1,3,19,9,0,9
501276,1,3,19,9,1,10
548311,1,3,19,5,0,5
548316,1,3,19,16,1,17
548321,1,3,19,9,0,9
548327,1,3,19,7,0,7
548335,1,3,19,8,1,9
548352,1,3,19,11,0,11
548357,1,3,19,8,0,8
548360,1,3,19,8,1,9
548376,1,3,19,12,0,12
548384,1,3,19,18,0,18
548385,1,3,19,23,2,25
548386,1,3,19,11,0,11
598025,1,3,19,9,1,10
598039,1,3,19,9,0,9
598043,1,3,19,12,0,12
598046,1,3,19,12,1,13
598056,1,3,19,10,0,10
598063,1,3,19,14,0,14
598067,1,3,19,18,0,18
598075,1,3,19,12,0,12
729288,1,3,19,7,0,7
729298,1,3,19,12,0,12
729302,1,3,19,9,2,11
734018,1,3,19,8,0,8
734028,1,3,19,8,0,8
734034,1,3,19,6,1,7
829712,1,3,19,9,0,9
829716,1,3,19,10,0,10
829728,1,3,19,7,0,7
829740,1,3,19,8,2,10
829750,1,3,19,13,1,14
829758,1,3,19,17,0,17
829770,1,3,19,3,0,3
829784,1,3,19,7,0,7
829794,1,3,19,14,0,14
829802,1,3,19,17,0,17
829806,1,3,19,3,1,4
336014,2,3,19,7,0,7
336034,2,3,19,1,1,2
336038,2,3,19,11,1,12
336042,2,3,19,10,0,10
392186,2,3,19,6,0,6
392194,2,3,19,8,1,9
392207,2,3,19,4,0,4
392222,2,3,19,3,0,3
392232,2,3,19,7,0,7
419115,2,3,19,9,0,9
419121,2,3,19,14,0,14
419126,2,3,19,2,1,3
419128,2,3,19,7,0,7
419134,2,3,19,5,0,5
419138,2,3,19,14,2,16
419164,2,3,19,13,0,13
501226,2,3,19,3,0,3
501233,2,3,19,6,0,6
501245,2,3,19,7,0,7
501273,2,3,19,21,0,21
548323,2,3,19,28,0,28
548337,2,3,19,8,0,8
548348,2,3,19,15,0,15
548366,2,3,19,6,6,12
548373,2,3,19,18,0,18
598007,2,3,19,9,2,11
598017,2,3,19,12,1,13
598020,2,3,19,6,0,6
598027,2,3,19,15,0,15
598031,2,3,19,5,1,6
598035,2,3,19,13,0,13
598078,2,3,19,7,1,8
729308,2,3,19,9,0,9
729316,2,3,19,4,0,4
733986,2,3,19,5,0,5
733992,2,3,19,9,0,9
734000,2,3,19,6,0,6
734008,2,3,19,13,0,13
734050,2,3,19,5,1,6
734052,2,3,19,10,4,14
829778,2,3,19,9,0,9
829822,2,3,19,5,0,5
829826,2,3,19,8,0,8
829828,2,3,19,3,0,3
335992,1,4,19,11,0,11
335996,1,4,19,10,2,12
336008,1,4,19,7,0,7
336024,1,4,19,13,0,13
336033,1,4,19,13,0,13
336040,1,4,19,7,0,7
336044,1,4,19,14,0,14
392191,1,4,19,7,1,8
392200,1,4,19,5,2,7
392205,1,4,19,5,0,5
392227,1,4,19,1,0,1
392234,1,4,19,5,0,5
419113,1,4,19,6,0,6
419117,1,4,19,12,0,12
419126,1,4,19,2,0,2
419137,1,4,19,11,0,11
419141,1,4,19,11,0,11
419148,1,4,19,5,1,6
419161,1,4,19,18,0,18
419164,1,4,19,19,0,19
501207,1,4,19,14,1,15
501225,1,4,19,7,0,7
501239,1,4,19,7,0,7
501253,1,4,19,6,0,6
501256,1,4,19,7,0,7
501262,1,4,19,10,0,10
501265,1,4,19,7,4,11
548328,1,4,19,19,0,19
548333,1,4,19,7,0,7
548336,1,4,19,10,0,10
548344,1,4,19,12,0,12
548348,1,4,19,10,0,10
548364,1,4,19,9,0,9
548374,1,4,19,5,0,5
548379,1,4,19,4,0,4
598012,1,4,19,3,1,4
598019,1,4,19,8,0,8
598021,1,4,19,22,1,23
598026,1,4,19,2,0,2
598033,1,4,19,17,0,17
598036,1,4,19,2,0,2
598057,1,4,19,3,0,3
598071,1,4,19,10,0,10
729300,1,4,19,4,2,6
729312,1,4,19,1,0,1
733978,1,4,19,16,4,20
733992,1,4,19,17,0,17
733996,1,4,19,4,0,4
734002,1,4,19,6,1,7
734030,1,4,19,14,0,14
734038,1,4,19,22,1,23
734052,1,4,19,7,0,7
734054,1,4,19,16,1,17
829722,1,4,19,11,0,11
829730,1,4,19,19,0,19
829738,1,4,19,6,0,6
829772,1,4,19,6,0,6
829796,1,4,19,7,2,9
829814,1,4,19,14,0,14
980910,1,4,19,9,0,9
980918,1,4,19,3,0,3
980930,1,4,19,5,0,5
980940,1,4,19,15,0,15
980960,1,4,19,6,0,6
980976,1,4,19,15,1,16
980996,1,4,19,8,0,8
981010,1,4,19,6,0,6
1082601,1,4,19,10,0,10
1082612,1,4,19,8,2,10
1082616,1,4,19,18,0,18
1082633,1,4,19,0,0,0
1082637,1,4,19,16,0,16
1082639,1,4,19,10,0,10
1082641,1,4,19,6,1,7
335988,2,4,19,7,0,7
336000,2,4,19,3,0,3
336004,2,4,19,8,1,9
336011,2,4,19,6,1,7
336018,2,4,19,9,0,9
336036,2,4,19,16,0,16
392196,2,4,19,14,1,15
392209,2,4,19,4,0,4
392212,2,4,19,11,0,11
392215,2,4,19,1,0,1
392221,2,4,19,10,1,11
392231,2,4,19,9,4,13
392239,2,4,19,8,0,8
419122,2,4,19,14,0,14
419129,2,4,19,10,1,11
419132,2,4,19,8,1,9
419144,2,4,19,8,0,8
419151,2,4,19,12,0,12
419154,2,4,19,1,0,1
501211,2,4,19,11,0,11
501228,2,4,19,7,0,7
501242,2,4,19,5,1,6
501249,2,4,19,1,0,1
501259,2,4,19,12,0,12
501269,2,4,19,12,0,12
548314,2,4,19,10,0,10
548318,2,4,19,8,1,9
548339,2,4,19,11,0,11
548355,2,4,19,2,0,2
548359,2,4,19,4,0,4
548371,2,4,19,8,0,8
598030,2,4,19,13,0,13
598042,2,4,19,9,0,9
598046,2,4,19,11,0,11
598050,2,4,19,4,0,4
598061,2,4,19,4,0,4
729288,2,4,19,12,0,12
729296,2,4,19,11,0,11
729318,2,4,19,11,1,12
734012,2,4,19,9,0,9
734024,2,4,19,2,0,2
734048,2,4,19,4,0,4
829714,2,4,19,8,1,9
829746,2,4,19,10,1,11
829758,2,4,19,4,0,4
829764,2,4,19,2,1,3
829780,2,4,19,9,2,11
829804,2,4,19,11,0,11
980924,2,4,19,9,0,9
980946,2,4,19,7,3,10
980968,2,4,19,10,0,10
980982,2,4,19,7,0,7
1082594,2,4,19,6,1,7
1082605,2,4,19,4,0,4
1082609,2,4,19,4,1,5
1082623,2,4,19,8,0,8
335989,1,5,19,10,0,10
336005,1,5,19,7,2,9
336028,1,5,19,9,0,9
336038,1,5,19,5,0,5
336043,1,5,19,16,0,16
392195,1,5,19,4,3,7
392215,1,5,19,21,2,23
392222,1,5,19,4,2,6
392230,1,5,19,2,2,4
392238,1,5,19,4,0,4
419116,1,5,19,7,0,7
419120,1,5,19,3,0,3
419123,1,5,19,6,0,6
419129,1,5,19,10,0,10
419134,1,5,19,10,0,10
419146,1,5,19,9,3,12
419159,1,5,19,9,0,9
419163,1,5,19,6,2,8
501214,1,5,19,8,3,11
501245,1,5,19,4,0,4
501257,1,5,19,5,6,11
501263,1,5,19,5,0,5
548314,1,5,19,12,1,13
548317,1,5,19,14,1,15
548325,1,5,19,3,0,3
548329,1,5,19,5,4,9
548337,1,5,19,9,0,9
548354,1,5,19,6,0,6
548359,1,5,19,15,1,16
548366,1,5,19,9,0,9
548370,1,5,19,5,0,5
548378,1,5,19,5,1,6
548382,1,5,19,6,2,8
598006,1,5,19,2,0,2
598010,1,5,19,17,1,18
598014,1,5,19,4,0,4
598024,1,5,19,6,1,7
598028,1,5,19,2,0,2
598031,1,5,19,7,0,7
598048,1,5,19,4,0,4
598077,1,5,19,11,4,15
729296,1,5,19,6,3,9
729320,1,5,19,10,0,10
733984,1,5,19,9,0,9
734008,1,5,19,4,0,4
734016,1,5,19,17,0,17
734046,1,5,19,11,1,12
829714,1,5,19,20,0,20
829746,1,5,19,9,1,10
829754,1,5,19,5,0,5
829782,1,5,19,14,1,15
829816,1,5,19,11,0,11
335992,2,5,19,4,0,4
335995,2,5,19,4,2,6
336020,2,5,19,5,0,5
336024,2,5,19,6,1,7
336041,2,5,19,16,1,17
336045,2,5,19,10,0,10
392200,2,5,19,4,0,4
392203,2,5,19,6,0,6
392207,2,5,19,0,0,0
392210,2,5,19,8,1,9
392225,2,5,19,5,0,5
392235,2,5,19,4,0,4
419112,2,5,19,6,1,7
419142,2,5,19,4,0,4
419155,2,5,19,12,0,12
501204,2,5,19,18,0,18
501209,2,5,19,11,0,11
501225,2,5,19,9,1,10
501236,2,5,19,1,0,1
501240,2,5,19,12,1,13
501254,2,5,19,3,0,3
548322,2,5,19,1,0,1
548331,2,5,19,13,1,14
548341,2,5,19,5,0,5
548350,2,5,19,3,0,3
598019,2,5,19,1,0,1
598041,2,5,19,7,0,7
598052,2,5,19,13,0,13
598057,2,5,19,12,0,12
598068,2,5,19,10,0,10
598070,2,5,19,14,0,14
598076,2,5,19,5,0,5
729290,2,5,19,9,0,9
729302,2,5,19,5,0,5
733980,2,5,19,8,0,8
733994,2,5,19,7,2,9
734004,2,5,19,19,2,21
734022,2,5,19,17,1,18
734038,2,5,19,18,0,18
829720,2,5,19,7,0,7
829726,2,5,19,11,0,11
829732,2,5,19,7,0,7
829740,2,5,19,1,0,1
829774,2,5,19,6,0,6
829792,2,5,19,22,0,22
829802,2,5,19,4,2,6
829824,2,5,19,4,0,4
336000,1,6,19,13,0,13
336003,1,6,19,6,0,6
336014,1,6,19,9,0,9
336020,1,6,19,27,0,27
336025,1,6,19,9,0,9
392194,1,6,19,22,0,22
392203,1,6,19,0,2,2
392228,1,6,19,10,0,10
392231,1,6,19,3,0,3
392235,1,6,19,24,1,25
392237,1,6,19,7,0,7
392242,1,6,19,8,1,9
419121,1,6,19,14,0,14
419133,1,6,19,17,1,18
419136,1,6,19,16,0,16
419139,1,6,19,9,0,9
419145,1,6,19,19,0,19
419154,1,6,19,4,0,4
501209,1,6,19,15,1,16
501228,1,6,19,12,0,12
501232,1,6,19,8,3,11
501238,1,6,19,9,0,9
501243,1,6,19,9,0,9
548347,1,6,19,2,0,2
548350,1,6,19,5,2,7
548362,1,6,19,12,1,13
548369,1,6,19,12,1,13
598003,1,6,19,12,0,12
598015,1,6,19,3,1,4
598022,1,6,19,15,0,15
598040,1,6,19,21,0,21
598049,1,6,19,2,0,2
598054,1,6,19,12,0,12
598064,1,6,19,9,0,9
729286,1,6,19,13,0,13
733980,1,6,19,11,0,11
733986,1,6,19,9,0,9
733990,1,6,19,8,4,12
733998,1,6,19,2,0,2
734024,1,6,19,4,0,4
734044,1,6,19,0,0,0
829720,1,6,19,9,0,9
829736,1,6,19,16,0,16
829744,1,6,19,20,0,20
829752,1,6,19,5,1,6
829762,1,6,19,1,0,1
829788,1,6,19,5,1,6
829818,1,6,19,15,1,16
980938,1,6,19,4,3,7
980956,1,6,19,12,1,13
980970,1,6,19,5,0,5
981002,1,6,19,8,0,8
981016,1,6,19,9,0,9
1082599,1,6,19,22,0,22
1082605,1,6,19,16,0,16
1082608,1,6,19,4,1,5
1082622,1,6,19,5,0,5
1082642,1,6,19,1,2,3
336006,2,6,19,15,1,16
336009,2,6,19,1,0,1
336031,2,6,19,6,0,6
336037,2,6,19,8,0,8
392199,2,6,19,12,0,12
392206,2,6,19,16,2,18
392211,2,6,19,2,0,2
392216,2,6,19,13,0,13
392220,2,6,19,11,0,11
419113,2,6,19,13,0,13
419125,2,6,19,6,0,6
419149,2,6,19,4,1,5
419157,2,6,19,7,0,7
419160,2,6,19,4,0,4
419165,2,6,19,10,0,10
501218,2,6,19,13,0,13
501221,2,6,19,11,1,12
501235,2,6,19,2,0,2
501248,2,6,19,11,0,11
501251,2,6,19,7,1,8
501258,2,6,19,15,0,15
501262,2,6,19,3,0,3
548315,2,6,19,8,0,8
548326,2,6,19,6,0,6
548338,2,6,19,15,0,15
548374,2,6,19,14,0,14
548377,2,6,19,13,1,14
548379,2,6,19,4,0,4
548383,2,6,19,7,0,7
598006,2,6,19,7,1,8
598011,2,6,19,14,0,14
598033,2,6,19,19,0,19
598059,2,6,19,13,2,15
598067,2,6,19,5,0,5
598072,2,6,19,6,0,6
729294,2,6,19,1,4,5
729306,2,6,19,11,0,11
729314,2,6,19,8,0,8
734010,2,6,19,13,1,14
734016,2,6,19,6,0,6
734036,2,6,19,6,1,7
829712,2,6,19,7,1,8
829730,2,6,19,3,1,4
829766,2,6,19,6,0,6
829782,2,6,19,12,3,15
829798,2,6,19,4,2,6
980926,2,6,19,7,1,8
980950,2,6,19,4,0,4
980976,2,6,19,3,0,3
980988,2,6,19,6,0,6
980998,2,6,19,3,0,3
981008,2,6,19,5,0,5
1082595,2,6,19,2,0,2
1082611,2,6,19,9,1,10
1082614,2,6,19,5,0,5
1082630,2,6,19,11,0,11
1082640,2,6,19,6,0,6
1082646,2,6,19,13,1,14
335990,1,7,19,9,0,9
335999,1,7,19,11,1,12
336009,1,7,19,20,2,22
336029,1,7,19,9,6,15
336037,1,7,19,16,1,17
336041,1,7,19,1,1,2
392186,1,7,19,9,0,9
392202,1,7,19,8,0,8
392208,1,7,19,8,2,10
392213,1,7,19,18,0,18
392220,1,7,19,8,1,9
392223,1,7,19,9,0,9
392232,1,7,19,5,0,5
392240,1,7,19,11,0,11
419112,1,7,19,9,0,9
419119,1,7,19,7,1,8
419124,1,7,19,8,0,8
419135,1,7,19,19,0,19
419143,1,7,19,19,1,20
419151,1,7,19,15,0,15
419155,1,7,19,11,0,11
419157,1,7,19,11,0,11
419162,1,7,19,8,0,8
419166,1,7,19,9,0,9
419167,1,7,19,17,0,17
501215,1,7,19,14,0,14
501226,1,7,19,17,0,17
501229,1,7,19,16,0,16
501236,1,7,19,2,0,2
501242,1,7,19,4,0,4
501246,1,7,19,24,3,27
501251,1,7,19,10,0,10
501268,1,7,19,7,0,7
548322,1,7,19,9,0,9
548330,1,7,19,3,0,3
548339,1,7,19,8,0,8
548356,1,7,19,16,1,17
548365,1,7,19,10,0,10
548368,1,7,19,4,0,4
598007,1,7,19,11,2,13
598011,1,7,19,22,0,22
598016,1,7,19,9,0,9
598029,1,7,19,14,0,14
598038,1,7,19,16,0,16
598042,1,7,19,8,0,8
598044,1,7,19,5,0,5
598051,1,7,19,7,1,8
598055,1,7,19,9,1,10
598068,1,7,19,7,0,7
598078,1,7,19,6,0,6
729292,1,7,19,8,1,9
729308,1,7,19,2,0,2
729314,1,7,19,13,0,13
733988,1,7,19,24,0,24
734000,1,7,19,10,0,10
734014,1,7,19,9,0,9
734022,1,7,19,10,2,12
734036,1,7,19,4,0,4
734050,1,7,19,11,0,11
829710,1,7,19,15,0,15
829726,1,7,19,20,0,20
829734,1,7,19,15,0,15
829742,1,7,19,9,0,9
829756,1,7,19,7,1,8
829774,1,7,19,16,0,16
829780,1,7,19,9,0,9
829810,1,7,19,16,1,17
829822,1,7,19,12,3,15
829828,1,7,19,8,0,8
980906,1,7,19,13,1,14
980922,1,7,19,14,3,17
980928,1,7,19,5,1,6
980946,1,7,19,9,0,9
980990,1,7,19,3,0,3
980998,1,7,19,16,0,16
981012,1,7,19,4,2,6
1082592,1,7,19,9,0,9
1082614,1,7,19,8,1,9
1082635,1,7,19,5,2,7
1082638,1,7,19,6,0,6
1082644,1,7,19,11,0,11
1082650,1,7,19,10,0,10
335994,2,7,19,9,0,9
335996,2,7,19,2,1,3
336002,2,7,19,6,0,6
336033,2,7,19,8,0,8
392197,2,7,19,4,0,4
392205,2,7,19,7,0,7
392217,2,7,19,9,0,9
392230,2,7,19,9,1,10
419127,2,7,19,4,0,4
419130,2,7,19,13,0,13
419137,2,7,19,13,0,13
419147,2,7,19,4,0,4
419170,2,7,19,6,0,6
501210,2,7,19,5,0,5
501223,2,7,19,6,0,6
501261,2,7,19,16,0,16
501272,2,7,19,7,2,9
501274,2,7,19,8,0,8
501275,2,7,19,4,1,5
548313,2,7,19,5,0,5
548319,2,7,19,4,1,5
548344,2,7,19,27,0,27
548347,2,7,19,8,0,8
548351,2,7,19,3,1,4
548360,2,7,19,8,1,9
548372,2,7,19,9,0,9
548375,2,7,19,3,0,3
548382,2,7,19,0,1,1
548384,2,7,19,13,0,13
598004,2,7,19,7,0,7
598024,2,7,19,4,0,4
598034,2,7,19,8,0,8
598060,2,7,19,4,0,4
598065,2,7,19,5,0,5
598071,2,7,19,3,0,3
598075,2,7,19,4,0,4
598077,2,7,19,14,1,15
729284,2,7,19,4,0,4
729322,2,7,19,6,1,7
733978,2,7,19,19,1,20
734006,2,7,19,9,0,9
734030,2,7,19,9,0,9
829722,2,7,19,17,0,17
829752,2,7,19,2,2,4
829788,2,7,19,14,0,14
829794,2,7,19,24,1,25
829800,2,7,19,6,0,6
980914,2,7,19,17,0,17
980938,2,7,19,10,1,11
980962,2,7,19,8,0,8
980986,2,7,19,9,2,11
1082597,2,7,19,18,1,19
1082600,2,7,19,4,0,4
1082602,2,7,19,11,1,12
1082606,2,7,19,8,1,9
1082618,2,7,19,5,2,7
1082625,2,7,19,4,0,4
1082628,2,7,19,11,0,11
1082641,2,7,19,6,1,7
1082647,2,7,19,9,0,9
335991,1,8,19,5,0,5
335993,1,8,19,12,0,12
335995,1,8,19,15,2,17
336004,1,8,19,17,0,17
336007,1,8,19,5,1,6
336016,1,8,19,8,0,8
336036,1,8,19,8,1,9
336042,1,8,19,12,1,13
392193,1,8,19,4,0,4
392197,1,8,19,6,0,6
392206,1,8,19,1,0,1
392210,1,8,19,4,0,4
392217,1,8,19,12,1,13
392221,1,8,19,6,1,7
392225,1,8,19,9,0,9
392244,1,8,19,9,0,9
419115,1,8,19,8,0,8
419122,1,8,19,5,0,5
419125,1,8,19,8,0,8
419131,1,8,19,16,0,16
419156,1,8,19,8,0,8
419165,1,8,19,10,0,10
419169,1,8,19,0,0,0
501204,1,8,19,14,0,14
501213,1,8,19,11,0,11
501217,1,8,19,11,1,12
501221,1,8,19,5,0,5
501234,1,8,19,9,1,10
501248,1,8,19,5,0,5
501255,1,8,19,6,0,6
501261,1,8,19,5,3,8
501269,1,8,19,9,0,9
548319,1,8,19,7,0,7
548326,1,8,19,15,1,16
548331,1,8,19,18,0,18
548334,1,8,19,7,1,8
548340,1,8,19,4,0,4
548346,1,8,19,6,0,6
548351,1,8,19,1,0,1
548353,1,8,19,24,1,25
548361,1,8,19,11,0,11
548371,1,8,19,19,1,20
548381,1,8,19,3,4,7
336019,2,8,19,9,2,11
336025,2,8,19,10,0,10
336029,2,8,19,10,0,10
336039,2,8,19,4,1,5
392201,2,8,19,7,1,8
392228,2,8,19,8,0,8
392233,2,8,19,6,0,6
392234,2,8,19,12,2,14
392241,2,8,19,7,0,7
419111,2,8,19,3,1,4
419140,2,8,19,6,0,6
419143,2,8,19,2,0,2
419146,2,8,19,13,0,13
419150,2,8,19,10,0,10
419152,2,8,19,10,1,11
419161,2,8,19,17,1,18
419168,2,8,19,1,0,1
501208,2,8,19,8,1,9
501229,2,8,19,5,1,6
501241,2,8,19,6,0,6
501244,2,8,19,11,0,11
501264,2,8,19,7,0,7
548357,2,8,19,8,1,9
548364,2,8,19,6,4,10
548378,2,8,19,10,0,10
501205,1,9,19,6,0,6
501212,1,9,19,9,0,9
501224,1,9,19,9,0,9
501230,1,9,19,6,1,7
501247,1,9,19,8,1,9
501252,1,9,19,7,0,7
501259,1,9,19,7,0,7
501215,2,9,19,20,0,20
501238,2,9,19,1,0,1
501266,2,9,19,19,0,19
501218,1,10,19,9,1,10
501233,1,10,19,3,0,3
501240,1,10,19,5,2,7
501264,1,10,19,8,1,9
501267,1,10,19,6,1,7
548313,1,10,19,8,0,8
548318,1,10,19,24,3,27
548324,1,10,19,1,2,3
548332,1,10,19,10,1,11
548338,1,10,19,9,0,9
548342,1,10,19,9,0,9
548363,1,10,19,8,1,9
598008,1,10,19,5,0,5
598020,1,10,19,16,0,16
598030,1,10,19,18,2,20
598052,1,10,19,14,0,14
598060,1,10,19,5,1,6
598066,1,10,19,11,0,11
598072,1,10,19,23,1,24
501212,2,10,19,16,0,16
501231,2,10,19,6,1,7
501237,2,10,19,1,1,2
501246,2,10,19,10,0,10
501255,2,10,19,1,0,1
548327,2,10,19,12,0,12
548335,2,10,19,4,0,4
548346,2,10,19,10,1,11
548353,2,10,19,17,0,17
548356,2,10,19,4,0,4
548358,2,10,19,4,0,4
548367,2,10,19,6,0,6
548370,2,10,19,4,0,4
548380,2,10,19,4,0,4
598005,2,10,19,1,0,1
598014,2,10,19,10,0,10
598016,2,10,19,6,0,6
598023,2,10,19,2,0,2
598032,2,10,19,2,0,2
598040,2,10,19,7,0,7
598043,2,10,19,7,0,7
598047,2,10,19,4,0,4
598058,2,10,19,2,0,2
598005,1,11,19,4,0,4
598023,1,11,19,12,0,12
598035,1,11,19,17,0,17
598037,1,11,19,9,0,9
598053,1,11,19,10,1,11
598061,1,11,19,14,0,14
598065,1,11,19,4,1,5
598070,1,11,19,6,1,7
598076,1,11,19,9,0,9
729290,1,11,19,6,3,9
729306,1,11,19,14,0,14
729316,1,11,19,19,1,20
729322,1,11,19,16,2,18
733982,1,11,19,8,1,9
733994,1,11,19,7,0,7
734006,1,11,19,14,1,15
734012,1,11,19,24,2,26
734020,1,11,19,6,1,7
734042,1,11,19,16,1,17
829732,1,11,19,11,0,11
829748,1,11,19,6,0,6
829764,1,11,19,5,0,5
829778,1,11,19,15,0,15
829792,1,11,19,10,1,11
829798,1,11,19,21,0,21
829804,1,11,19,11,0,11
829820,1,11,19,10,1,11
980920,1,11,19,9,1,10
980948,1,11,19,11,2,13
980958,1,11,19,14,0,14
980978,1,11,19,13,0,13
980984,1,11,19,15,0,15
980988,1,11,19,2,0,2
981008,1,11,19,14,0,14
981020,1,11,19,3,2,5
981024,1,11,19,11,5,16
1082591,1,11,19,12,0,12
1082600,1,11,19,5,1,6
1082609,1,11,19,10,0,10
1082611,1,11,19,4,0,4
1082615,1,11,19,14,1,15
1082623,1,11,19,20,0,20
1082627,1,11,19,15,1,16
1082630,1,11,19,13,0,13
1082648,1,11,19,3,0,3
598009,2,11,19,7,0,7
598015,2,11,19,6,0,6
598018,2,11,19,4,0,4
598026,2,11,19,20,1,21
598056,2,11,19,7,0,7
598074,2,11,19,16,0,16
729300,2,11,19,4,0,4
734026,2,11,19,15,1,16
734034,2,11,19,7,1,8
829716,2,11,19,5,0,5
829736,2,11,19,13,0,13
829756,2,11,19,0,1,1
829786,2,11,19,14,0,14
980912,2,11,19,9,0,9
980972,2,11,19,15,1,16
980996,2,11,19,11,0,11
981014,2,11,19,7,1,8
981022,2,11,19,19,0,19
1082604,2,11,19,10,1,11
1082634,2,11,19,8,1,9
1082638,2,11,19,4,0,4
1082643,2,11,19,4,0,4
980916,1,12,19,2,0,2
980924,1,12,19,9,0,9
980944,1,12,19,6,4,10
980954,1,12,19,14,0,14
980962,1,12,19,5,1,6
980974,1,12,19,3,1,4
1082594,1,12,19,14,0,14
1082603,1,12,19,11,1,12
1082607,1,12,19,18,1,19
1082618,1,12,19,6,2,8
1082620,1,12,19,17,1,18
1082624,1,12,19,8,0,8
1082634,1,12,19,18,1,19
1082647,1,12,19,23,3,26
980936,2,12,19,4,0,4
980970,2,12,19,14,0,14
980984,2,12,19,8,0,8
981010,2,12,19,6,0,6
1082592,2,12,19,7,0,7
1082615,2,12,19,18,1,19
1082629,2,12,19,17,0,17
1082631,2,12,19,2,1,3
1082642,2,12,19,8,0,8
1082650,2,12,19,11,1,12
980934,1,13,19,4,0,4
980950,1,13,19,8,0,8
980966,1,13,19,8,0,8
980972,1,13,19,8,0,8
981018,1,13,19,20,1,21
981022,1,13,19,14,1,15
1082593,1,13,19,16,0,16
1082596,1,13,19,13,0,13
1082606,1,13,19,11,1,12
1082625,1,13,19,12,3,15
1082629,1,13,19,7,0,7
1082632,1,13,19,7,0,7
1082640,1,13,19,8,0,8
1082643,1,13,19,3,1,4
980916,2,13,19,0,1,1
980922,2,13,19,2,0,2
980942,2,13,19,14,0,14
980954,2,13,19,11,0,11
980960,2,13,19,7,0,7
980992,2,13,19,4,0,4
1082610,2,13,19,20,1,21
1082613,2,13,19,5,0,5
1082616,2,13,19,3,2,5
1082637,2,13,19,16,0,16
335987,1,1,20,22,0,22
335998,1,1,20,12,1,13
336002,1,1,20,9,2,11
336019,1,1,20,13,0,13
336022,1,1,20,4,0,4
336030,1,1,20,10,1,11
336032,1,1,20,11,0,11
392189,1,1,20,3,0,3
392204,1,1,20,5,1,6
392212,1,1,20,21,0,21
392216,1,1,20,7,0,7
392224,1,1,20,9,0,9
392226,1,1,20,17,3,20
392233,1,1,20,14,0,14
419111,1,1,20,10,1,11
419127,1,1,20,7,0,7
419132,1,1,20,21,0,21
419140,1,1,20,12,0,12
419144,1,1,20,10,2,12
419149,1,1,20,14,0,14
419153,1,1,20,4,1,5
419158,1,1,20,9,2,11
501208,1,1,20,8,0,8
501227,1,1,20,6,1,7
501235,1,1,20,8,0,8
501244,1,1,20,10,1,11
501272,1,1,20,9,0,9
501274,1,1,20,13,0,13
548320,1,1,20,12,0,12
548349,1,1,20,8,1,9
548358,1,1,20,9,0,9
548373,1,1,20,9,0,9
548375,1,1,20,5,2,7
548380,1,1,20,8,1,9
548383,1,1,20,21,0,21
598013,1,1,20,6,0,6
598018,1,1,20,8,0,8
598027,1,1,20,4,0,4
598034,1,1,20,2,1,3
598045,1,1,20,16,0,16
598058,1,1,20,15,0,15
598074,1,1,20,8,1,9
729284,1,1,20,14,0,14
729294,1,1,20,10,2,12
729304,1,1,20,5,3,8
734032,1,1,20,11,1,12
734048,1,1,20,15,0,15
829718,1,1,20,13,1,14
829766,1,1,20,18,0,18
829786,1,1,20,13,0,13
980914,1,1,20,7,0,7
980952,1,1,20,8,0,8
980968,1,1,20,4,0,4
980980,1,1,20,11,2,13
981000,1,1,20,10,2,12
981006,1,1,20,4,0,4
981014,1,1,20,7,0,7
1082597,1,1,20,21,2,23
1082604,1,1,20,9,0,9
1082613,1,1,20,7,0,7
1082617,1,1,20,0,0,0
1082631,1,1,20,4,0,4
336005,2,1,20,0,0,0
336008,2,1,20,8,1,9
336040,2,1,20,15,0,15
392195,2,1,20,3,3,6
392208,2,1,20,9,0,9
392236,2,1,20,6,0,6
392238,2,1,20,3,1,4
419114,2,1,20,1,0,1
419118,2,1,20,0,0,0
419123,2,1,20,2,0,2
419136,2,1,20,3,0,3
501203,2,1,20,5,1,6
501224,2,1,20,7,0,7
501247,2,1,20,7,0,7
548317,2,1,20,8,0,8
548325,2,1,20,6,0,6
548328,2,1,20,5,1,6
548340,2,1,20,0,1,1
548352,2,1,20,6,0,6
548368,2,1,20,10,0,10
548386,2,1,20,10,0,10
598021,2,1,20,2,4,6
598039,2,1,20,4,0,4
598062,2,1,20,5,0,5
598066,2,1,20,10,0,10
729320,2,1,20,10,1,11
733984,2,1,20,4,2,6
734020,2,1,20,13,0,13
734054,2,1,20,5,0,5
829728,2,1,20,5,4,9
829770,2,1,20,14,0,14
829796,2,1,20,7,1,8
829810,2,1,20,5,1,6
829816,2,1,20,6,0,6
980944,2,1,20,8,0,8
980964,2,1,20,4,0,4
981020,2,1,20,1,1,2
1082608,2,1,20,9,0,9
1082627,2,1,20,7,0,7
1082639,2,1,20,5,0,5
1082644,2,1,20,4,0,4
335997,1,2,20,4,1,5
336011,1,2,20,0,0,0
336021,1,2,20,7,5,12
336031,1,2,20,24,0,24
336034,1,2,20,4,0,4
336039,1,2,20,13,0,13
392187,1,2,20,15,1,16
392196,1,2,20,6,0,6
392199,1,2,20,9,1,10
392209,1,2,20,8,2,10
392218,1,2,20,3,0,3
392241,1,2,20,23,0,23
419114,1,2,20,13,1,14
419128,1,2,20,17,0,17
419138,1,2,20,11,0,11
419150,1,2,20,17,0,17
501210,1,2,20,15,1,16
501237,1,2,20,6,0,6
501249,1,2,20,7,1,8
501273,1,2,20,6,2,8
501275,1,2,20,7,0,7
548315,1,2,20,10,0,10
548323,1,2,20,7,0,7
548341,1,2,20,13,2,15
548355,1,2,20,3,1,4
548367,1,2,20,15,0,15
548372,1,2,20,24,0,24
548377,1,2,20,12,0,12
598004,1,2,20,15,1,16
598009,1,2,20,5,0,5
598017,1,2,20,5,0,5
598032,1,2,20,10,0,10
598041,1,2,20,22,0,22
598047,1,2,20,26,0,26
598050,1,2,20,10,0,10
598059,1,2,20,23,0,23
598062,1,2,20,5,1,6
598069,1,2,20,21,0,21
729318,1,2,20,3,1,4
734004,1,2,20,17,1,18
734010,1,2,20,25,2,27
734026,1,2,20,8,0,8
734040,1,2,20,9,2,11
829724,1,2,20,7,0,7
829768,1,2,20,11,1,12
829790,1,2,20,8,1,9
829800,1,2,20,17,0,17
829824,1,2,20,10,1,11
829826,1,2,20,7,1,8
980912,1,2,20,13,0,13
980926,1,2,20,8,0,8
980932,1,2,20,9,0,9
980936,1,2,20,11,1,12
980942,1,2,20,16,1,17
980964,1,2,20,18,0,18
980982,1,2,20,11,1,12
980986,1,2,20,10,3,13
980992,1,2,20,15,0,15
1082595,1,2,20,7,0,7
1082598,1,2,20,14,0,14
1082602,1,2,20,10,0,10
1082610,1,2,20,17,0,17
1082621,1,2,20,4,0,4
1082628,1,2,20,5,0,5
1082636,1,2,20,21,0,21
1082646,1,2,20,14,2,16
335990,2,2,20,2,1,3
336001,2,2,20,2,1,3
336003,2,2,20,19,0,19
336028,2,2,20,14,0,14
392193,2,2,20,4,0,4
392204,2,2,20,13,0,13
392223,2,2,20,15,1,16
392226,2,2,20,6,1,7
392229,2,2,20,7,0,7
392244,2,2,20,4,4,8
419124,2,2,20,4,0,4
419133,2,2,20,13,0,13
419141,2,2,20,4,1,5
419145,2,2,20,4,0,4
419156,2,2,20,2,1,3
419162,2,2,20,6,1,7
419167,2,2,20,2,1,3
501213,2,2,20,3,2,5
501216,2,2,20,9,0,9
501232,2,2,20,3,0,3
501276,2,2,20,14,0,14
548320,2,2,20,5,0,5
548329,2,2,20,9,0,9
548332,2,2,20,24,0,24
548336,2,2,20,6,0,6
548349,2,2,20,5,0,5
548381,2,2,20,3,1,4
598022,2,2,20,10,1,11
598038,2,2,20,11,1,12
729304,2,2,20,6,0,6
733982,2,2,20,6,0,6
733988,2,2,20,6,1,7
733996,2,2,20,16,1,17
734018,2,2,20,13,0,13
734032,2,2,20,10,0,10
829742,2,2,20,9,0,9
829750,2,2,20,7,0,7
829784,2,2,20,0,0,0
980958,2,2,20,6,0,6
980974,2,2,20,7,0,7
981024,2,2,20,8,1,9
1082591,2,2,20,7,0,7
1082607,2,2,20,2,1,3
1082624,2,2,20,8,0,8
335988,1,3,20,25,0,25
335994,1,3,20,13,1,14
336001,1,3,20,14,0,14
336006,1,3,20,11,0,11
336012,1,3,20,20,0,20
336018,1,3,20,5,0,5
336023,1,3,20,10,5,15
336045,1,3,20,15,0,15
392190,1,3,20,13,1,14
392201,1,3,20,5,1,6
392207,1,3,20,11,0,11
392211,1,3,20,10,0,10
392214,1,3,20,12,1,13
392229,1,3,20,6,0,6
392236,1,3,20,17,2,19
392239,1,3,20,3,3,6
392243,1,3,20,6,0,6
419118,1,3,20,15,1,16
419130,1,3,20,6,1,7
419142,1,3,20,10,1,11
419147,1,3,20,12,1,13
419152,1,3,20,4,2,6
419160,1,3,20,12,0,12
419168,1,3,20,13,1,14
419170,1,3,20,6,5,11
501203,1,3,20,16,0,16
501211,1,3,20,7,0,7
501216,1,3,20,7,0,7
501231,1,3,20,8,1,9
501241,1,3,20,8,0,8
501250,1,3,20,7,0,7
501254,1,3,20,6,2,8
501258,1,3,20,17,0,17
501266,1,3,20,10,1,11
501271,1,3,20,17,0,17
501276,1,3,20,7,0,7
548311,1,3,20,3,0,3
548316,1,3,20,22,1,23
548321,1,3,20,6,1,7
548327,1,3,20,8,0,8
548335,1,3,20,18,0,18
548352,1,3,20,9,1,10
548357,1,3,20,13,0,13
548360,1,3,20,4,0,4
548376,1,3,20,6,1,7
548384,1,3,20,18,1,19
548385,1,3,20,7,0,7
548386,1,3,20,7,1,8
598025,1,3,20,7,2,9
598039,1,3,20,12,0,12
598043,1,3,20,14,0,14
598046,1,3,20,12,0,12
598056,1,3,20,18,2,20
598063,1,3,20,11,0,11
598067,1,3,20,8,0,8
598075,1,3,20,19,0,19
729288,1,3,20,18,0,18
729298,1,3,20,14,1,15
729302,1,3,20,8,1,9
734018,1,3,20,6,1,7
734028,1,3,20,11,1,12
734034,1,3,20,24,0,24
829712,1,3,20,16,0,16
829716,1,3,20,15,0,15
829728,1,3,20,3,2,5
829740,1,3,20,7,0,7
829750,1,3,20,3,1,4
829758,1,3,20,4,0,4
829770,1,3,20,10,0,10
829784,1,3,20,3,1,4
829794,1,3,20,11,0,11
829802,1,3,20,8,0,8
829806,1,3,20,5,0,5
336014,2,3,20,14,1,15
336034,2,3,20,1,0,1
336038,2,3,20,3,1,4
336042,2,3,20,7,0,7
392186,2,3,20,4,1,5
392194,2,3,20,5,0,5
392207,2,3,20,5,0,5
392232,2,3,20,4,2,6
419115,2,3,20,12,1,13
419121,2,3,20,6,0,6
419126,2,3,20,7,2,9
419128,2,3,20,11,0,11
419134,2,3,20,3,1,4
419164,2,3,20,18,0,18
501226,2,3,20,16,0,16
501233,2,3,20,5,0,5
501273,2,3,20,13,0,13
548323,2,3,20,16,1,17
548337,2,3,20,8,0,8
548348,2,3,20,8,1,9
548373,2,3,20,10,0,10
598007,2,3,20,2,0,2
598017,2,3,20,15,1,16
598020,2,3,20,11,0,11
598027,2,3,20,6,0,6
598031,2,3,20,11,0,11
598035,2,3,20,14,1,15
598078,2,3,20,16,2,18
729316,2,3,20,6,0,6
733986,2,3,20,13,0,13
733992,2,3,20,18,1,19
734000,2,3,20,12,1,13
734008,2,3,20,12,0,12
734052,2,3,20,15,0,15
829778,2,3,20,4,2,6
829826,2,3,20,5,0,5
829828,2,3,20,21,0,21
335992,1,4,20,16,1,17
335996,1,4,20,12,1,13
336008,1,4,20,20,1,21
336024,1,4,20,12,1,13
336033,1,4,20,16,2,18
336040,1,4,20,3,1,4
336044,1,4,20,12,2,14
392191,1,4,20,14,2,16
392200,1,4,20,7,2,9
392205,1,4,20,12,0,12
392227,1,4,20,3,2,5
392234,1,4,20,5,2,7
419113,1,4,20,9,1,10
419117,1,4,20,18,1,19
419126,1,4,20,10,2,12
419137,1,4,20,12,1,13
419141,1,4,20,16,2,18
419148,1,4,20,6,0,6
419161,1,4,20,14,0,14
419164,1,4,20,16,0,16
501207,1,4,20,10,0,10
501225,1,4,20,4,1,5
501239,1,4,20,9,0,9
501253,1,4,20,3,0,3
501256,1,4,20,8,0,8
501262,1,4,20,12,0,12
501265,1,4,20,11,1,12
548328,1,4,20,11,0,11
548333,1,4,20,10,0,10
548336,1,4,20,14,0,14
548344,1,4,20,16,0,16
548348,1,4,20,7,0,7
548364,1,4,20,12,1,13
548374,1,4,20,5,0,5
548379,1,4,20,15,0,15
598012,1,4,20,1,0,1
598021,1,4,20,6,1,7
598026,1,4,20,6,0,6
598033,1,4,20,6,0,6
598036,1,4,20,17,1,18
598057,1,4,20,7,1,8
598071,1,4,20,8,1,9
729300,1,4,20,8,0,8
729312,1,4,20,4,1,5
733978,1,4,20,3,0,3
733992,1,4,20,23,0,23
733996,1,4,20,9,1,10
734002,1,4,20,11,0,11
734030,1,4,20,9,0,9
734038,1,4,20,3,7,10
734052,1,4,20,8,0,8
734054,1,4,20,12,0,12
829722,1,4,20,11,2,13
829730,1,4,20,3,0,3
829738,1,4,20,8,1,9
829772,1,4,20,10,0,10
829796,1,4,20,21,0,21
829814,1,4,20,8,0,8
980910,1,4,20,6,0,6
980918,1,4,20,12,0,12
980930,1,4,20,18,0,18
980940,1,4,20,6,0,6
980960,1,4,20,3,0,3
980976,1,4,20,12,1,13
980996,1,4,20,11,0,11
981010,1,4,20,12,0,12
1082601,1,4,20,3,1,4
1082612,1,4,20,17,1,18
1082616,1,4,20,12,0,12
1082633,1,4,20,18,1,19
1082637,1,4,20,14,0,14
1082639,1,4,20,7,2,9
1082641,1,4,20,15,1,16
335988,2,4,20,9,0,9
336000,2,4,20,4,0,4
336018,2,4,20,8,0,8
336036,2,4,20,6,1,7
392209,2,4,20,4,0,4
392212,2,4,20,7,0,7
392215,2,4,20,5,0,5
392221,2,4,20,8,0,8
392231,2,4,20,4,0,4
392239,2,4,20,7,0,7
419122,2,4,20,12,0,12
419129,2,4,20,0,0,0
419132,2,4,20,6,1,7
419151,2,4,20,6,0,6
501211,2,4,20,6,0,6
501228,2,4,20,6,1,7
501242,2,4,20,4,0,4
501249,2,4,20,14,1,15
548314,2,4,20,8,0,8
548318,2,4,20,13,0,13
548339,2,4,20,9,0,9
548355,2,4,20,9,0,9
548359,2,4,20,7,2,9
548371,2,4,20,19,0,19
598030,2,4,20,16,0,16
598042,2,4,20,10,2,12
598046,2,4,20,3,0,3
598061,2,4,20,9,0,9
734024,2,4,20,9,0,9
734048,2,4,20,1,0,1
829714,2,4,20,5,0,5
829746,2,4,20,13,0,13
829758,2,4,20,1,0,1
829764,2,4,20,4,0,4
829780,2,4,20,9,0,9
829804,2,4,20,22,0,22
980946,2,4,20,13,0,13
980968,2,4,20,4,0,4
980982,2,4,20,15,0,15
1082605,2,4,20,3,0,3
1082609,2,4,20,3,2,5
1082623,2,4,20,6,0,6
335989,1,5,20,8,0,8
336005,1,5,20,6,1,7
336028,1,5,20,9,2,11
336038,1,5,20,8,0,8
336043,1,5,20,4,0,4
392195,1,5,20,18,0,18
392215,1,5,20,9,0,9
392222,1,5,20,13,1,14
392230,1,5,20,3,0,3
392238,1,5,20,2,0,2
419116,1,5,20,12,1,13
419120,1,5,20,0,1,1
419123,1,5,20,15,2,17
419129,1,5,20,13,0,13
419134,1,5,20,7,0,7
419146,1,5,20,7,0,7
419159,1,5,20,15,0,15
419163,1,5,20,7,0,7
501214,1,5,20,6,6,12
501245,1,5,20,7,0,7
501257,1,5,20,3,2,5
548314,1,5,20,13,0,13
548317,1,5,20,8,0,8
548325,1,5,20,13,2,15
548329,1,5,20,11,0,11
548337,1,5,20,4,0,4
548354,1,5,20,7,0,7
548359,1,5,20,11,0,11
548366,1,5,20,10,0,10
548370,1,5,20,9,0,9
548378,1,5,20,6,0,6
548382,1,5,20,11,0,11
598006,1,5,20,4,0,4
598010,1,5,20,10,2,12
598014,1,5,20,14,1,15
598024,1,5,20,19,0,19
598028,1,5,20,3,0,3
598031,1,5,20,10,0,10
598048,1,5,20,8,1,9
598077,1,5,20,10,8,18
729296,1,5,20,8,0,8
729320,1,5,20,9,0,9
733984,1,5,20,11,0,11
734008,1,5,20,7,1,8
734016,1,5,20,13,2,15
734046,1,5,20,15,1,16
829714,1,5,20,4,0,4
829746,1,5,20,16,0,16
829754,1,5,20,3,0,3
829782,1,5,20,15,0,15
829816,1,5,20,8,0,8
335995,2,5,20,19,0,19
336020,2,5,20,4,0,4
336024,2,5,20,2,0,2
336041,2,5,20,14,1,15
336045,2,5,20,6,2,8
392200,2,5,20,5,1,6
392210,2,5,20,1,1,2
392225,2,5,20,3,0,3
392235,2,5,20,13,0,13
419112,2,5,20,6,1,7
419142,2,5,20,11,0,11
419155,2,5,20,7,1,8
501225,2,5,20,7,0,7
501240,2,5,20,5,1,6
501254,2,5,20,0,0,0
548322,2,5,20,4,0,4
548331,2,5,20,11,0,11
548341,2,5,20,8,0,8
548350,2,5,20,10,0,10
598019,2,5,20,6,0,6
598041,2,5,20,7,0,7
598052,2,5,20,8,0,8
598068,2,5,20,7,1,8
598070,2,5,20,11,0,11
598076,2,5,20,12,0,12
729290,2,5,20,9,0,9
729302,2,5,20,16,0,16
733994,2,5,20,2,0,2
734022,2,5,20,8,0,8
734038,2,5,20,14,0,14
829720,2,5,20,13,0,13
829726,2,5,20,1,0,1
829732,2,5,20,7,1,8
829774,2,5,20,10,1,11
829792,2,5,20,10,0,10
829802,2,5,20,13,1,14
336000,1,6,20,6,0,6
336003,1,6,20,7,0,7
336014,1,6,20,11,0,11
336020,1,6,20,6,1,7
336025,1,6,20,14,0,14
392194,1,6,20,6,0,6
392203,1,6,20,8,0,8
392228,1,6,20,18,5,23
392231,1,6,20,6,0,6
392235,1,6,20,10,0,10
392237,1,6,20,12,0,12
392242,1,6,20,6,2,8
419121,1,6,20,11,1,12
419133,1,6,20,12,0,12
419136,1,6,20,12,0,12
419139,1,6,20,11,0,11
419145,1,6,20,7,4,11
419154,1,6,20,3,1,4
501209,1,6,20,10,2,12
501228,1,6,20,17,5,22
501232,1,6,20,7,2,9
501238,1,6,20,6,4,10
501243,1,6,20,5,0,5
548347,1,6,20,10,0,10
548350,1,6,20,20,0,20
548362,1,6,20,7,5,12
548369,1,6,20,7,0,7
598003,1,6,20,3,0,3
598015,1,6,20,13,0,13
598022,1,6,20,15,0,15
598040,1,6,20,13,0,13
598049,1,6,20,0,0,0
598054,1,6,20,14,0,14
598064,1,6,20,4,1,5
729286,1,6,20,17,0,17
733980,1,6,20,18,0,18
733986,1,6,20,18,0,18
733990,1,6,20,12,0,12
733998,1,6,20,4,0,4
734024,1,6,20,5,0,5
829720,1,6,20,16,1,17
829736,1,6,20,9,0,9
829744,1,6,20,3,0,3
829752,1,6,20,10,0,10
829788,1,6,20,9,0,9
829818,1,6,20,11,0,11
980938,1,6,20,15,1,16
980956,1,6,20,9,1,10
980970,1,6,20,13,0,13
981002,1,6,20,22,0,22
981016,1,6,20,4,0,4
1082599,1,6,20,23,0,23
1082605,1,6,20,19,0,19
1082608,1,6,20,10,1,11
1082622,1,6,20,6,0,6
1082642,1,6,20,5,0,5
336037,2,6,20,10,0,10
392199,2,6,20,3,0,3
392211,2,6,20,10,0,10
419113,2,6,20,7,0,7
419125,2,6,20,3,0,3
419149,2,6,20,11,0,11
419157,2,6,20,12,0,12
419165,2,6,20,3,2,5
501218,2,6,20,10,0,10
501221,2,6,20,9,0,9
501235,2,6,20,6,0,6
501251,2,6,20,7,2,9
501258,2,6,20,10,0,10
501262,2,6,20,13,0,13
548315,2,6,20,6,0,6
548326,2,6,20,6,0,6
548338,2,6,20,5,0,5
548377,2,6,20,7,1,8
548383,2,6,20,7,0,7
598006,2,6,20,3,0,3
598011,2,6,20,11,0,11
598033,2,6,20,14,0,14
598059,2,6,20,14,0,14
598067,2,6,20,5,0,5
598072,2,6,20,6,0,6
729294,2,6,20,6,0,6
729306,2,6,20,14,1,15
734010,2,6,20,9,0,9
734016,2,6,20,12,1,13
734036,2,6,20,8,1,9
829712,2,6,20,17,0,17
829730,2,6,20,6,0,6
829766,2,6,20,14,1,15
829782,2,6,20,12,3,15
829798,2,6,20,9,0,9
980926,2,6,20,1,0,1
980950,2,6,20,12,0,12
980976,2,6,20,15,0,15
980998,2,6,20,0,0,0
981008,2,6,20,11,2,13
1082595,2,6,20,3,0,3
1082611,2,6,20,8,0,8
1082614,2,6,20,8,2,10
1082630,2,6,20,4,0,4
1082640,2,6,20,8,2,10
1082646,2,6,20,2,0,2
335990,1,7,20,7,0,7
335999,1,7,20,5,2,7
336009,1,7,20,6,0,6
336029,1,7,20,7,0,7
336037,1,7,20,14,0,14
336041,1,7,20,24,1,25
392186,1,7,20,8,0,8
392202,1,7,20,10,0,10
392208,1,7,20,16,0,16
392213,1,7,20,15,1,16
392220,1,7,20,1,1,2
392223,1,7,20,13,1,14
392232,1,7,20,11,0,11
392240,1,7,20,7,3,10
419112,1,7,20,11,1,12
419119,1,7,20,12,0,12
419124,1,7,20,16,0,16
419135,1,7,20,18,2,20
419143,1,7,20,14,0,14
419151,1,7,20,2,2,4
419155,1,7,20,20,0,20
419157,1,7,20,25,0,25
419162,1,7,20,12,0,12
419166,1,7,20,5,2,7
419167,1,7,20,15,1,16
501215,1,7,20,11,0,11
501226,1,7,20,1,3,4
501229,1,7,20,23,1,24
501236,1,7,20,9,0,9
501242,1,7,20,11,0,11
501246,1,7,20,3,5,8
501251,1,7,20,5,0,5
501268,1,7,20,8,0,8
548322,1,7,20,13,0,13
548330,1,7,20,0,0,0
548339,1,7,20,4,4,8
548356,1,7,20,4,0,4
548365,1,7,20,18,0,18
548368,1,7,20,8,0,8
598007,1,7,20,15,0,15
598011,1,7,20,20,0,20
598016,1,7,20,16,0,16
598029,1,7,20,12,0,12
598038,1,7,20,8,0,8
598042,1,7,20,26,1,27
598044,1,7,20,15,1,16
598051,1,7,20,19,0,19
598055,1,7,20,19,6,25
598068,1,7,20,4,0,4
598078,1,7,20,13,0,13
729292,1,7,20,3,1,4
729308,1,7,20,13,1,14
729314,1,7,20,11,1,12
733988,1,7,20,10,1,11
734000,1,7,20,17,1,18
734014,1,7,20,4,0,4
734022,1,7,20,17,0,17
734036,1,7,20,1,1,2
734050,1,7,20,9,0,9
829710,1,7,20,20,0,20
829726,1,7,20,13,2,15
829734,1,7,20,6,2,8
829742,1,7,20,15,1,16
829756,1,7,20,7,1,8
829774,1,7,20,12,0,12
829780,1,7,20,8,1,9
829810,1,7,20,12,1,13
829822,1,7,20,13,3,16
829828,1,7,20,7,4,11
980906,1,7,20,17,0,17
980922,1,7,20,14,0,14
980928,1,7,20,6,0,6
980946,1,7,20,4,0,4
980990,1,7,20,8,0,8
980998,1,7,20,10,2,12
981012,1,7,20,6,0,6
1082592,1,7,20,28,2,30
1082614,1,7,20,10,0,10
1082635,1,7,20,21,2,23
1082638,1,7,20,3,3,6
1082644,1,7,20,3,2,5
1082650,1,7,20,12,2,14
335994,2,7,20,11,1,12
335996,2,7,20,0,0,0
336033,2,7,20,15,2,17
392197,2,7,20,9,0,9
392205,2,7,20,7,1,8
392217,2,7,20,5,0,5
392230,2,7,20,1,0,1
419137,2,7,20,5,1,6
419147,2,7,20,8,1,9
419170,2,7,20,4,0,4
501223,2,7,20,10,0,10
501261,2,7,20,13,2,15
501272,2,7,20,23,0,23
501274,2,7,20,7,0,7
501275,2,7,20,13,0,13
548313,2,7,20,5,0,5
548319,2,7,20,20,1,21
548344,2,7,20,6,1,7
548347,2,7,20,3,0,3
548360,2,7,20,16,0,16
548372,2,7,20,14,1,15
548375,2,7,20,0,0,0
548384,2,7,20,7,0,7
598004,2,7,20,6,1,7
598034,2,7,20,12,0,12
598065,2,7,20,12,0,12
598071,2,7,20,0,0,0
598077,2,7,20,10,1,11
729284,2,7,20,5,0,5
729322,2,7,20,1,3,4
733978,2,7,20,6,0,6
829722,2,7,20,11,0,11
829752,2,7,20,5,0,5
829788,2,7,20,8,0,8
829794,2,7,20,5,0,5
829800,2,7,20,14,0,14
980914,2,7,20,1,0,1
980938,2,7,20,10,0,10
1082597,2,7,20,10,2,12
1082606,2,7,20,8,0,8
1082618,2,7,20,13,0,13
1082625,2,7,20,10,0,10
1082628,2,7,20,8,1,9
1082641,2,7,20,8,0,8
1082647,2,7,20,9,0,9
335993,1,8,20,12,2,14
335995,1,8,20,10,1,11
336004,1,8,20,9,1,10
336007,1,8,20,1,0,1
336016,1,8,20,8,3,11
336036,1,8,20,11,0,11
336042,1,8,20,6,1,7
392193,1,8,20,10,0,10
392197,1,8,20,0,5,5
392206,1,8,20,7,1,8
392210,1,8,20,10,0,10
392217,1,8,20,9,0,9
392221,1,8,20,8,1,9
392225,1,8,20,10,0,10
392244,1,8,20,9,0,9
419115,1,8,20,20,2,22
419122,1,8,20,8,0,8
419125,1,8,20,7,0,7
419131,1,8,20,2,2,4
419156,1,8,20,10,0,10
419165,1,8,20,7,0,7
501204,1,8,20,7,0,7
501213,1,8,20,8,0,8
501217,1,8,20,9,0,9
501221,1,8,20,10,0,10
501234,1,8,20,3,1,4
501248,1,8,20,10,0,10
501255,1,8,20,11,0,11
501261,1,8,20,23,0,23
501269,1,8,20,8,0,8
548319,1,8,20,7,1,8
548326,1,8,20,6,0,6
548331,1,8,20,18,0,18
548334,1,8,20,9,0,9
548340,1,8,20,11,0,11
548346,1,8,20,9,0,9
548353,1,8,20,6,0,6
548361,1,8,20,11,3,14
548371,1,8,20,11,0,11
548381,1,8,20,5,1,6
336019,2,8,20,8,1,9
336025,2,8,20,2,0,2
336029,2,8,20,4,2,6
336039,2,8,20,16,0,16
392201,2,8,20,11,0,11
392228,2,8,20,1,0,1
392233,2,8,20,23,3,26
392234,2,8,20,8,1,9
392241,2,8,20,13,0,13
419111,2,8,20,4,1,5
419140,2,8,20,9,0,9
419146,2,8,20,2,1,3
419150,2,8,20,10,0,10
419152,2,8,20,1,1,2
419161,2,8,20,4,0,4
419168,2,8,20,0,0,0
501208,2,8,20,9,1,10
501229,2,8,20,6,0,6
501241,2,8,20,3,0,3
501244,2,8,20,6,1,7
501264,2,8,20,5,0,5
548357,2,8,20,9,0,9
548364,2,8,20,9,0,9
501205,1,9,20,7,1,8
501212,1,9,20,13,6,19
501224,1,9,20,2,2,4
501230,1,9,20,2,1,3
501247,1,9,20,22,0,22
501252,1,9,20,6,0,6
501259,1,9,20,7,0,7
501266,2,9,20,6,1,7
501218,1,10,20,25,1,26
501233,1,10,20,15,0,15
501240,1,10,20,14,1,15
501264,1,10,20,15,0,15
501267,1,10,20,6,1,7
548313,1,10,20,5,0,5
548318,1,10,20,8,0,8
548332,1,10,20,7,0,7
548338,1,10,20,12,0,12
548342,1,10,20,10,4,14
548363,1,10,20,3,0,3
598008,1,10,20,10,0,10
598020,1,10,20,11,1,12
598030,1,10,20,5,1,6
598052,1,10,20,12,1,13
598060,1,10,20,5,0,5
598066,1,10,20,16,0,16
598072,1,10,20,8,0,8
501231,2,10,20,3,1,4
501237,2,10,20,16,1,17
501246,2,10,20,11,0,11
548327,2,10,20,10,0,10
548335,2,10,20,5,2,7
548346,2,10,20,7,0,7
548353,2,10,20,9,0,9
548356,2,10,20,9,1,10
548358,2,10,20,10,0,10
548367,2,10,20,10,0,10
548370,2,10,20,9,0,9
548380,2,10,20,3,0,3
598016,2,10,20,4,0,4
598032,2,10,20,5,0,5
598040,2,10,20,12,0,12
598043,2,10,20,6,0,6
598047,2,10,20,5,1,6
598058,2,10,20,1,0,1
598005,1,11,20,9,0,9
598023,1,11,20,13,1,14
598035,1,11,20,16,0,16
598037,1,11,20,16,1,17
598053,1,11,20,6,0,6
598061,1,11,20,6,2,8
598065,1,11,20,8,1,9
598070,1,11,20,6,1,7
598076,1,11,20,10,0,10
729290,1,11,20,7,1,8
729306,1,11,20,10,0,10
729316,1,11,20,11,1,12
729322,1,11,20,11,0,11
733982,1,11,20,5,1,6
733994,1,11,20,6,6,12
734006,1,11,20,17,1,18
734012,1,11,20,10,2,12
734020,1,11,20,4,2,6
734042,1,11,20,12,1,13
829732,1,11,20,11,1,12
829748,1,11,20,11,1,12
829764,1,11,20,14,0,14
829778,1,11,20,7,0,7
829792,1,11,20,5,1,6
829798,1,11,20,11,0,11
829804,1,11,20,15,0,15
829820,1,11,20,9,0,9
980920,1,11,20,6,1,7
980948,1,11,20,13,0,13
980958,1,11,20,5,1,6
980978,1,11,20,7,0,7
980984,1,11,20,8,0,8
980988,1,11,20,7,1,8
981008,1,11,20,9,0,9
981020,1,11,20,13,1,14
981024,1,11,20,24,0,24
1082591,1,11,20,16,0,16
1082600,1,11,20,5,0,5
1082609,1,11,20,14,1,15
1082611,1,11,20,17,0,17
1082615,1,11,20,15,0,15
1082623,1,11,20,11,0,11
1082627,1,11,20,7,0,7
1082630,1,11,20,18,1,19
1082648,1,11,20,6,1,7
598009,2,11,20,5,1,6
598015,2,11,20,6,0,6
598018,2,11,20,3,3,6
598056,2,11,20,11,1,12
729300,2,11,20,1,0,1
734026,2,11,20,4,0,4
734034,2,11,20,5,0,5
829716,2,11,20,14,0,14
829736,2,11,20,5,0,5
829756,2,11,20,8,1,9
829786,2,11,20,1,0,1
980912,2,11,20,8,1,9
980996,2,11,20,8,1,9
981014,2,11,20,5,0,5
981022,2,11,20,5,0,5
1082604,2,11,20,12,0,12
1082634,2,11,20,0,0,0
980916,1,12,20,20,0,20
980924,1,12,20,3,0,3
980944,1,12,20,17,0,17
980954,1,12,20,12,0,12
980962,1,12,20,10,1,11
980974,1,12,20,16,0,16
1082594,1,12,20,16,0,16
1082603,1,12,20,4,0,4
1082607,1,12,20,9,1,10
1082618,1,12,20,10,0,10
1082620,1,12,20,9,3,12
1082624,1,12,20,9,1,10
1082634,1,12,20,5,1,6
1082647,1,12,20,15,0,15
980936,2,12,20,7,0,7
980970,2,12,20,5,1,6
980984,2,12,20,9,0,9
981010,2,12,20,22,1,23
1082592,2,12,20,15,0,15
1082615,2,12,20,13,0,13
1082629,2,12,20,12,1,13
1082631,2,12,20,7,0,7
1082642,2,12,20,12,5,17
1082650,2,12,20,8,1,9
980934,1,13,20,6,0,6
980950,1,13,20,10,0,10
980966,1,13,20,10,1,11
980972,1,13,20,12,0,12
981018,1,13,20,4,0,4
981022,1,13,20,7,1,8
1082593,1,13,20,13,1,14
1082596,1,13,20,4,1,5
1082606,1,13,20,10,0,10
1082625,1,13,20,9,0,9
1082629,1,13,20,5,1,6
1082632,1,13,20,16,1,17
1082640,1,13,20,12,0,12
1082643,1,13,20,0,0,0
980922,2,13,20,14,0,14
980942,2,13,20,6,2,8
980954,2,13,20,8,1,9
980960,2,13,20,6,0,6
1082610,2,13,20,4,0,4
1082616,2,13,20,9,0,9
1082637,2,13,20,8,2,10
