"Match_Id","Innings","Team","Over","Runs Scored","Extras","Overall","x"
335987,1,1,1,0,3,3,3
335998,1,1,1,8,0,8,8
336002,1,1,1,6,0,6,6
336015,1,1,1,2,0,2,2
336019,1,1,1,6,0,6,6
336022,1,1,1,2,1,3,3
336026,1,1,1,5,0,5,5
336030,1,1,1,3,2,5,5
336032,1,1,1,4,3,7,7
392189,1,1,1,1,0,1,1
392204,1,1,1,2,1,3,3
392212,1,1,1,4,1,5,5
392216,1,1,1,2,1,3,3
392224,1,1,1,6,1,7,7
392226,1,1,1,5,0,5,5
392233,1,1,1,4,1,5,5
419111,1,1,1,0,1,1,1
419127,1,1,1,5,5,10,10
419132,1,1,1,14,5,19,19
419140,1,1,1,10,0,10,10
419144,1,1,1,8,1,9,9
419149,1,1,1,7,0,7,7
419153,1,1,1,6,1,7,7
419158,1,1,1,3,0,3,3
501208,1,1,1,8,0,8,8
501227,1,1,1,12,7,19,19
501235,1,1,1,4,0,4,4
501244,1,1,1,9,2,11,11
501260,1,1,1,8,0,8,8
501272,1,1,1,1,0,1,1
501274,1,1,1,1,2,3,3
548312,1,1,1,9,0,9,9
548320,1,1,1,4,0,4,4
548349,1,1,1,11,0,11,11
548358,1,1,1,6,1,7,7
548373,1,1,1,6,0,6,6
548375,1,1,1,6,0,6,6
548380,1,1,1,8,0,8,8
548383,1,1,1,4,1,5,5
598013,1,1,1,2,1,3,3
598018,1,1,1,3,0,3,3
598027,1,1,1,10,1,11,11
598034,1,1,1,25,1,26,26
598045,1,1,1,5,0,5,5
598058,1,1,1,2,2,4,4
598074,1,1,1,5,0,5,5
729284,1,1,1,0,1,1,1
729294,1,1,1,2,8,10,10
729304,1,1,1,6,0,6,6
734032,1,1,1,5,0,5,5
734048,1,1,1,2,0,2,2
829718,1,1,1,13,0,13,13
829766,1,1,1,3,2,5,5
829776,1,1,1,6,2,8,8
829786,1,1,1,6,0,6,6
980914,1,1,1,2,1,3,3
980952,1,1,1,4,0,4,4
980968,1,1,1,2,0,2,2
980980,1,1,1,5,0,5,5
981000,1,1,1,8,0,8,8
981006,1,1,1,3,0,3,3
981014,1,1,1,13,0,13,13
1082597,1,1,1,8,2,10,10
1082604,1,1,1,2,1,3,3
1082613,1,1,1,12,0,12,12
1082617,1,1,1,18,0,18,18
1082631,1,1,1,0,0,0,0
1082649,1,1,1,3,0,3,3
335991,2,1,1,6,0,6,6
336005,2,1,1,7,2,9,9
336008,2,1,1,5,5,10,10
336040,2,1,1,9,1,10,10
392191,2,1,1,2,1,3,3
392195,2,1,1,6,1,7,7
392202,2,1,1,3,0,3,3
392208,2,1,1,1,0,1,1
392236,2,1,1,10,0,10,10
392238,2,1,1,9,0,9,9
419114,2,1,1,3,0,3,3
419118,2,1,1,0,0,0,0
419123,2,1,1,5,0,5,5
419136,2,1,1,1,1,2,2
419163,2,1,1,10,2,12,12
419166,2,1,1,6,0,6,6
501203,2,1,1,10,0,10,10
501214,2,1,1,5,2,7,7
501219,2,1,1,0,2,2,2
501224,2,1,1,3,4,7,7
501239,2,1,1,5,0,5,5
501247,2,1,1,9,0,9,9
501250,2,1,1,6,2,8,8
501267,2,1,1,7,0,7,7
548317,2,1,1,3,1,4,4
548325,2,1,1,9,1,10,10
548328,2,1,1,2,0,2,2
548333,2,1,1,9,1,10,10
548340,2,1,1,5,0,5,5
548352,2,1,1,7,0,7,7
548362,2,1,1,10,0,10,10
548368,2,1,1,2,0,2,2
548386,2,1,1,3,0,3,3
598003,2,1,1,0,0,0,0
598010,2,1,1,12,2,14,14
598021,2,1,1,1,0,1,1
598036,2,1,1,9,0,9,9
598039,2,1,1,6,12,18,18
598048,2,1,1,7,1,8,8
598055,2,1,1,1,1,2,2
598062,2,1,1,0,0,0,0
598066,2,1,1,4,6,10,10
729312,2,1,1,6,1,7,7
729320,2,1,1,7,0,7,7
733976,2,1,1,2,1,3,3
733984,2,1,1,5,0,5,5
733990,2,1,1,2,0,2,2
734002,2,1,1,2,0,2,2
734014,2,1,1,6,1,7,7
734020,2,1,1,6,0,6,6
734028,2,1,1,11,1,12,12
734042,2,1,1,2,0,2,2
734054,2,1,1,10,0,10,10
829710,2,1,1,1,2,3,3
829728,2,1,1,6,0,6,6
829738,2,1,1,8,0,8,8
829744,2,1,1,6,0,6,6
829748,2,1,1,5,0,5,5
829770,2,1,1,5,0,5,5
829796,2,1,1,5,0,5,5
829810,2,1,1,7,0,7,7
829816,2,1,1,6,2,8,8
980908,2,1,1,4,0,4,4
980920,2,1,1,7,0,7,7
980930,2,1,1,8,4,12,12
980944,2,1,1,13,2,15,15
980956,2,1,1,5,0,5,5
980964,2,1,1,6,0,6,6
980994,2,1,1,8,1,9,9
981020,2,1,1,3,0,3,3
1082593,2,1,1,7,0,7,7
1082601,2,1,1,4,1,5,5
1082608,2,1,1,6,0,6,6
1082620,2,1,1,7,1,8,8
1082622,2,1,1,7,1,8,8
1082627,2,1,1,9,0,9,9
1082636,2,1,1,14,0,14,14
1082639,2,1,1,14,0,14,14
1082644,2,1,1,0,0,0,0
1082648,2,1,1,11,0,11,11
392195,3,1,1,14,1,15,15
729320,3,1,1,10,1,11,11
335997,1,2,1,1,0,1,1
336011,1,2,1,0,1,1,1
336017,1,2,1,6,0,6,6
336021,1,2,1,3,0,3,3
336031,1,2,1,1,0,1,1
336034,1,2,1,6,0,6,6
336039,1,2,1,2,0,2,2
392187,1,2,1,4,0,4,4
392196,1,2,1,6,0,6,6
392199,1,2,1,9,0,9,9
392209,1,2,1,2,0,2,2
392218,1,2,1,2,1,3,3
392241,1,2,1,4,0,4,4
419114,1,2,1,5,0,5,5
419128,1,2,1,2,0,2,2
419138,1,2,1,2,0,2,2
419150,1,2,1,2,2,4,4
501210,1,2,1,1,0,1,1
501237,1,2,1,3,0,3,3
501249,1,2,1,9,0,9,9
501273,1,2,1,6,1,7,7
501275,1,2,1,20,7,27,27
548315,1,2,1,4,0,4,4
548323,1,2,1,9,0,9,9
548341,1,2,1,5,0,5,5
548355,1,2,1,1,0,1,1
548367,1,2,1,3,0,3,3
548372,1,2,1,6,0,6,6
548377,1,2,1,11,0,11,11
598004,1,2,1,1,0,1,1
598009,1,2,1,3,5,8,8
598017,1,2,1,4,1,5,5
598032,1,2,1,3,0,3,3
598041,1,2,1,13,0,13,13
598047,1,2,1,7,1,8,8
598050,1,2,1,7,0,7,7
598059,1,2,1,1,0,1,1
598062,1,2,1,3,0,3,3
598069,1,2,1,3,0,3,3
598073,1,2,1,6,0,6,6
729310,1,2,1,1,0,1,1
729318,1,2,1,20,0,20,20
734004,1,2,1,4,0,4,4
734010,1,2,1,1,0,1,1
734026,1,2,1,4,1,5,5
734040,1,2,1,2,0,2,2
829724,1,2,1,9,2,11,11
829768,1,2,1,10,0,10,10
829790,1,2,1,1,0,1,1
829800,1,2,1,7,1,8,8
829824,1,2,1,5,0,5,5
829826,1,2,1,6,0,6,6
980912,1,2,1,5,0,5,5
980926,1,2,1,8,0,8,8
980932,1,2,1,4,0,4,4
980936,1,2,1,8,1,9,9
980942,1,2,1,2,0,2,2
980964,1,2,1,2,0,2,2
980982,1,2,1,9,0,9,9
980986,1,2,1,7,1,8,8
980992,1,2,1,0,1,1,1
981004,1,2,1,5,0,5,5
1082595,1,2,1,10,0,10,10
1082598,1,2,1,2,0,2,2
1082602,1,2,1,4,2,6,6
1082610,1,2,1,8,0,8,8
1082621,1,2,1,2,1,3,3
1082628,1,2,1,10,0,10,10
1082636,1,2,1,1,0,1,1
1082646,1,2,1,9,1,10,10
335987,2,2,1,3,1,4,4
335990,2,2,1,10,0,10,10
336001,2,2,1,4,2,6,6
336003,2,2,1,7,0,7,7
336007,2,2,1,10,0,10,10
336015,2,2,1,4,0,4,4
336028,2,2,1,1,0,1,1
392190,2,2,1,5,0,5,5
392193,2,2,1,10,0,10,10
392204,2,2,1,1,1,2,2
392213,2,2,1,8,1,9,9
392223,2,2,1,6,0,6,6
392226,2,2,1,1,1,2,2
392229,2,2,1,5,1,6,6
392237,2,2,1,2,0,2,2
392243,2,2,1,9,0,9,9
392244,2,2,1,0,1,1,1
419117,2,2,1,5,0,5,5
419120,2,2,1,12,0,12,12
419124,2,2,1,3,1,4,4
419133,2,2,1,6,2,8,8
419141,2,2,1,5,0,5,5
419145,2,2,1,11,0,11,11
419153,2,2,1,4,0,4,4
419156,2,2,1,6,0,6,6
419159,2,2,1,6,0,6,6
419162,2,2,1,4,0,4,4
419167,2,2,1,9,0,9,9
419169,2,2,1,6,0,6,6
501205,2,2,1,2,5,7,7
501213,2,2,1,2,0,2,2
501216,2,2,1,15,0,15,15
501227,2,2,1,8,0,8,8
501232,2,2,1,9,1,10,10
501252,2,2,1,8,1,9,9
501257,2,2,1,9,1,10,10
501260,2,2,1,16,0,16,16
501265,2,2,1,0,0,0,0
501271,2,2,1,6,0,6,6
501276,2,2,1,5,1,6,6
548320,2,2,1,6,0,6,6
548329,2,2,1,7,0,7,7
548332,2,2,1,3,0,3,3
548336,2,2,1,2,1,3,3
548349,2,2,1,2,0,2,2
548361,2,2,1,11,0,11,11
548365,2,2,1,4,0,4,4
548381,2,2,1,3,0,3,3
598013,2,2,1,4,0,4,4
598022,2,2,1,2,0,2,2
598028,2,2,1,4,0,4,4
598038,2,2,1,5,0,5,5
598053,2,2,1,12,0,12,12
729286,2,2,1,5,0,5,5
729292,2,2,1,7,0,7,7
729304,2,2,1,7,1,8,8
733982,2,2,1,4,1,5,5
733988,2,2,1,6,0,6,6
733996,2,2,1,4,0,4,4
734018,2,2,1,9,0,9,9
734032,2,2,1,1,0,1,1
829718,2,2,1,1,0,1,1
829742,2,2,1,1,3,4,4
829750,2,2,1,8,0,8,8
829754,2,2,1,3,1,4,4
829762,2,2,1,3,1,4,4
829776,2,2,1,2,2,4,4
829784,2,2,1,4,0,4,4
829808,2,2,1,10,0,10,10
829812,2,2,1,17,0,17,17
829818,2,2,1,2,0,2,2
980958,2,2,1,10,0,10,10
980974,2,2,1,4,0,4,4
981000,2,2,1,6,1,7,7
981016,2,2,1,5,0,5,5
981018,2,2,1,5,6,11,11
981024,2,2,1,4,1,5,5
1082591,2,2,1,11,0,11,11
1082607,2,2,1,7,0,7,7
1082617,2,2,1,1,2,3,3
1082624,2,2,1,4,0,4,4
1082633,2,2,1,7,0,7,7
598022,3,2,1,15,0,15,15
598009,4,2,1,15,0,15,15
335988,1,3,1,5,0,5,5
335994,1,3,1,6,1,7,7
336001,1,3,1,1,0,1,1
336006,1,3,1,4,0,4,4
336010,1,3,1,1,0,1,1
336012,1,3,1,4,0,4,4
336018,1,3,1,10,2,12,12
336023,1,3,1,1,0,1,1
336045,1,3,1,5,1,6,6
392190,1,3,1,8,1,9,9
392201,1,3,1,2,0,2,2
392207,1,3,1,4,0,4,4
392211,1,3,1,9,1,10,10
392214,1,3,1,10,0,10,10
392219,1,3,1,5,0,5,5
392229,1,3,1,4,0,4,4
392236,1,3,1,5,0,5,5
392239,1,3,1,6,0,6,6
392243,1,3,1,2,0,2,2
419118,1,3,1,1,0,1,1
419130,1,3,1,4,1,5,5
419142,1,3,1,8,0,8,8
419147,1,3,1,6,0,6,6
419152,1,3,1,6,0,6,6
419160,1,3,1,7,2,9,9
419168,1,3,1,5,1,6,6
419170,1,3,1,4,0,4,4
501203,1,3,1,5,0,5,5
501211,1,3,1,0,0,0,0
501216,1,3,1,2,0,2,2
501220,1,3,1,8,0,8,8
501231,1,3,1,2,0,2,2
501241,1,3,1,3,1,4,4
501250,1,3,1,1,0,1,1
501254,1,3,1,6,1,7,7
501258,1,3,1,6,0,6,6
501266,1,3,1,3,0,3,3
501271,1,3,1,4,1,5,5
501276,1,3,1,5,0,5,5
548311,1,3,1,4,1,5,5
548316,1,3,1,2,0,2,2
548321,1,3,1,4,0,4,4
548327,1,3,1,1,0,1,1
548335,1,3,1,6,0,6,6
548352,1,3,1,4,0,4,4
548357,1,3,1,6,0,6,6
548360,1,3,1,7,0,7,7
548376,1,3,1,4,0,4,4
548384,1,3,1,1,0,1,1
548385,1,3,1,12,0,12,12
548386,1,3,1,3,0,3,3
598025,1,3,1,5,0,5,5
598039,1,3,1,6,0,6,6
598043,1,3,1,5,1,6,6
598046,1,3,1,3,0,3,3
598056,1,3,1,0,0,0,0
598063,1,3,1,3,0,3,3
598067,1,3,1,4,1,5,5
598075,1,3,1,6,0,6,6
729288,1,3,1,4,5,9,9
729298,1,3,1,3,1,4,4
729302,1,3,1,5,0,5,5
733976,1,3,1,9,0,9,9
734018,1,3,1,7,0,7,7
734028,1,3,1,5,0,5,5
734034,1,3,1,12,0,12,12
829712,1,3,1,12,4,16,16
829716,1,3,1,4,0,4,4
829728,1,3,1,12,7,19,19
829740,1,3,1,9,0,9,9
829750,1,3,1,5,4,9,9
829758,1,3,1,4,0,4,4
829770,1,3,1,4,0,4,4
829784,1,3,1,0,0,0,0
829794,1,3,1,3,0,3,3
829802,1,3,1,5,0,5,5
829806,1,3,1,0,0,0,0
335998,2,3,1,4,1,5,5
336014,2,3,1,9,0,9,9
336030,2,3,1,3,2,5,5
336034,2,3,1,4,1,5,5
336038,2,3,1,5,1,6,6
336042,2,3,1,10,2,12,12
336044,2,3,1,7,0,7,7
392186,2,3,1,2,0,2,2
392194,2,3,1,11,0,11,11
392207,2,3,1,5,1,6,6
392222,2,3,1,9,0,9,9
392232,2,3,1,4,0,4,4
419115,2,3,1,4,0,4,4
419121,2,3,1,3,1,4,4
419126,2,3,1,5,1,6,6
419128,2,3,1,2,0,2,2
419134,2,3,1,4,0,4,4
419138,2,3,1,7,0,7,7
419158,2,3,1,3,5,8,8
419164,2,3,1,1,0,1,1
501226,2,3,1,4,1,5,5
501233,2,3,1,0,0,0,0
501245,2,3,1,5,0,5,5
501273,2,3,1,1,2,3,3
548323,2,3,1,2,0,2,2
548337,2,3,1,2,0,2,2
548348,2,3,1,2,0,2,2
548366,2,3,1,1,0,1,1
548369,2,3,1,2,0,2,2
548373,2,3,1,5,0,5,5
598007,2,3,1,5,0,5,5
598012,2,3,1,5,1,6,6
598017,2,3,1,2,1,3,3
598020,2,3,1,0,0,0,0
598027,2,3,1,6,1,7,7
598031,2,3,1,4,0,4,4
598035,2,3,1,4,0,4,4
598051,2,3,1,6,0,6,6
598073,2,3,1,8,0,8,8
598078,2,3,1,2,0,2,2
729308,2,3,1,0,0,0,0
729316,2,3,1,6,0,6,6
733986,2,3,1,7,0,7,7
733992,2,3,1,4,1,5,5
734000,2,3,1,12,0,12,12
734008,2,3,1,7,0,7,7
734040,2,3,1,5,0,5,5
734050,2,3,1,4,2,6,6
734052,2,3,1,9,0,9,9
829734,2,3,1,6,0,6,6
829778,2,3,1,13,0,13,13
829814,2,3,1,2,0,2,2
829822,2,3,1,2,0,2,2
829826,2,3,1,2,1,3,3
829828,2,3,1,5,0,5,5
419126,3,3,1,9,0,9,9
335992,1,4,1,1,0,1,1
335996,1,4,1,2,0,2,2
336008,1,4,1,5,0,5,5
336024,1,4,1,5,0,5,5
336033,1,4,1,3,0,3,3
336040,1,4,1,4,1,5,5
336044,1,4,1,7,0,7,7
392188,1,4,1,6,4,10,10
392191,1,4,1,1,0,1,1
392200,1,4,1,0,1,1,1
392205,1,4,1,5,0,5,5
392227,1,4,1,4,1,5,5
392234,1,4,1,7,2,9,9
419113,1,4,1,0,3,3,3
419117,1,4,1,1,0,1,1
419126,1,4,1,2,0,2,2
419137,1,4,1,5,0,5,5
419141,1,4,1,1,0,1,1
419148,1,4,1,11,2,13,13
419161,1,4,1,1,1,2,2
419164,1,4,1,14,1,15,15
501207,1,4,1,4,0,4,4
501225,1,4,1,11,2,13,13
501239,1,4,1,3,0,3,3
501253,1,4,1,5,0,5,5
501256,1,4,1,2,0,2,2
501262,1,4,1,5,0,5,5
501265,1,4,1,5,0,5,5
548328,1,4,1,7,0,7,7
548333,1,4,1,6,2,8,8
548336,1,4,1,3,0,3,3
548344,1,4,1,3,0,3,3
548348,1,4,1,6,3,9,9
548364,1,4,1,5,0,5,5
548374,1,4,1,4,2,6,6
548379,1,4,1,0,5,5,5
598012,1,4,1,5,0,5,5
598019,1,4,1,1,0,1,1
598021,1,4,1,0,1,1,1
598026,1,4,1,2,0,2,2
598033,1,4,1,9,0,9,9
598036,1,4,1,5,0,5,5
598057,1,4,1,1,0,1,1
598071,1,4,1,2,0,2,2
729300,1,4,1,2,0,2,2
729312,1,4,1,7,0,7,7
733978,1,4,1,5,0,5,5
733992,1,4,1,7,2,9,9
733996,1,4,1,8,2,10,10
734002,1,4,1,16,1,17,17
734030,1,4,1,10,1,11,11
734038,1,4,1,14,1,15,15
734052,1,4,1,10,0,10,10
734054,1,4,1,8,1,9,9
829722,1,4,1,10,0,10,10
829730,1,4,1,1,0,1,1
829738,1,4,1,2,0,2,2
829772,1,4,1,6,0,6,6
829796,1,4,1,2,0,2,2
829808,1,4,1,13,1,14,14
829814,1,4,1,5,0,5,5
980910,1,4,1,3,0,3,3
980918,1,4,1,2,0,2,2
980930,1,4,1,5,0,5,5
980940,1,4,1,8,0,8,8
980960,1,4,1,9,0,9,9
980976,1,4,1,1,0,1,1
980996,1,4,1,6,1,7,7
981010,1,4,1,8,0,8,8
1082601,1,4,1,10,0,10,10
1082612,1,4,1,8,0,8,8
1082616,1,4,1,11,0,11,11
1082633,1,4,1,2,0,2,2
1082637,1,4,1,2,0,2,2
1082639,1,4,1,8,0,8,8
1082641,1,4,1,13,0,13,13
1082645,1,4,1,4,0,4,4
335988,2,4,1,9,0,9,9
336000,2,4,1,1,1,2,2
336004,2,4,1,11,0,11,11
336011,2,4,1,2,4,6,6
336018,2,4,1,12,0,12,12
336021,2,4,1,10,2,12,12
336027,2,4,1,3,0,3,3
336036,2,4,1,14,0,14,14
392196,2,4,1,3,1,4,4
392209,2,4,1,3,0,3,3
392212,2,4,1,2,0,2,2
392215,2,4,1,1,1,2,2
392219,2,4,1,5,0,5,5
392221,2,4,1,7,1,8,8
392231,2,4,1,2,0,2,2
392239,2,4,1,3,0,3,3
419122,2,4,1,8,1,9,9
419129,2,4,1,7,0,7,7
419132,2,4,1,1,0,1,1
419144,2,4,1,8,0,8,8
419151,2,4,1,9,0,9,9
419154,2,4,1,7,0,7,7
501211,2,4,1,8,0,8,8
501217,2,4,1,9,0,9,9
501228,2,4,1,4,0,4,4
501242,2,4,1,1,0,1,1
501249,2,4,1,3,1,4,4
501259,2,4,1,5,2,7,7
501269,2,4,1,5,0,5,5
548314,2,4,1,11,1,12,12
548318,2,4,1,2,1,3,3
548324,2,4,1,7,0,7,7
548339,2,4,1,10,0,10,10
548355,2,4,1,8,3,11,11
548359,2,4,1,8,0,8,8
548371,2,4,1,2,1,3,3
548376,2,4,1,9,0,9,9
598008,2,4,1,14,0,14,14
598030,2,4,1,4,1,5,5
598042,2,4,1,6,1,7,7
598046,2,4,1,7,1,8,8
598050,2,4,1,5,2,7,7
598061,2,4,1,2,0,2,2
598064,2,4,1,7,0,7,7
598069,2,4,1,6,0,6,6
729288,2,4,1,3,0,3,3
729296,2,4,1,4,1,5,5
729318,2,4,1,2,0,2,2
734012,2,4,1,8,0,8,8
734024,2,4,1,4,2,6,6
734044,2,4,1,10,0,10,10
734048,2,4,1,4,1,5,5
829714,2,4,1,10,1,11,11
829746,2,4,1,2,0,2,2
829758,2,4,1,3,1,4,4
829764,2,4,1,4,0,4,4
829780,2,4,1,3,6,9,9
829790,2,4,1,3,8,11,11
829804,2,4,1,1,0,1,1
980924,2,4,1,3,0,3,3
980946,2,4,1,1,0,1,1
980968,2,4,1,1,1,2,2
980982,2,4,1,5,0,5,5
980990,2,4,1,1,0,1,1
981004,2,4,1,11,0,11,11
1082594,2,4,1,6,0,6,6
1082598,2,4,1,6,0,6,6
1082605,2,4,1,2,0,2,2
1082609,2,4,1,6,0,6,6
1082623,2,4,1,10,0,10,10
1082626,2,4,1,8,0,8,8
829746,3,4,1,13,2,15,15
419126,4,4,1,10,0,10,10
335989,1,5,1,6,1,7,7
336005,1,5,1,5,0,5,5
336013,1,5,1,5,0,5,5
336028,1,5,1,8,2,10,10
336038,1,5,1,7,5,12,12
336043,1,5,1,0,1,1,1
392195,1,5,1,3,1,4,4
392215,1,5,1,16,0,16,16
392222,1,5,1,5,0,5,5
392230,1,5,1,7,0,7,7
392238,1,5,1,22,0,22,22
419116,1,5,1,13,1,14,14
419120,1,5,1,7,0,7,7
419123,1,5,1,6,0,6,6
419129,1,5,1,8,0,8,8
419134,1,5,1,13,0,13,13
419146,1,5,1,6,0,6,6
419159,1,5,1,6,0,6,6
419163,1,5,1,6,0,6,6
501214,1,5,1,4,2,6,6
501219,1,5,1,4,0,4,4
501245,1,5,1,5,4,9,9
501257,1,5,1,3,1,4,4
501263,1,5,1,5,0,5,5
548314,1,5,1,3,2,5,5
548317,1,5,1,1,0,1,1
548325,1,5,1,4,0,4,4
548329,1,5,1,2,0,2,2
548337,1,5,1,5,0,5,5
548354,1,5,1,5,0,5,5
548359,1,5,1,2,1,3,3
548366,1,5,1,4,1,5,5
548370,1,5,1,6,2,8,8
548378,1,5,1,6,0,6,6
548382,1,5,1,6,1,7,7
598006,1,5,1,4,1,5,5
598010,1,5,1,0,1,1,1
598014,1,5,1,7,0,7,7
598024,1,5,1,2,1,3,3
598028,1,5,1,5,0,5,5
598031,1,5,1,5,0,5,5
598048,1,5,1,5,0,5,5
598077,1,5,1,4,0,4,4
729296,1,5,1,6,0,6,6
729320,1,5,1,7,0,7,7
733984,1,5,1,5,0,5,5
734008,1,5,1,2,0,2,2
734016,1,5,1,7,0,7,7
734046,1,5,1,5,0,5,5
829714,1,5,1,0,4,4,4
829746,1,5,1,5,1,6,6
829754,1,5,1,6,2,8,8
829782,1,5,1,2,3,5,5
829816,1,5,1,9,0,9,9
335992,2,5,1,5,1,6,6
335995,2,5,1,5,0,5,5
335997,2,5,1,9,0,9,9
336010,2,5,1,0,0,0,0
336016,2,5,1,10,0,10,10
336020,2,5,1,1,0,1,1
336024,2,5,1,5,0,5,5
336032,2,5,1,6,0,6,6
336041,2,5,1,1,0,1,1
336045,2,5,1,2,0,2,2
392187,2,5,1,1,1,2,2
392200,2,5,1,5,1,6,6
392203,2,5,1,4,2,6,6
392207,2,5,1,1,0,1,7
392210,2,5,1,2,1,3,3
392218,2,5,1,2,0,2,2
392225,2,5,1,5,0,5,5
392235,2,5,1,1,1,2,2
419112,2,5,1,1,0,1,1
419131,2,5,1,8,0,8,8
419139,2,5,1,1,0,1,1
419142,2,5,1,14,0,14,14
419148,2,5,1,8,1,9,9
419155,2,5,1,0,1,1,1
501204,2,5,1,11,0,11,11
501209,2,5,1,6,2,8,8
501225,2,5,1,7,0,7,7
501230,2,5,1,8,0,8,8
501236,2,5,1,3,0,3,3
501240,2,5,1,5,5,10,10
501254,2,5,1,8,0,8,8
501268,2,5,1,7,1,8,8
548322,2,5,1,7,0,7,7
548331,2,5,1,5,0,5,5
548341,2,5,1,5,3,8,8
548350,2,5,1,6,0,6,6
548363,2,5,1,4,0,4,4
598019,2,5,1,1,5,6,6
598037,2,5,1,1,0,1,1
598041,2,5,1,8,0,8,8
598052,2,5,1,8,1,9,9
598054,2,5,1,0,0,0,0
598057,2,5,1,4,0,4,4
598063,2,5,1,2,0,2,2
598068,2,5,1,4,1,5,5
598070,2,5,1,3,0,3,3
598076,2,5,1,8,0,8,8
729290,2,5,1,4,0,4,4
729302,2,5,1,9,1,10,10
729310,2,5,1,10,1,11,11
733980,2,5,1,5,0,5,5
733994,2,5,1,1,1,2,2
734004,2,5,1,6,0,6,6
734022,2,5,1,3,1,4,4
734038,2,5,1,5,0,5,5
829720,2,5,1,2,0,2,2
829726,2,5,1,1,0,1,1
829732,2,5,1,6,0,6,6
829740,2,5,1,1,0,1,1
829774,2,5,1,7,2,9,9
829792,2,5,1,8,0,8,8
829802,2,5,1,4,0,4,4
829824,2,5,1,11,0,11,11
392195,4,5,1,18,0,18,18
729320,4,5,1,11,0,11,11
829746,4,5,1,5,1,6,6
336000,1,6,1,8,0,8,8
336003,1,6,1,3,0,3,3
336014,1,6,1,6,1,7,7
336020,1,6,1,12,0,12,12
336025,1,6,1,7,0,7,7
336027,1,6,1,6,4,10,10
392194,1,6,1,2,0,2,2
392203,1,6,1,7,0,7,7
392228,1,6,1,4,1,5,5
392231,1,6,1,6,1,7,7
392235,1,6,1,2,2,4,4
392237,1,6,1,1,0,1,1
392242,1,6,1,0,0,0,0
419121,1,6,1,9,0,9,9
419133,1,6,1,13,0,13,13
419136,1,6,1,9,0,9,9
419139,1,6,1,11,0,11,11
419145,1,6,1,2,0,2,2
419154,1,6,1,4,0,4,4
501206,1,6,1,10,0,10,10
501209,1,6,1,5,0,5,5
501228,1,6,1,9,1,10,10
501232,1,6,1,5,1,6,6
501238,1,6,1,3,1,4,4
501243,1,6,1,9,0,9,9
501270,1,6,1,1,1,2,2
548347,1,6,1,1,0,1,1
548350,1,6,1,7,0,7,7
548362,1,6,1,0,0,0,0
548369,1,6,1,5,0,5,5
598003,1,6,1,8,1,9,9
598015,1,6,1,0,0,0,0
598022,1,6,1,0,1,1,1
598040,1,6,1,3,0,3,3
598049,1,6,1,4,0,4,4
598054,1,6,1,8,3,11,11
598064,1,6,1,5,1,6,6
729286,1,6,1,3,1,4,4
733980,1,6,1,9,0,9,9
733986,1,6,1,4,4,8,8
733990,1,6,1,8,0,8,8
733998,1,6,1,4,0,4,4
734024,1,6,1,6,0,6,6
734044,1,6,1,6,0,6,6
829720,1,6,1,7,1,8,8
829736,1,6,1,6,1,7,7
829744,1,6,1,1,2,3,3
829752,1,6,1,2,2,4,4
829762,1,6,1,1,1,2,2
829788,1,6,1,4,0,4,4
829818,1,6,1,2,1,3,3
980908,1,6,1,12,1,13,13
980938,1,6,1,10,0,10,10
980956,1,6,1,2,0,2,2
980970,1,6,1,2,0,2,2
981002,1,6,1,2,0,2,2
981016,1,6,1,9,1,10,10
1082599,1,6,1,0,2,2,2
1082605,1,6,1,8,0,8,8
1082608,1,6,1,10,0,10,10
1082622,1,6,1,5,0,5,5
1082626,1,6,1,1,0,1,1
1082642,1,6,1,3,0,3,3
335989,2,6,1,8,0,8,8
335993,2,6,1,4,0,4,4
336006,2,6,1,8,0,8,8
336009,2,6,1,2,0,2,2
336022,2,6,1,4,1,5,5
336031,2,6,1,6,4,10,10
336037,2,6,1,19,0,19,19
336043,2,6,1,5,3,8,8
392188,2,6,1,8,1,9,9
392199,2,6,1,9,0,9,9
392206,2,6,1,5,0,5,5
392211,2,6,1,5,0,5,5
392216,2,6,1,4,0,4,4
392220,2,6,1,5,3,8,8
392224,2,6,1,2,1,3,3
392240,2,6,1,8,0,8,8
419113,2,6,1,9,0,9,9
419116,2,6,1,11,1,12,12
419119,2,6,1,4,0,4,4
419125,2,6,1,9,0,9,9
419149,2,6,1,1,0,1,1
419157,2,6,1,7,1,8,8
419160,2,6,1,5,0,5,5
419165,2,6,1,5,0,5,5
501218,2,6,1,5,0,5,5
501221,2,6,1,1,0,1,1
501235,2,6,1,6,1,7,7
501248,2,6,1,5,0,5,5
501251,2,6,1,4,0,4,4
501258,2,6,1,4,0,4,4
501262,2,6,1,5,5,10,10
548312,2,6,1,5,0,5,5
548315,2,6,1,14,0,14,14
548321,2,6,1,12,0,12,12
548326,2,6,1,2,0,2,2
548330,2,6,1,8,0,8,8
548334,2,6,1,12,4,16,16
548338,2,6,1,5,0,5,5
548342,2,6,1,6,2,8,8
548354,2,6,1,1,0,1,1
548374,2,6,1,11,0,11,11
548377,2,6,1,10,1,11,11
548379,2,6,1,10,0,10,10
548383,2,6,1,8,3,11,11
548385,2,6,1,6,0,6,6
598006,2,6,1,3,2,5,5
598011,2,6,1,2,0,2,2
598025,2,6,1,8,1,9,9
598029,2,6,1,2,0,2,2
598033,2,6,1,1,0,1,1
598045,2,6,1,2,1,3,3
598059,2,6,1,7,0,7,7
598067,2,6,1,5,1,6,6
598072,2,6,1,6,6,12,12
729294,2,6,1,9,1,10,10
729298,2,6,1,6,0,6,6
729306,2,6,1,3,1,4,4
729314,2,6,1,6,0,6,6
734010,2,6,1,7,0,7,7
734016,2,6,1,6,0,6,6
734036,2,6,1,7,1,8,8
829712,2,6,1,4,0,4,4
829730,2,6,1,7,0,7,7
829766,2,6,1,4,0,4,4
829772,2,6,1,2,0,2,2
829782,2,6,1,6,0,6,6
829798,2,6,1,5,0,5,5
829806,2,6,1,5,0,5,5
980918,2,6,1,6,0,6,6
980926,2,6,1,5,6,11,11
980950,2,6,1,2,0,2,2
980966,2,6,1,10,0,10,10
980976,2,6,1,2,1,3,3
980988,2,6,1,5,0,5,5
980998,2,6,1,10,0,10,10
981008,2,6,1,2,6,8,8
1082595,2,6,1,8,1,9,9
1082611,2,6,1,1,1,2,2
1082614,2,6,1,9,0,9,9
1082630,2,6,1,3,0,3,3
1082632,2,6,1,9,2,11,11
1082635,2,6,1,4,0,4,4
1082640,2,6,1,7,0,7,7
1082646,2,6,1,2,0,2,2
598022,4,6,1,11,0,11,11
335990,1,7,1,8,0,8,8
335999,1,7,1,5,1,6,6
336009,1,7,1,4,1,5,5
336029,1,7,1,10,1,11,11
336037,1,7,1,5,0,5,5
336041,1,7,1,1,1,2,2
392186,1,7,1,3,0,3,3
392202,1,7,1,4,0,4,4
392208,1,7,1,7,2,9,9
392213,1,7,1,0,0,0,0
392220,1,7,1,0,1,1,1
392223,1,7,1,4,1,5,5
392232,1,7,1,1,0,1,1
392240,1,7,1,2,3,5,5
419112,1,7,1,13,0,13,13
419119,1,7,1,8,4,12,12
419124,1,7,1,5,0,5,5
419135,1,7,1,4,1,5,5
419143,1,7,1,9,3,12,12
419151,1,7,1,7,0,7,7
419155,1,7,1,10,1,11,11
419157,1,7,1,8,0,8,8
419162,1,7,1,4,0,4,4
419166,1,7,1,3,0,3,3
419167,1,7,1,2,0,2,2
501215,1,7,1,5,2,7,7
501226,1,7,1,0,0,0,0
501229,1,7,1,6,0,6,6
501236,1,7,1,7,0,7,7
501242,1,7,1,3,0,3,3
501246,1,7,1,5,0,5,5
501251,1,7,1,9,1,10,10
501268,1,7,1,2,0,2,2
548322,1,7,1,1,1,2,2
548330,1,7,1,0,2,2,2
548339,1,7,1,0,0,0,0
548356,1,7,1,4,0,4,4
548365,1,7,1,1,0,1,1
548368,1,7,1,1,0,1,1
598007,1,7,1,4,0,4,4
598011,1,7,1,0,0,0,0
598016,1,7,1,3,0,3,3
598029,1,7,1,2,0,2,2
598038,1,7,1,7,0,7,7
598042,1,7,1,2,0,2,2
598044,1,7,1,6,0,6,6
598051,1,7,1,4,0,4,4
598055,1,7,1,0,0,0,0
598068,1,7,1,2,0,2,2
598078,1,7,1,8,0,8,8
729292,1,7,1,8,0,8,8
729308,1,7,1,2,0,2,2
729314,1,7,1,5,2,7,7
733988,1,7,1,5,2,7,7
734000,1,7,1,3,1,4,4
734014,1,7,1,0,3,3,3
734022,1,7,1,4,0,4,4
734036,1,7,1,6,0,6,6
734050,1,7,1,6,0,6,6
829710,1,7,1,3,1,4,4
829726,1,7,1,6,0,6,6
829734,1,7,1,1,1,2,2
829742,1,7,1,2,0,2,2
829756,1,7,1,10,1,11,11
829774,1,7,1,5,0,5,5
829780,1,7,1,9,0,9,9
829810,1,7,1,6,0,6,6
829822,1,7,1,5,0,5,5
829828,1,7,1,1,0,1,1
980906,1,7,1,8,0,8,8
980922,1,7,1,3,0,3,3
980928,1,7,1,2,0,2,2
980946,1,7,1,2,0,2,2
980990,1,7,1,5,0,5,5
980998,1,7,1,11,0,11,11
981012,1,7,1,8,0,8,8
1082592,1,7,1,10,1,11,11
1082614,1,7,1,2,6,8,8
1082635,1,7,1,3,0,3,3
1082638,1,7,1,2,1,3,3
1082644,1,7,1,1,1,2,2
1082650,1,7,1,3,0,3,3
335994,2,7,1,7,2,9,9
335996,2,7,1,1,1,2,2
336002,2,7,1,4,2,6,6
336013,2,7,1,0,2,2,2
336017,2,7,1,9,0,9,9
336023,2,7,1,7,0,7,7
336026,2,7,1,5,1,6,6
336033,2,7,1,3,7,10,10
392197,2,7,1,2,1,3,3
392202,2,7,1,1,0,1,4
392205,2,7,1,2,1,3,3
392217,2,7,1,6,0,6,6
392227,2,7,1,4,1,5,5
392230,2,7,1,8,0,8,8
419119,2,7,1,9,0,9,13
419127,2,7,1,12,0,12,12
419130,2,7,1,5,1,6,6
419137,2,7,1,10,0,10,10
419147,2,7,1,7,0,7,7
419170,2,7,1,0,0,0,0
501206,2,7,1,1,0,1,1
501210,2,7,1,6,1,7,7
501223,2,7,1,6,0,6,6
501256,2,7,1,12,0,12,12
501261,2,7,1,1,4,5,5
501272,2,7,1,12,1,13,13
501274,2,7,1,14,0,14,14
501275,2,7,1,10,0,10,10
548311,2,7,1,1,0,1,1
548313,2,7,1,2,0,2,2
548319,2,7,1,2,0,2,2
548344,2,7,1,4,0,4,4
548347,2,7,1,10,0,10,10
548351,2,7,1,0,1,1,1
548360,2,7,1,0,0,0,0
548372,2,7,1,0,2,2,2
548375,2,7,1,4,1,5,5
548382,2,7,1,8,0,8,8
548384,2,7,1,6,0,6,6
598004,2,7,1,2,0,2,2
598024,2,7,1,2,2,4,4
598034,2,7,1,5,0,5,5
598060,2,7,1,4,0,4,4
598065,2,7,1,5,0,5,5
598071,2,7,1,2,0,2,2
598075,2,7,1,10,0,10,10
598077,2,7,1,6,0,6,6
729284,2,7,1,8,0,8,8
729322,2,7,1,6,0,6,6
733978,2,7,1,5,1,6,6
734006,2,7,1,2,0,2,2
734030,2,7,1,12,1,13,13
734046,2,7,1,12,0,12,12
829722,2,7,1,3,0,3,3
829752,2,7,1,6,1,7,7
829788,2,7,1,5,3,8,8
829794,2,7,1,2,1,3,3
829800,2,7,1,8,1,9,9
829820,2,7,1,5,0,5,5
980914,2,7,1,8,0,8,8
980932,2,7,1,6,0,6,6
980938,2,7,1,8,0,8,8
980952,2,7,1,8,0,8,8
980962,2,7,1,4,0,4,4
980978,2,7,1,5,0,5,5
980986,2,7,1,2,0,2,2
1082597,2,7,1,9,0,9,9
1082600,2,7,1,5,1,6,6
1082602,2,7,1,2,2,4,4
1082606,2,7,1,5,1,6,6
1082612,2,7,1,9,1,10,10
1082618,2,7,1,3,0,3,3
1082625,2,7,1,13,0,13,13
1082628,2,7,1,6,0,6,6
1082641,2,7,1,9,1,10,10
1082647,2,7,1,1,0,1,1
1082649,2,7,1,7,4,11,11
1082625,3,7,1,11,0,11,11
335991,1,8,1,8,1,9,9
335993,1,8,1,0,1,1,1
335995,1,8,1,12,0,12,12
336004,1,8,1,6,0,6,6
336007,1,8,1,2,6,8,8
336016,1,8,1,8,0,8,8
336036,1,8,1,5,0,5,5
336042,1,8,1,1,0,1,1
392193,1,8,1,12,0,12,12
392197,1,8,1,6,0,6,6
392206,1,8,1,8,0,8,8
392210,1,8,1,8,0,8,8
392217,1,8,1,5,2,7,7
392221,1,8,1,6,1,7,7
392225,1,8,1,7,1,8,8
392244,1,8,1,2,0,2,2
419115,1,8,1,6,2,8,8
419122,1,8,1,4,0,4,4
419125,1,8,1,2,2,4,4
419131,1,8,1,2,0,2,2
419156,1,8,1,1,0,1,1
419165,1,8,1,7,0,7,7
419169,1,8,1,4,0,4,4
501204,1,8,1,10,0,10,10
501213,1,8,1,2,1,3,3
501217,1,8,1,9,0,9,9
501221,1,8,1,13,0,13,13
501234,1,8,1,2,1,3,3
501248,1,8,1,8,2,10,10
501255,1,8,1,4,0,4,4
501261,1,8,1,1,0,1,1
501269,1,8,1,4,0,4,4
548319,1,8,1,2,0,2,2
548326,1,8,1,2,0,2,2
548331,1,8,1,9,0,9,9
548334,1,8,1,8,0,8,8
548340,1,8,1,6,0,6,6
548346,1,8,1,13,3,16,16
548351,1,8,1,2,1,3,3
548353,1,8,1,4,0,4,4
548361,1,8,1,10,1,11,11
548371,1,8,1,5,0,5,5
548381,1,8,1,6,0,6,6
335999,2,8,1,10,0,10,10
336012,2,8,1,3,0,3,3
336019,2,8,1,5,0,5,5
336025,2,8,1,9,1,10,10
336029,2,8,1,5,0,5,5
336039,2,8,1,5,2,7,7
392189,2,8,1,9,0,9,9
392201,2,8,1,11,0,11,11
392214,2,8,1,0,0,0,0
392228,2,8,1,18,0,18,18
392233,2,8,1,5,0,5,5
392234,2,8,1,5,0,5,5
392241,2,8,1,4,0,4,4
392242,2,8,1,20,1,21,21
419111,2,8,1,3,2,5,5
419135,2,8,1,8,2,10,10
419140,2,8,1,13,1,14,14
419143,2,8,1,9,0,9,9
419146,2,8,1,2,0,2,2
419150,2,8,1,5,0,5,5
419152,2,8,1,3,0,3,3
419161,2,8,1,9,0,9,9
419168,2,8,1,1,0,1,1
501208,2,8,1,1,0,1,1
501229,2,8,1,5,0,5,5
501241,2,8,1,4,2,6,6
501244,2,8,1,1,0,1,1
501264,2,8,1,4,0,4,4
548316,2,8,1,4,0,4,4
548357,2,8,1,4,0,4,4
548364,2,8,1,8,0,8,8
548378,2,8,1,11,0,11,11
501205,1,9,1,6,1,7,7
501212,1,9,1,9,0,9,9
501224,1,9,1,5,1,6,6
501230,1,9,1,5,4,9,9
501247,1,9,1,0,0,0,0
501252,1,9,1,7,0,7,7
501259,1,9,1,9,6,15,15
501215,2,9,1,5,0,5,5
501220,2,9,1,7,0,7,7
501234,2,9,1,0,0,0,0
501238,2,9,1,2,1,3,3
501243,2,9,1,5,8,13,13
501263,2,9,1,17,2,19,19
501266,2,9,1,3,0,3,3
501218,1,10,1,14,0,14,14
501223,1,10,1,3,0,3,3
501233,1,10,1,2,0,2,2
501240,1,10,1,6,0,6,6
501264,1,10,1,14,0,14,14
501267,1,10,1,9,0,9,9
548313,1,10,1,0,0,0,0
548318,1,10,1,10,0,10,10
548324,1,10,1,5,0,5,5
548332,1,10,1,4,1,5,5
548338,1,10,1,0,0,0,0
548342,1,10,1,1,0,1,1
548363,1,10,1,3,3,6,6
598008,1,10,1,1,0,1,1
598020,1,10,1,13,0,13,13
598030,1,10,1,8,1,9,9
598052,1,10,1,9,0,9,9
598060,1,10,1,1,0,1,1
598066,1,10,1,6,0,6,6
598072,1,10,1,11,0,11,11
501207,2,10,1,1,1,2,2
501212,2,10,1,10,0,10,10
501231,2,10,1,2,1,3,3
501237,2,10,1,4,1,5,5
501246,2,10,1,0,0,0,0
501253,2,10,1,0,0,0,0
501255,2,10,1,14,1,15,15
548327,2,10,1,5,1,6,6
548335,2,10,1,8,1,9,9
548346,2,10,1,3,0,3,3
548353,2,10,1,3,0,3,3
548356,2,10,1,5,1,6,6
548358,2,10,1,10,0,10,10
548367,2,10,1,4,0,4,4
548370,2,10,1,3,0,3,3
548380,2,10,1,7,2,9,9
598005,2,10,1,2,0,2,2
598014,2,10,1,5,1,6,6
598016,2,10,1,4,1,5,5
598023,2,10,1,7,0,7,7
598032,2,10,1,9,0,9,9
598040,2,10,1,0,0,0,0
598043,2,10,1,8,1,9,9
598047,2,10,1,4,0,4,4
598058,2,10,1,9,0,9,9
598005,1,11,1,3,1,4,4
598023,1,11,1,2,0,2,2
598035,1,11,1,6,0,6,6
598037,1,11,1,2,0,2,2
598053,1,11,1,7,0,7,7
598061,1,11,1,4,0,4,4
598065,1,11,1,18,1,19,19
598070,1,11,1,3,0,3,3
598076,1,11,1,2,0,2,2
729290,1,11,1,2,0,2,2
729306,1,11,1,5,1,6,6
729316,1,11,1,6,2,8,8
729322,1,11,1,8,2,10,10
733982,1,11,1,3,0,3,3
733994,1,11,1,9,0,9,9
734006,1,11,1,4,0,4,4
734012,1,11,1,6,0,6,6
734020,1,11,1,6,2,8,8
734042,1,11,1,8,1,9,9
829732,1,11,1,1,0,1,1
829748,1,11,1,2,1,3,3
829764,1,11,1,0,0,0,0
829778,1,11,1,10,0,10,10
829792,1,11,1,13,0,13,13
829798,1,11,1,8,0,8,8
829804,1,11,1,5,0,5,5
829812,1,11,1,5,1,6,6
829820,1,11,1,7,0,7,7
980920,1,11,1,6,3,9,9
980948,1,11,1,0,4,4,4
980958,1,11,1,6,0,6,6
980978,1,11,1,6,1,7,7
980984,1,11,1,2,0,2,2
980988,1,11,1,6,0,6,6
981008,1,11,1,1,0,1,1
981020,1,11,1,4,0,4,4
981024,1,11,1,7,0,7,7
1082591,1,11,1,4,3,7,7
1082600,1,11,1,2,0,2,2
1082609,1,11,1,2,1,3,3
1082611,1,11,1,9,1,10,10
1082615,1,11,1,7,0,7,7
1082623,1,11,1,2,1,3,3
1082627,1,11,1,6,0,6,6
1082630,1,11,1,4,0,4,4
1082648,1,11,1,7,0,7,7
598009,2,11,1,4,0,4,4
598015,2,11,1,1,1,2,2
598018,2,11,1,5,2,7,7
598026,2,11,1,0,0,0,0
598044,2,11,1,6,0,6,6
598049,2,11,1,6,0,6,6
598056,2,11,1,4,0,4,4
598074,2,11,1,3,0,3,3
729300,2,11,1,10,1,11,11
733998,2,11,1,5,5,10,10
734026,2,11,1,6,0,6,6
734034,2,11,1,10,0,10,10
829716,2,11,1,10,0,10,10
829724,2,11,1,16,0,16,16
829736,2,11,1,3,0,3,3
829756,2,11,1,9,0,9,9
829786,2,11,1,4,2,6,6
980912,2,11,1,7,5,12,12
980928,2,11,1,3,1,4,4
980934,2,11,1,10,0,10,10
980940,2,11,1,6,0,6,6
980972,2,11,1,7,0,7,7
980996,2,11,1,8,0,8,8
981014,2,11,1,4,0,4,4
981022,2,11,1,5,1,6,6
1082596,2,11,1,3,0,3,3
1082604,2,11,1,3,2,5,5
1082634,2,11,1,11,0,11,11
1082638,2,11,1,7,0,7,7
1082643,2,11,1,6,1,7,7
598009,3,11,1,19,1,20,20
980916,1,12,1,5,0,5,5
980924,1,12,1,4,0,4,4
980944,1,12,1,2,0,2,2
980954,1,12,1,5,0,5,5
980962,1,12,1,6,1,7,7
980974,1,12,1,9,0,9,9
980994,1,12,1,3,1,4,4
1082594,1,12,1,1,0,1,1
1082603,1,12,1,4,2,6,6
1082607,1,12,1,3,0,3,3
1082618,1,12,1,8,1,9,9
1082620,1,12,1,5,1,6,6
1082624,1,12,1,3,1,4,4
1082634,1,12,1,3,0,3,3
1082647,1,12,1,4,2,6,6
980906,2,12,1,8,0,8,8
980936,2,12,1,11,0,11,11
980948,2,12,1,0,0,0,0
980970,2,12,1,6,0,6,6
980984,2,12,1,0,1,1,1
981002,2,12,1,2,2,4,4
981010,2,12,1,6,0,6,6
1082592,2,12,1,7,1,8,8
1082599,2,12,1,9,1,10,10
1082615,2,12,1,1,0,1,1
1082629,2,12,1,8,0,8,8
1082631,2,12,1,7,0,7,7
1082642,2,12,1,9,1,10,10
1082645,2,12,1,3,0,3,3
1082650,2,12,1,6,0,6,6
980934,1,13,1,5,0,5,5
980950,1,13,1,18,0,18,18
980966,1,13,1,5,0,5,5
980972,1,13,1,0,0,0,0
981018,1,13,1,1,1,2,2
981022,1,13,1,6,1,7,7
1082593,1,13,1,8,0,8,8
1082596,1,13,1,3,0,3,3
1082606,1,13,1,2,1,3,3
1082625,1,13,1,6,1,7,7
1082629,1,13,1,10,1,11,11
1082632,1,13,1,10,0,10,10
1082640,1,13,1,7,0,7,7
1082643,1,13,1,11,0,11,11
980910,2,13,1,1,0,1,1
980916,2,13,1,6,1,7,7
980922,2,13,1,11,0,11,11
980942,2,13,1,2,1,3,3
980954,2,13,1,6,0,6,6
980960,2,13,1,10,1,11,11
980980,2,13,1,1,0,1,1
980992,2,13,1,7,0,7,7
981006,2,13,1,11,1,12,12
981012,2,13,1,0,0,0,0
1082603,2,13,1,16,0,16,16
1082610,2,13,1,1,0,1,1
1082613,2,13,1,9,0,9,9
1082616,2,13,1,6,0,6,6
1082621,2,13,1,8,0,8,8
1082637,2,13,1,7,0,7,7
1082625,4,13,1,2,4,6,6
335987,1,1,2,18,0,18,21
335998,1,1,2,15,1,16,24
336002,1,1,2,9,0,9,15
336015,1,1,2,6,1,7,9
336019,1,1,2,2,0,2,8
336022,1,1,2,7,1,8,11
336026,1,1,2,6,1,7,12
336030,1,1,2,5,0,5,10
336032,1,1,2,0,0,0,7
392189,1,1,2,1,0,1,2
392204,1,1,2,10,0,10,13
392212,1,1,2,2,0,2,7
392216,1,1,2,7,2,9,12
392224,1,1,2,1,1,2,9
392226,1,1,2,8,0,8,13
392233,1,1,2,5,0,5,10
419111,1,1,2,5,0,5,6
419127,1,1,2,1,0,1,11
419132,1,1,2,8,0,8,27
419140,1,1,2,4,1,5,15
419144,1,1,2,7,1,8,17
419149,1,1,2,14,1,15,22
419153,1,1,2,5,0,5,12
419158,1,1,2,8,0,8,11
501208,1,1,2,9,0,9,17
501227,1,1,2,14,0,14,33
501235,1,1,2,8,1,9,13
501244,1,1,2,5,0,5,16
501260,1,1,2,7,0,7,15
501272,1,1,2,6,2,8,9
501274,1,1,2,6,0,6,9
548312,1,1,2,5,1,6,15
548320,1,1,2,5,3,8,12
548349,1,1,2,2,0,2,13
548358,1,1,2,9,0,9,16
548373,1,1,2,6,1,7,13
548375,1,1,2,5,0,5,11
548380,1,1,2,5,0,5,13
548383,1,1,2,9,0,9,14
598013,1,1,2,10,0,10,13
598018,1,1,2,14,1,15,18
598027,1,1,2,9,0,9,20
598034,1,1,2,9,1,10,36
598045,1,1,2,10,0,10,15
598058,1,1,2,13,0,13,17
598074,1,1,2,5,0,5,10
729284,1,1,2,4,0,4,5
729294,1,1,2,1,0,1,11
729304,1,1,2,11,0,11,17
734032,1,1,2,9,1,10,15
734048,1,1,2,3,0,3,5
829718,1,1,2,6,0,6,19
829766,1,1,2,6,1,7,12
829776,1,1,2,12,0,12,20
829786,1,1,2,9,0,9,15
980914,1,1,2,3,0,3,6
980952,1,1,2,11,0,11,15
980968,1,1,2,10,0,10,12
980980,1,1,2,10,0,10,15
981000,1,1,2,6,0,6,14
981006,1,1,2,11,0,11,14
981014,1,1,2,9,0,9,22
1082597,1,1,2,9,0,9,19
1082604,1,1,2,6,0,6,9
1082613,1,1,2,17,0,17,29
1082617,1,1,2,6,1,7,25
1082631,1,1,2,4,4,8,8
1082649,1,1,2,2,0,2,5
335991,2,1,2,6,4,10,16
336005,2,1,2,11,2,13,22
336008,2,1,2,6,0,6,16
336040,2,1,2,5,0,5,15
392191,2,1,2,4,2,6,9
392195,2,1,2,0,1,1,8
392202,2,1,2,1,0,1,5
392208,2,1,2,3,0,3,4
392236,2,1,2,1,0,1,11
392238,2,1,2,1,0,1,10
419114,2,1,2,9,0,9,12
419118,2,1,2,10,0,10,10
419123,2,1,2,5,1,6,11
419136,2,1,2,12,1,13,15
419163,2,1,2,9,0,9,21
419166,2,1,2,6,0,6,12
501203,2,1,2,4,0,4,14
501214,2,1,2,4,1,5,12
501219,2,1,2,6,1,7,9
501224,2,1,2,7,0,7,14
501239,2,1,2,5,0,5,10
501247,2,1,2,5,1,6,15
501250,2,1,2,5,1,6,14
501267,2,1,2,9,1,10,17
548317,2,1,2,4,0,4,8
548325,2,1,2,3,0,3,13
548328,2,1,2,11,0,11,13
548333,2,1,2,8,0,8,18
548340,2,1,2,4,0,4,9
548352,2,1,2,6,1,7,14
548362,2,1,2,4,0,4,14
548368,2,1,2,2,0,2,4
548386,2,1,2,6,0,6,9
598003,2,1,2,5,0,5,5
598010,2,1,2,2,2,4,18
598021,2,1,2,4,1,5,6
598036,2,1,2,5,0,5,14
598039,2,1,2,6,0,6,24
598048,2,1,2,6,1,7,15
598055,2,1,2,10,0,10,12
598062,2,1,2,4,0,4,4
598066,2,1,2,3,6,9,19
729312,2,1,2,4,0,4,11
729320,2,1,2,5,0,5,12
733976,2,1,2,12,1,13,16
733984,2,1,2,8,0,8,13
733990,2,1,2,8,5,13,15
734002,2,1,2,6,2,8,10
734014,2,1,2,5,1,6,13
734020,2,1,2,2,0,2,8
734028,2,1,2,9,0,9,21
734042,2,1,2,5,0,5,7
734054,2,1,2,9,0,9,19
829710,2,1,2,2,0,2,5
829728,2,1,2,5,2,7,13
829738,2,1,2,7,1,8,16
829744,2,1,2,3,4,7,13
829748,2,1,2,9,2,11,16
829770,2,1,2,10,0,10,15
829796,2,1,2,10,0,10,15
829810,2,1,2,5,0,5,12
829816,2,1,2,6,0,6,14
980908,2,1,2,15,1,16,20
980920,2,1,2,5,1,6,13
980930,2,1,2,7,1,8,20
980944,2,1,2,6,0,6,21
980956,2,1,2,8,0,8,13
980964,2,1,2,3,2,5,11
980994,2,1,2,13,0,13,22
981020,2,1,2,12,0,12,15
1082593,2,1,2,13,0,13,20
1082601,2,1,2,8,2,10,15
1082608,2,1,2,13,0,13,19
1082620,2,1,2,9,1,10,18
1082622,2,1,2,6,4,10,18
1082627,2,1,2,3,0,3,12
1082636,2,1,2,6,0,6,20
1082639,2,1,2,11,0,11,25
1082644,2,1,2,9,2,11,11
1082648,2,1,2,8,2,10,21
335997,1,2,2,13,2,15,16
336011,1,2,2,5,1,6,7
336017,1,2,2,5,0,5,11
336021,1,2,2,0,1,1,4
336031,1,2,2,12,7,19,20
336034,1,2,2,1,0,1,7
336039,1,2,2,11,0,11,13
392187,1,2,2,4,1,5,9
392196,1,2,2,8,0,8,14
392199,1,2,2,1,0,1,10
392209,1,2,2,5,1,6,8
392218,1,2,2,7,0,7,10
392241,1,2,2,3,0,3,7
419114,1,2,2,6,0,6,11
419128,1,2,2,6,0,6,8
419138,1,2,2,9,0,9,11
419150,1,2,2,11,2,13,17
501210,1,2,2,1,2,3,4
501237,1,2,2,5,0,5,8
501249,1,2,2,0,3,3,12
501273,1,2,2,1,4,5,12
501275,1,2,2,8,1,9,36
548315,1,2,2,7,0,7,11
548323,1,2,2,5,1,6,15
548341,1,2,2,10,0,10,15
548355,1,2,2,7,0,7,8
548367,1,2,2,7,1,8,11
548372,1,2,2,1,0,1,7
548377,1,2,2,0,0,0,11
598004,1,2,2,1,0,1,2
598009,1,2,2,5,0,5,13
598017,1,2,2,1,0,1,6
598032,1,2,2,20,1,21,24
598041,1,2,2,8,1,9,22
598047,1,2,2,1,0,1,9
598050,1,2,2,5,0,5,12
598059,1,2,2,5,0,5,6
598062,1,2,2,2,0,2,5
598069,1,2,2,8,0,8,11
598073,1,2,2,8,3,11,17
729310,1,2,2,4,0,4,5
729318,1,2,2,5,0,5,25
734004,1,2,2,1,0,1,5
734010,1,2,2,8,0,8,9
734026,1,2,2,2,0,2,7
734040,1,2,2,4,0,4,6
829724,1,2,2,9,0,9,20
829768,1,2,2,5,4,9,19
829790,1,2,2,20,0,20,21
829800,1,2,2,6,0,6,14
829824,1,2,2,5,0,5,10
829826,1,2,2,5,0,5,11
980912,1,2,2,2,1,3,8
980926,1,2,2,5,0,5,13
980932,1,2,2,1,1,2,6
980936,1,2,2,2,0,2,11
980942,1,2,2,7,0,7,9
980964,1,2,2,9,0,9,11
980982,1,2,2,4,0,4,13
980986,1,2,2,3,0,3,11
980992,1,2,2,2,0,2,3
981004,1,2,2,6,0,6,11
1082595,1,2,2,8,1,9,19
1082598,1,2,2,5,0,5,7
1082602,1,2,2,1,0,1,7
1082610,1,2,2,5,0,5,13
1082621,1,2,2,7,0,7,10
1082628,1,2,2,6,0,6,16
1082636,1,2,2,11,0,11,12
1082646,1,2,2,7,0,7,17
335987,2,2,2,1,4,5,9
335990,2,2,2,1,0,1,11
336001,2,2,2,6,0,6,12
336003,2,2,2,10,0,10,17
336007,2,2,2,6,0,6,16
336015,2,2,2,5,0,5,9
336028,2,2,2,3,0,3,4
392190,2,2,2,9,0,9,14
392193,2,2,2,3,0,3,13
392204,2,2,2,6,2,8,10
392213,2,2,2,11,1,12,21
392223,2,2,2,7,2,9,15
392226,2,2,2,4,1,5,7
392229,2,2,2,10,1,11,17
392237,2,2,2,4,0,4,6
392243,2,2,2,8,0,8,17
392244,2,2,2,4,0,4,5
419117,2,2,2,4,1,5,10
419120,2,2,2,17,3,20,32
419124,2,2,2,2,0,2,6
419133,2,2,2,5,0,5,13
419141,2,2,2,4,1,5,10
419145,2,2,2,6,1,7,18
419153,2,2,2,3,0,3,7
419156,2,2,2,7,1,8,14
419159,2,2,2,1,0,1,7
419162,2,2,2,1,0,1,5
419167,2,2,2,10,0,10,19
419169,2,2,2,7,1,8,14
501205,2,2,2,4,0,4,11
501213,2,2,2,6,0,6,8
501216,2,2,2,2,1,3,18
501227,2,2,2,5,0,5,13
501232,2,2,2,16,0,16,26
501252,2,2,2,20,0,20,29
501257,2,2,2,10,0,10,20
501260,2,2,2,23,0,23,39
501265,2,2,2,1,4,5,5
501271,2,2,2,1,1,2,8
501276,2,2,2,9,0,9,15
548320,2,2,2,1,0,1,7
548329,2,2,2,4,0,4,11
548332,2,2,2,1,0,1,4
548336,2,2,2,5,0,5,8
548349,2,2,2,6,1,7,9
548361,2,2,2,7,0,7,18
548365,2,2,2,1,2,3,7
548381,2,2,2,24,0,24,27
598013,2,2,2,7,0,7,11
598022,2,2,2,7,1,8,10
598028,2,2,2,9,0,9,13
598038,2,2,2,5,0,5,10
598053,2,2,2,4,0,4,16
729286,2,2,2,5,0,5,10
729292,2,2,2,4,0,4,11
729304,2,2,2,2,0,2,10
733982,2,2,2,0,1,1,6
733988,2,2,2,9,0,9,15
733996,2,2,2,4,0,4,8
734018,2,2,2,1,0,1,10
734032,2,2,2,6,0,6,7
829718,2,2,2,4,0,4,5
829742,2,2,2,0,0,0,4
829750,2,2,2,3,1,4,12
829754,2,2,2,5,4,9,13
829762,2,2,2,14,0,14,18
829776,2,2,2,17,1,18,22
829784,2,2,2,6,0,6,10
829808,2,2,2,6,0,6,16
829812,2,2,2,24,0,24,41
829818,2,2,2,0,0,0,2
980958,2,2,2,12,0,12,22
980974,2,2,2,2,1,3,7
981000,2,2,2,8,0,8,15
981016,2,2,2,6,5,11,16
981018,2,2,2,5,1,6,17
981024,2,2,2,11,2,13,18
1082591,2,2,2,1,0,1,12
1082607,2,2,2,11,0,11,18
1082617,2,2,2,4,0,4,7
1082624,2,2,2,7,0,7,11
1082633,2,2,2,15,0,15,22
335988,1,3,2,14,1,15,20
335994,1,3,2,9,0,9,16
336001,1,3,2,10,0,10,11
336006,1,3,2,6,1,7,11
336010,1,3,2,4,5,9,10
336012,1,3,2,2,4,6,10
336018,1,3,2,7,1,8,20
336023,1,3,2,12,0,12,13
336045,1,3,2,6,0,6,12
392190,1,3,2,5,1,6,15
392201,1,3,2,15,1,16,18
392207,1,3,2,1,0,1,5
392211,1,3,2,6,0,6,16
392214,1,3,2,4,1,5,15
392219,1,3,2,7,1,8,13
392229,1,3,2,15,1,16,20
392236,1,3,2,10,2,12,17
392239,1,3,2,11,0,11,17
392243,1,3,2,13,0,13,15
419118,1,3,2,9,0,9,10
419130,1,3,2,16,1,17,22
419142,1,3,2,15,0,15,23
419147,1,3,2,6,0,6,12
419152,1,3,2,10,1,11,17
419160,1,3,2,4,0,4,13
419168,1,3,2,5,1,6,12
419170,1,3,2,2,0,2,6
501203,1,3,2,6,0,6,11
501211,1,3,2,2,0,2,2
501216,1,3,2,3,1,4,6
501220,1,3,2,1,0,1,9
501231,1,3,2,7,1,8,10
501241,1,3,2,2,0,2,6
501250,1,3,2,4,0,4,5
501254,1,3,2,7,1,8,15
501258,1,3,2,11,0,11,17
501266,1,3,2,2,0,2,5
501271,1,3,2,2,0,2,7
501276,1,3,2,11,0,11,16
548311,1,3,2,3,1,4,9
548316,1,3,2,6,1,7,9
548321,1,3,2,7,1,8,12
548327,1,3,2,7,0,7,8
548335,1,3,2,2,0,2,8
548352,1,3,2,1,0,1,5
548357,1,3,2,5,0,5,11
548360,1,3,2,8,0,8,15
548376,1,3,2,5,2,7,11
548384,1,3,2,2,1,3,4
548385,1,3,2,7,0,7,19
548386,1,3,2,3,0,3,6
598025,1,3,2,6,0,6,11
598039,1,3,2,5,0,5,11
598043,1,3,2,0,0,0,6
598046,1,3,2,7,0,7,10
598056,1,3,2,10,1,11,11
598063,1,3,2,3,1,4,7
598067,1,3,2,4,0,4,9
598075,1,3,2,12,0,12,18
729288,1,3,2,9,1,10,19
729298,1,3,2,10,0,10,14
729302,1,3,2,3,0,3,8
733976,1,3,2,5,0,5,14
734018,1,3,2,1,0,1,8
734028,1,3,2,0,0,0,5
734034,1,3,2,12,0,12,24
829712,1,3,2,8,2,10,26
829716,1,3,2,6,1,7,11
829728,1,3,2,4,0,4,23
829740,1,3,2,2,0,2,11
829750,1,3,2,7,0,7,16
829758,1,3,2,10,0,10,14
829770,1,3,2,6,1,7,11
829784,1,3,2,6,0,6,6
829794,1,3,2,0,5,5,8
829802,1,3,2,6,0,6,11
829806,1,3,2,1,0,1,1
335998,2,3,2,2,1,3,8
336014,2,3,2,15,0,15,24
336030,2,3,2,13,0,13,18
336034,2,3,2,2,0,2,7
336038,2,3,2,8,1,9,15
336042,2,3,2,6,0,6,18
336044,2,3,2,6,1,7,14
392186,2,3,2,14,0,14,16
392194,2,3,2,9,1,10,21
392207,2,3,2,0,0,0,7
392222,2,3,2,1,0,1,10
392232,2,3,2,13,0,13,17
419115,2,3,2,8,0,8,12
419121,2,3,2,17,0,17,21
419126,2,3,2,1,1,2,8
419128,2,3,2,6,2,8,10
419134,2,3,2,11,0,11,15
419138,2,3,2,6,1,7,14
419158,2,3,2,13,1,14,22
419164,2,3,2,7,0,7,8
501226,2,3,2,4,1,5,10
501233,2,3,2,2,0,2,2
501245,2,3,2,3,0,3,8
501273,2,3,2,9,0,9,12
548323,2,3,2,5,0,5,7
548337,2,3,2,12,0,12,14
548348,2,3,2,6,0,6,8
548366,2,3,2,9,0,9,10
548369,2,3,2,7,1,8,10
548373,2,3,2,10,1,11,16
598007,2,3,2,5,0,5,10
598012,2,3,2,3,0,3,9
598017,2,3,2,1,0,1,4
598020,2,3,2,7,0,7,7
598027,2,3,2,5,0,5,12
598031,2,3,2,11,0,11,15
598035,2,3,2,12,1,13,17
598051,2,3,2,3,0,3,9
598073,2,3,2,3,0,3,11
598078,2,3,2,1,2,3,5
729308,2,3,2,2,0,2,2
729316,2,3,2,5,1,6,12
733986,2,3,2,5,3,8,15
733992,2,3,2,3,0,3,8
734000,2,3,2,2,0,2,14
734008,2,3,2,12,1,13,20
734040,2,3,2,15,0,15,20
734050,2,3,2,10,0,10,16
734052,2,3,2,18,0,18,27
829734,2,3,2,11,1,12,18
829778,2,3,2,0,1,1,14
829814,2,3,2,8,0,8,10
829822,2,3,2,15,2,17,19
829826,2,3,2,7,0,7,10
829828,2,3,2,7,0,7,12
335992,1,4,2,5,0,5,6
335996,1,4,2,6,0,6,8
336008,1,4,2,11,0,11,16
336024,1,4,2,8,0,8,13
336033,1,4,2,5,0,5,8
336040,1,4,2,11,5,16,21
336044,1,4,2,4,0,4,11
392188,1,4,2,11,0,11,21
392191,1,4,2,8,0,8,9
392200,1,4,2,6,0,6,7
392205,1,4,2,1,0,1,6
392227,1,4,2,5,0,5,10
392234,1,4,2,2,1,3,12
419113,1,4,2,8,1,9,12
419117,1,4,2,8,1,9,10
419126,1,4,2,11,0,11,13
419137,1,4,2,5,4,9,14
419141,1,4,2,7,0,7,8
419148,1,4,2,10,0,10,23
419161,1,4,2,6,0,6,8
419164,1,4,2,5,1,6,21
501207,1,4,2,0,1,1,5
501225,1,4,2,11,3,14,27
501239,1,4,2,7,0,7,10
501253,1,4,2,13,0,13,18
501256,1,4,2,4,2,6,8
501262,1,4,2,0,1,1,6
501265,1,4,2,7,2,9,14
548328,1,4,2,7,0,7,14
548333,1,4,2,7,0,7,15
548336,1,4,2,7,0,7,10
548344,1,4,2,6,0,6,9
548348,1,4,2,11,0,11,20
548364,1,4,2,16,2,18,23
548374,1,4,2,13,0,13,19
548379,1,4,2,0,0,0,5
598012,1,4,2,10,1,11,16
598019,1,4,2,3,4,7,8
598021,1,4,2,6,0,6,7
598026,1,4,2,4,0,4,6
598033,1,4,2,6,2,8,17
598036,1,4,2,0,0,0,5
598057,1,4,2,5,0,5,6
598071,1,4,2,0,0,0,2
729300,1,4,2,1,0,1,3
729312,1,4,2,1,1,2,9
733978,1,4,2,5,3,8,13
733992,1,4,2,12,0,12,21
733996,1,4,2,6,0,6,16
734002,1,4,2,4,0,4,21
734030,1,4,2,12,0,12,23
734038,1,4,2,4,1,5,20
734052,1,4,2,1,0,1,11
734054,1,4,2,6,0,6,15
829722,1,4,2,5,0,5,15
829730,1,4,2,10,0,10,11
829738,1,4,2,3,1,4,6
829772,1,4,2,3,0,3,9
829796,1,4,2,8,0,8,10
829808,1,4,2,19,1,20,34
829814,1,4,2,9,0,9,14
980910,1,4,2,10,0,10,13
980918,1,4,2,10,0,10,12
980930,1,4,2,6,0,6,11
980940,1,4,2,6,0,6,14
980960,1,4,2,4,0,4,13
980976,1,4,2,10,0,10,11
980996,1,4,2,12,0,12,19
981010,1,4,2,2,0,2,10
1082601,1,4,2,9,2,11,21
1082612,1,4,2,7,0,7,15
1082616,1,4,2,5,0,5,16
1082633,1,4,2,9,0,9,11
1082637,1,4,2,1,0,1,3
1082639,1,4,2,3,0,3,11
1082641,1,4,2,15,1,16,29
1082645,1,4,2,7,0,7,11
335988,2,4,2,7,0,7,16
336000,2,4,2,9,0,9,11
336004,2,4,2,6,0,6,17
336011,2,4,2,4,3,7,13
336018,2,4,2,4,0,4,16
336021,2,4,2,1,0,1,13
336027,2,4,2,11,1,12,15
336036,2,4,2,9,0,9,23
392196,2,4,2,8,2,10,14
392209,2,4,2,1,0,1,4
392212,2,4,2,2,2,4,6
392215,2,4,2,1,0,1,3
392219,2,4,2,6,0,6,11
392221,2,4,2,12,0,12,20
392231,2,4,2,14,0,14,16
392239,2,4,2,2,1,3,6
419122,2,4,2,1,0,1,10
419129,2,4,2,3,1,4,11
419132,2,4,2,4,2,6,7
419144,2,4,2,11,0,11,19
419151,2,4,2,9,1,10,19
419154,2,4,2,4,0,4,11
501211,2,4,2,7,0,7,15
501217,2,4,2,6,1,7,16
501228,2,4,2,14,0,14,18
501242,2,4,2,2,0,2,3
501249,2,4,2,1,0,1,5
501259,2,4,2,6,0,6,13
501269,2,4,2,9,0,9,14
548314,2,4,2,3,0,3,15
548318,2,4,2,4,0,4,7
548324,2,4,2,6,0,6,13
548339,2,4,2,6,0,6,16
548355,2,4,2,6,0,6,17
548359,2,4,2,0,0,0,8
548371,2,4,2,3,1,4,7
548376,2,4,2,9,3,12,21
598008,2,4,2,6,1,7,21
598030,2,4,2,10,0,10,15
598042,2,4,2,5,0,5,12
598046,2,4,2,5,0,5,13
598050,2,4,2,11,1,12,19
598061,2,4,2,5,0,5,7
598064,2,4,2,14,0,14,21
598069,2,4,2,6,0,6,12
729288,2,4,2,11,0,11,14
729296,2,4,2,1,0,1,6
729318,2,4,2,8,2,10,12
734012,2,4,2,15,1,16,24
734024,2,4,2,9,2,11,17
734044,2,4,2,2,0,2,12
734048,2,4,2,2,1,3,8
829714,2,4,2,9,1,10,21
829746,2,4,2,1,0,1,3
829758,2,4,2,4,0,4,8
829764,2,4,2,4,1,5,9
829780,2,4,2,7,0,7,16
829790,2,4,2,8,0,8,19
829804,2,4,2,15,1,16,17
980924,2,4,2,11,2,13,16
980946,2,4,2,9,0,9,10
980968,2,4,2,4,1,5,7
980982,2,4,2,6,1,7,12
980990,2,4,2,5,0,5,6
981004,2,4,2,8,0,8,19
1082594,2,4,2,11,2,13,19
1082598,2,4,2,8,0,8,14
1082605,2,4,2,4,0,4,6
1082609,2,4,2,9,0,9,15
1082623,2,4,2,15,0,15,25
1082626,2,4,2,6,1,7,15
335989,1,5,2,10,0,10,17
336005,1,5,2,6,0,6,11
336013,1,5,2,7,0,7,12
336028,1,5,2,4,4,8,18
336038,1,5,2,3,0,3,15
336043,1,5,2,7,0,7,8
392195,1,5,2,4,0,4,8
392215,1,5,2,5,0,5,21
392222,1,5,2,3,0,3,8
392230,1,5,2,7,0,7,14
392238,1,5,2,4,0,4,26
419116,1,5,2,1,0,1,15
419120,1,5,2,7,0,7,14
419123,1,5,2,6,2,8,14
419129,1,5,2,8,1,9,17
419134,1,5,2,8,2,10,23
419146,1,5,2,10,0,10,16
419159,1,5,2,6,1,7,13
419163,1,5,2,2,0,2,8
501214,1,5,2,4,2,6,12
501219,1,5,2,9,0,9,13
501245,1,5,2,6,0,6,15
501257,1,5,2,10,0,10,14
501263,1,5,2,2,1,3,8
548314,1,5,2,11,0,11,16
548317,1,5,2,3,0,3,4
548325,1,5,2,7,0,7,11
548329,1,5,2,9,0,9,11
548337,1,5,2,7,1,8,13
548354,1,5,2,10,1,11,16
548359,1,5,2,5,0,5,8
548366,1,5,2,0,5,5,10
548370,1,5,2,5,0,5,13
548378,1,5,2,2,0,2,8
548382,1,5,2,1,1,2,9
598006,1,5,2,6,0,6,11
598010,1,5,2,5,0,5,6
598014,1,5,2,7,0,7,14
598024,1,5,2,8,0,8,11
598028,1,5,2,5,0,5,10
598031,1,5,2,5,0,5,10
598048,1,5,2,3,0,3,8
598077,1,5,2,7,0,7,11
729296,1,5,2,7,0,7,13
729320,1,5,2,4,2,6,13
733984,1,5,2,8,1,9,14
734008,1,5,2,6,0,6,8
734016,1,5,2,8,4,12,19
734046,1,5,2,0,0,0,5
829714,1,5,2,4,0,4,8
829746,1,5,2,8,0,8,14
829754,1,5,2,1,0,1,9
829782,1,5,2,7,0,7,12
829816,1,5,2,10,4,14,23
335992,2,5,2,5,2,7,13
335995,2,5,2,7,2,9,14
335997,2,5,2,9,0,9,18
336010,2,5,2,6,0,6,6
336016,2,5,2,1,0,1,11
336020,2,5,2,6,0,6,7
336024,2,5,2,3,0,3,8
336032,2,5,2,10,0,10,16
336041,2,5,2,8,0,8,9
336045,2,5,2,12,0,12,14
392187,2,5,2,2,2,4,6
392200,2,5,2,1,2,3,9
392203,2,5,2,5,1,6,12
392207,2,5,2,2,0,2,9
392210,2,5,2,0,0,0,3
392218,2,5,2,2,0,2,4
392225,2,5,2,3,0,3,8
392235,2,5,2,5,1,6,8
419112,2,5,2,7,0,7,8
419131,2,5,2,6,0,6,14
419139,2,5,2,9,0,9,10
419142,2,5,2,1,0,1,15
419148,2,5,2,9,0,9,18
419155,2,5,2,8,0,8,9
501204,2,5,2,8,0,8,19
501209,2,5,2,1,4,5,13
501225,2,5,2,5,0,5,12
501230,2,5,2,8,0,8,16
501236,2,5,2,4,0,4,7
501240,2,5,2,9,0,9,19
501254,2,5,2,8,2,10,18
501268,2,5,2,12,0,12,20
548322,2,5,2,2,0,2,9
548331,2,5,2,12,0,12,17
548341,2,5,2,10,0,10,18
548350,2,5,2,8,0,8,14
548363,2,5,2,1,0,1,5
598019,2,5,2,12,1,13,19
598037,2,5,2,6,0,6,7
598041,2,5,2,13,0,13,21
598052,2,5,2,2,0,2,11
598054,2,5,2,5,2,7,7
598057,2,5,2,2,0,2,6
598063,2,5,2,1,0,1,3
598068,2,5,2,5,1,6,11
598070,2,5,2,11,0,11,14
598076,2,5,2,5,0,5,13
729290,2,5,2,6,0,6,10
729302,2,5,2,0,0,0,10
729310,2,5,2,2,0,2,13
733980,2,5,2,9,0,9,14
733994,2,5,2,9,0,9,11
734004,2,5,2,4,0,4,10
734022,2,5,2,12,1,13,17
734038,2,5,2,11,0,11,16
829720,2,5,2,8,0,8,10
829726,2,5,2,10,1,11,12
829732,2,5,2,4,1,5,11
829740,2,5,2,7,0,7,8
829774,2,5,2,9,0,9,18
829792,2,5,2,4,0,4,12
829802,2,5,2,2,0,2,6
829824,2,5,2,3,0,3,14
336000,1,6,2,1,2,3,11
336003,1,6,2,14,0,14,17
336014,1,6,2,10,2,12,19
336020,1,6,2,3,0,3,15
336025,1,6,2,5,0,5,12
336027,1,6,2,4,0,4,14
392194,1,6,2,6,0,6,8
392203,1,6,2,8,0,8,15
392228,1,6,2,11,1,12,17
392231,1,6,2,6,0,6,13
392235,1,6,2,8,0,8,12
392237,1,6,2,1,0,1,2
392242,1,6,2,13,0,13,13
419121,1,6,2,10,0,10,19
419133,1,6,2,16,0,16,29
419136,1,6,2,11,1,12,21
419139,1,6,2,4,0,4,15
419145,1,6,2,9,0,9,11
419154,1,6,2,13,2,15,19
501206,1,6,2,6,1,7,17
501209,1,6,2,1,1,2,7
501228,1,6,2,4,0,4,14
501232,1,6,2,10,0,10,16
501238,1,6,2,0,0,0,4
501243,1,6,2,6,0,6,15
501270,1,6,2,0,1,1,3
548347,1,6,2,7,0,7,8
548350,1,6,2,6,0,6,13
548362,1,6,2,17,0,17,17
548369,1,6,2,7,0,7,12
598003,1,6,2,6,2,8,17
598015,1,6,2,12,0,12,12
598022,1,6,2,14,1,15,16
598040,1,6,2,5,0,5,8
598049,1,6,2,0,0,0,4
598054,1,6,2,10,0,10,21
598064,1,6,2,4,0,4,10
729286,1,6,2,3,0,3,7
733980,1,6,2,7,0,7,16
733986,1,6,2,0,0,0,8
733990,1,6,2,6,0,6,14
733998,1,6,2,5,1,6,10
734024,1,6,2,5,0,5,11
734044,1,6,2,6,0,6,12
829720,1,6,2,5,0,5,13
829736,1,6,2,8,0,8,15
829744,1,6,2,1,1,2,5
829752,1,6,2,5,2,7,11
829762,1,6,2,6,2,8,10
829788,1,6,2,2,1,3,7
829818,1,6,2,4,1,5,8
980908,1,6,2,10,0,10,23
980938,1,6,2,1,0,1,11
980956,1,6,2,10,1,11,13
980970,1,6,2,9,0,9,11
981002,1,6,2,2,0,2,4
981016,1,6,2,3,0,3,13
1082599,1,6,2,10,1,11,13
1082605,1,6,2,9,0,9,17
1082608,1,6,2,9,0,9,19
1082622,1,6,2,11,1,12,17
1082626,1,6,2,0,1,1,2
1082642,1,6,2,6,0,6,9
335989,2,6,2,12,1,13,21
335993,2,6,2,14,0,14,18
336006,2,6,2,16,1,17,25
336009,2,6,2,2,0,2,4
336022,2,6,2,11,0,11,16
336031,2,6,2,8,5,13,23
336037,2,6,2,10,0,10,29
336043,2,6,2,4,1,5,13
392188,2,6,2,18,1,19,28
392199,2,6,2,3,1,4,13
392206,2,6,2,11,0,11,16
392211,2,6,2,5,1,6,11
392216,2,6,2,7,0,7,11
392220,2,6,2,3,0,3,11
392224,2,6,2,9,0,9,12
392240,2,6,2,11,0,11,19
419113,2,6,2,1,0,1,10
419116,2,6,2,10,2,12,24
419119,2,6,2,9,0,9,22
419125,2,6,2,20,0,20,29
419149,2,6,2,9,1,10,11
419157,2,6,2,5,1,6,14
419160,2,6,2,2,0,2,7
419165,2,6,2,9,0,9,14
501218,2,6,2,7,0,7,12
501221,2,6,2,17,0,17,18
501235,2,6,2,7,0,7,14
501248,2,6,2,2,1,3,8
501251,2,6,2,0,0,0,4
501258,2,6,2,12,1,13,17
501262,2,6,2,4,1,5,15
548312,2,6,2,10,1,11,16
548315,2,6,2,10,0,10,24
548321,2,6,2,7,0,7,19
548326,2,6,2,5,0,5,7
548330,2,6,2,3,3,6,14
548334,2,6,2,6,1,7,23
548338,2,6,2,7,0,7,12
548342,2,6,2,7,0,7,15
548354,2,6,2,13,0,13,14
548374,2,6,2,9,1,10,21
548377,2,6,2,7,0,7,18
548379,2,6,2,4,0,4,14
548383,2,6,2,9,4,13,24
548385,2,6,2,11,0,11,17
598006,2,6,2,5,0,5,10
598011,2,6,2,8,0,8,10
598025,2,6,2,3,1,4,13
598029,2,6,2,7,1,8,10
598033,2,6,2,4,0,4,5
598045,2,6,2,9,0,9,12
598059,2,6,2,9,0,9,16
598067,2,6,2,6,0,6,12
598072,2,6,2,5,0,5,17
729294,2,6,2,6,2,8,18
729298,2,6,2,2,0,2,8
729306,2,6,2,7,1,8,12
729314,2,6,2,6,0,6,12
734010,2,6,2,3,0,3,10
734016,2,6,2,13,0,13,19
734036,2,6,2,14,0,14,22
829712,2,6,2,9,0,9,13
829730,2,6,2,8,0,8,15
829766,2,6,2,7,0,7,11
829772,2,6,2,18,1,19,21
829782,2,6,2,8,0,8,14
829798,2,6,2,8,0,8,13
829806,2,6,2,9,0,9,14
980918,2,6,2,3,0,3,9
980926,2,6,2,13,0,13,24
980950,2,6,2,0,0,0,2
980966,2,6,2,14,0,14,24
980976,2,6,2,7,0,7,10
980988,2,6,2,8,0,8,13
980998,2,6,2,3,0,3,13
981008,2,6,2,2,0,2,10
1082595,2,6,2,4,0,4,13
1082611,2,6,2,13,0,13,15
1082614,2,6,2,5,0,5,14
1082630,2,6,2,13,0,13,16
1082632,2,6,2,3,1,4,15
1082635,2,6,2,1,1,2,6
1082640,2,6,2,8,0,8,15
1082646,2,6,2,7,4,11,13
335990,1,7,2,1,4,5,13
335999,1,7,2,8,0,8,14
336009,1,7,2,9,0,9,14
336029,1,7,2,19,0,19,30
336037,1,7,2,10,1,11,16
336041,1,7,2,3,1,4,6
392186,1,7,2,6,1,7,10
392202,1,7,2,11,1,12,16
392208,1,7,2,6,0,6,15
392213,1,7,2,9,3,12,12
392220,1,7,2,5,3,8,9
392223,1,7,2,2,1,3,8
392232,1,7,2,6,0,6,7
392240,1,7,2,8,0,8,13
419112,1,7,2,11,2,13,26
419119,1,7,2,10,0,10,22
419124,1,7,2,4,2,6,11
419135,1,7,2,9,0,9,14
419143,1,7,2,6,0,6,18
419151,1,7,2,1,0,1,8
419155,1,7,2,1,0,1,12
419157,1,7,2,8,0,8,16
419162,1,7,2,9,0,9,13
419166,1,7,2,4,0,4,7
419167,1,7,2,8,1,9,11
501215,1,7,2,6,6,12,19
501226,1,7,2,4,5,9,9
501229,1,7,2,9,0,9,15
501236,1,7,2,3,1,4,11
501242,1,7,2,8,2,10,13
501246,1,7,2,9,0,9,14
501251,1,7,2,5,0,5,15
501268,1,7,2,4,1,5,7
548322,1,7,2,3,0,3,5
548330,1,7,2,1,0,1,3
548339,1,7,2,3,0,3,3
548356,1,7,2,0,0,0,4
548365,1,7,2,0,1,1,2
548368,1,7,2,12,0,12,13
598007,1,7,2,7,0,7,11
598011,1,7,2,6,0,6,6
598016,1,7,2,8,0,8,11
598029,1,7,2,4,0,4,6
598038,1,7,2,3,2,5,12
598042,1,7,2,8,0,8,10
598044,1,7,2,4,0,4,10
598051,1,7,2,0,1,1,5
598055,1,7,2,10,1,11,11
598068,1,7,2,8,0,8,10
598078,1,7,2,1,2,3,11
729292,1,7,2,2,0,2,10
729308,1,7,2,9,0,9,11
729314,1,7,2,6,1,7,14
733988,1,7,2,12,0,12,19
734000,1,7,2,4,0,4,8
734014,1,7,2,9,0,9,12
734022,1,7,2,4,0,4,8
734036,1,7,2,7,0,7,13
734050,1,7,2,6,1,7,13
829710,1,7,2,5,0,5,9
829726,1,7,2,11,0,11,17
829734,1,7,2,0,0,0,2
829742,1,7,2,5,6,11,13
829756,1,7,2,5,3,8,19
829774,1,7,2,11,2,13,18
829780,1,7,2,6,1,7,16
829810,1,7,2,4,0,4,10
829822,1,7,2,4,2,6,11
829828,1,7,2,16,0,16,17
980906,1,7,2,0,4,4,12
980922,1,7,2,6,0,6,9
980928,1,7,2,8,0,8,10
980946,1,7,2,9,0,9,11
980990,1,7,2,1,1,2,7
980998,1,7,2,3,0,3,14
981012,1,7,2,11,0,11,19
1082592,1,7,2,8,0,8,19
1082614,1,7,2,11,1,12,20
1082635,1,7,2,5,2,7,10
1082638,1,7,2,1,0,1,4
1082644,1,7,2,8,2,10,12
1082650,1,7,2,4,0,4,7
335994,2,7,2,0,4,4,13
335996,2,7,2,11,1,12,14
336002,2,7,2,10,0,10,16
336013,2,7,2,3,1,4,6
336017,2,7,2,0,1,1,10
336023,2,7,2,10,2,12,19
336026,2,7,2,13,2,15,21
336033,2,7,2,21,3,24,34
392197,2,7,2,1,0,1,4
392202,2,7,2,1,2,3,8
392205,2,7,2,1,1,2,5
392217,2,7,2,1,0,1,7
392227,2,7,2,0,0,0,5
392230,2,7,2,1,0,1,9
419119,2,7,2,2,1,3,25
419127,2,7,2,12,0,12,24
419130,2,7,2,8,5,13,19
419137,2,7,2,0,1,1,11
419147,2,7,2,9,0,9,16
419170,2,7,2,3,0,3,3
501206,2,7,2,4,1,5,6
501210,2,7,2,4,0,4,11
501223,2,7,2,1,4,5,11
501256,2,7,2,7,0,7,19
501261,2,7,2,4,0,4,9
501272,2,7,2,1,0,1,14
501274,2,7,2,7,0,7,21
501275,2,7,2,10,0,10,20
548311,2,7,2,9,1,10,11
548313,2,7,2,1,2,3,5
548319,2,7,2,6,0,6,8
548344,2,7,2,8,0,8,12
548347,2,7,2,8,0,8,18
548351,2,7,2,5,1,6,7
548360,2,7,2,8,0,8,8
548372,2,7,2,4,1,5,7
548375,2,7,2,1,1,2,7
548382,2,7,2,4,0,4,12
548384,2,7,2,12,2,14,20
598004,2,7,2,2,0,2,4
598024,2,7,2,2,0,2,6
598034,2,7,2,1,0,1,6
598060,2,7,2,1,3,4,8
598065,2,7,2,7,1,8,13
598071,2,7,2,11,0,11,13
598075,2,7,2,2,0,2,12
598077,2,7,2,11,1,12,18
729284,2,7,2,1,0,1,9
729322,2,7,2,1,1,2,8
733978,2,7,2,11,0,11,17
734006,2,7,2,1,0,1,3
734030,2,7,2,2,5,7,20
734046,2,7,2,7,0,7,19
829722,2,7,2,7,0,7,10
829752,2,7,2,4,0,4,11
829788,2,7,2,0,0,0,8
829794,2,7,2,7,0,7,10
829800,2,7,2,2,0,2,11
829820,2,7,2,2,1,3,8
980914,2,7,2,9,1,10,18
980932,2,7,2,2,0,2,8
980938,2,7,2,5,0,5,13
980952,2,7,2,7,1,8,16
980962,2,7,2,4,0,4,8
980978,2,7,2,4,0,4,9
980986,2,7,2,2,0,2,4
1082597,2,7,2,2,4,6,15
1082600,2,7,2,15,0,15,21
1082602,2,7,2,3,0,3,7
1082606,2,7,2,7,1,8,14
1082612,2,7,2,9,2,11,21
1082618,2,7,2,11,0,11,14
1082625,2,7,2,11,0,11,24
1082628,2,7,2,9,0,9,15
1082641,2,7,2,13,0,13,23
1082647,2,7,2,8,0,8,9
1082649,2,7,2,2,1,3,14
335991,1,8,2,2,3,5,14
335993,1,8,2,8,0,8,9
335995,1,8,2,10,0,10,22
336004,1,8,2,10,0,10,16
336007,1,8,2,8,1,9,17
336016,1,8,2,3,2,5,13
336036,1,8,2,7,1,8,13
336042,1,8,2,5,1,6,7
392193,1,8,2,15,0,15,27
392197,1,8,2,9,0,9,15
392206,1,8,2,10,1,11,19
392210,1,8,2,10,0,10,18
392217,1,8,2,0,1,1,8
392221,1,8,2,9,0,9,16
392225,1,8,2,3,0,3,11
392244,1,8,2,8,3,11,13
419115,1,8,2,18,1,19,27
419122,1,8,2,23,1,24,28
419125,1,8,2,14,0,14,18
419131,1,8,2,14,2,16,18
419156,1,8,2,7,2,9,10
419165,1,8,2,8,0,8,15
419169,1,8,2,3,1,4,8
501204,1,8,2,10,0,10,20
501213,1,8,2,9,2,11,14
501217,1,8,2,4,0,4,13
501221,1,8,2,1,0,1,14
501234,1,8,2,1,0,1,4
501248,1,8,2,4,0,4,14
501255,1,8,2,8,0,8,12
501261,1,8,2,1,0,1,2
501269,1,8,2,5,6,11,15
548319,1,8,2,5,0,5,7
548326,1,8,2,7,0,7,9
548331,1,8,2,6,1,7,16
548334,1,8,2,8,0,8,16
548340,1,8,2,2,0,2,8
548346,1,8,2,3,1,4,20
548351,1,8,2,9,0,9,12
548353,1,8,2,0,0,0,4
548361,1,8,2,10,1,11,22
548371,1,8,2,13,2,15,20
548381,1,8,2,4,0,4,10
335999,2,8,2,10,0,10,20
336012,2,8,2,1,0,1,4
336019,2,8,2,6,0,6,11
336025,2,8,2,10,1,11,21
336029,2,8,2,6,1,7,12
336039,2,8,2,4,0,4,11
392189,2,8,2,5,0,5,14
392201,2,8,2,19,1,20,31
392214,2,8,2,0,1,1,1
392228,2,8,2,11,1,12,30
392233,2,8,2,15,0,15,20
392234,2,8,2,18,0,18,23
392241,2,8,2,8,0,8,12
392242,2,8,2,2,1,3,24
419111,2,8,2,10,1,11,16
419135,2,8,2,6,4,10,20
419140,2,8,2,8,1,9,23
419143,2,8,2,4,0,4,13
419146,2,8,2,16,4,20,22
419150,2,8,2,6,0,6,11
419152,2,8,2,5,1,6,9
419161,2,8,2,8,0,8,17
419168,2,8,2,0,1,1,2
501208,2,8,2,6,1,7,8
501229,2,8,2,10,0,10,15
501241,2,8,2,12,0,12,18
501244,2,8,2,9,0,9,10
501264,2,8,2,7,1,8,12
548316,2,8,2,11,1,12,16
548357,2,8,2,5,0,5,9
548364,2,8,2,2,0,2,10
548378,2,8,2,6,0,6,17
501205,1,9,2,16,0,16,23
501212,1,9,2,1,0,1,10
501224,1,9,2,4,1,5,11
501230,1,9,2,1,1,2,11
501247,1,9,2,6,1,7,7
501252,1,9,2,5,0,5,12
501259,1,9,2,5,1,6,21
501215,2,9,2,1,2,3,8
501220,2,9,2,2,1,3,10
501234,2,9,2,0,2,2,2
501238,2,9,2,7,0,7,10
501243,2,9,2,13,0,13,26
501263,2,9,2,18,1,19,38
501266,2,9,2,5,2,7,10
501218,1,10,2,5,0,5,19
501223,1,10,2,5,2,7,10
501233,1,10,2,6,0,6,8
501240,1,10,2,10,0,10,16
501264,1,10,2,4,0,4,18
501267,1,10,2,1,0,1,10
548313,1,10,2,2,0,2,2
548318,1,10,2,5,0,5,15
548324,1,10,2,3,0,3,8
548332,1,10,2,13,0,13,18
548338,1,10,2,3,0,3,3
548342,1,10,2,1,0,1,2
548363,1,10,2,1,0,1,7
598008,1,10,2,1,0,1,2
598020,1,10,2,6,0,6,19
598030,1,10,2,11,0,11,20
598052,1,10,2,6,1,7,16
598060,1,10,2,11,0,11,12
598066,1,10,2,10,0,10,16
598072,1,10,2,5,0,5,16
501207,2,10,2,4,0,4,6
501212,2,10,2,7,3,10,20
501231,2,10,2,8,1,9,12
501237,2,10,2,6,2,8,13
501246,2,10,2,6,0,6,6
501253,2,10,2,8,2,10,10
501255,2,10,2,9,0,9,24
548327,2,10,2,10,0,10,16
548335,2,10,2,6,0,6,15
548346,2,10,2,8,0,8,11
548353,2,10,2,8,0,8,11
548356,2,10,2,7,0,7,13
548358,2,10,2,6,2,8,18
548367,2,10,2,6,0,6,10
548370,2,10,2,7,1,8,11
548380,2,10,2,2,0,2,11
598005,2,10,2,1,0,1,3
598014,2,10,2,7,0,7,13
598016,2,10,2,7,1,8,13
598023,2,10,2,12,0,12,19
598032,2,10,2,2,0,2,11
598040,2,10,2,10,0,10,10
598043,2,10,2,11,1,12,21
598047,2,10,2,7,1,8,12
598058,2,10,2,9,1,10,19
598005,1,11,2,6,0,6,10
598023,1,11,2,2,1,3,5
598035,1,11,2,4,2,6,12
598037,1,11,2,5,0,5,7
598053,1,11,2,5,0,5,12
598061,1,11,2,11,0,11,15
598065,1,11,2,11,1,12,31
598070,1,11,2,0,1,1,4
598076,1,11,2,1,0,1,3
729290,1,11,2,1,1,2,4
729306,1,11,2,6,3,9,15
729316,1,11,2,7,0,7,15
729322,1,11,2,4,1,5,15
733982,1,11,2,12,0,12,15
733994,1,11,2,10,0,10,19
734006,1,11,2,1,0,1,5
734012,1,11,2,3,1,4,10
734020,1,11,2,6,0,6,14
734042,1,11,2,1,4,5,14
829732,1,11,2,12,0,12,13
829748,1,11,2,8,0,8,11
829764,1,11,2,10,0,10,10
829778,1,11,2,3,0,3,13
829792,1,11,2,1,4,5,18
829798,1,11,2,7,0,7,15
829804,1,11,2,14,0,14,19
829812,1,11,2,9,0,9,15
829820,1,11,2,0,1,1,8
980920,1,11,2,5,0,5,14
980948,1,11,2,3,0,3,7
980958,1,11,2,8,0,8,14
980978,1,11,2,7,0,7,14
980984,1,11,2,8,1,9,11
980988,1,11,2,3,0,3,9
981008,1,11,2,9,0,9,10
981020,1,11,2,8,0,8,12
981024,1,11,2,3,2,5,12
1082591,1,11,2,15,1,16,23
1082600,1,11,2,2,1,3,5
1082609,1,11,2,3,3,6,9
1082611,1,11,2,2,0,2,12
1082615,1,11,2,1,4,5,12
1082623,1,11,2,10,0,10,13
1082627,1,11,2,12,0,12,18
1082630,1,11,2,11,0,11,15
1082648,1,11,2,6,0,6,13
598009,2,11,2,6,2,8,12
598015,2,11,2,0,0,0,2
598018,2,11,2,4,0,4,11
598026,2,11,2,8,0,8,8
598044,2,11,2,10,0,10,16
598049,2,11,2,11,0,11,17
598056,2,11,2,7,0,7,11
598074,2,11,2,10,0,10,13
729300,2,11,2,5,0,5,16
733998,2,11,2,3,4,7,17
734026,2,11,2,9,1,10,16
734034,2,11,2,12,0,12,22
829716,2,11,2,5,0,5,15
829724,2,11,2,19,1,20,36
829736,2,11,2,4,3,7,10
829756,2,11,2,5,0,5,14
829786,2,11,2,9,0,9,15
980912,2,11,2,10,0,10,22
980928,2,11,2,10,0,10,14
980934,2,11,2,7,6,13,23
980940,2,11,2,6,0,6,12
980972,2,11,2,15,1,16,23
980996,2,11,2,7,1,8,16
981014,2,11,2,7,0,7,11
981022,2,11,2,5,0,5,11
1082596,2,11,2,8,0,8,11
1082604,2,11,2,5,0,5,10
1082634,2,11,2,3,0,3,14
1082638,2,11,2,3,0,3,10
1082643,2,11,2,13,0,13,20
980916,1,12,2,11,0,11,16
980924,1,12,2,6,0,6,10
980944,1,12,2,4,0,4,6
980954,1,12,2,7,1,8,13
980962,1,12,2,1,0,1,8
980974,1,12,2,13,0,13,22
980994,1,12,2,6,1,7,11
1082594,1,12,2,2,0,2,3
1082603,1,12,2,9,0,9,15
1082607,1,12,2,8,0,8,11
1082618,1,12,2,9,0,9,18
1082620,1,12,2,8,0,8,14
1082624,1,12,2,5,0,5,9
1082634,1,12,2,3,0,3,6
1082647,1,12,2,3,0,3,9
980906,2,12,2,5,0,5,13
980936,2,12,2,1,0,1,12
980948,2,12,2,4,1,5,5
980970,2,12,2,7,0,7,13
980984,2,12,2,4,0,4,5
981002,2,12,2,11,1,12,16
981010,2,12,2,13,1,14,20
1082592,2,12,2,14,1,15,23
1082599,2,12,2,6,1,7,17
1082615,2,12,2,3,1,4,5
1082629,2,12,2,2,1,3,11
1082631,2,12,2,4,0,4,11
1082642,2,12,2,8,0,8,18
1082645,2,12,2,6,0,6,9
1082650,2,12,2,4,4,8,14
980934,1,13,2,9,0,9,14
980950,1,13,2,10,0,10,28
980966,1,13,2,8,1,9,14
980972,1,13,2,0,0,0,0
981018,1,13,2,5,0,5,7
981022,1,13,2,8,1,9,16
1082593,1,13,2,7,1,8,16
1082596,1,13,2,10,0,10,13
1082606,1,13,2,11,1,12,15
1082625,1,13,2,12,2,14,21
1082629,1,13,2,1,0,1,12
1082632,1,13,2,3,0,3,13
1082640,1,13,2,5,3,8,15
1082643,1,13,2,9,0,9,20
980910,2,13,2,11,0,11,12
980916,2,13,2,5,1,6,13
980922,2,13,2,3,1,4,15
980942,2,13,2,12,0,12,15
980954,2,13,2,3,0,3,9
980960,2,13,2,3,0,3,14
980980,2,13,2,9,0,9,10
980992,2,13,2,2,0,2,9
981006,2,13,2,3,5,8,20
981012,2,13,2,6,2,8,8
1082603,2,13,2,11,0,11,27
1082610,2,13,2,3,0,3,4
1082613,2,13,2,16,0,16,25
1082616,2,13,2,8,0,8,14
1082621,2,13,2,5,0,5,13
1082637,2,13,2,10,0,10,17
335987,1,1,3,5,1,6,27
335998,1,1,3,8,0,8,32
336002,1,1,3,7,0,7,22
336015,1,1,3,9,1,10,19
336019,1,1,3,11,0,11,19
336022,1,1,3,6,0,6,17
336026,1,1,3,3,1,4,16
336030,1,1,3,4,2,6,16
336032,1,1,3,4,1,5,12
392189,1,1,3,0,0,0,2
392204,1,1,3,5,5,10,23
392212,1,1,3,2,0,2,9
392216,1,1,3,21,0,21,33
392224,1,1,3,5,1,6,15
392226,1,1,3,2,0,2,15
392233,1,1,3,5,0,5,15
419111,1,1,3,4,4,8,14
419127,1,1,3,12,2,14,25
419132,1,1,3,0,1,1,28
419140,1,1,3,9,0,9,24
419144,1,1,3,8,0,8,25
419149,1,1,3,10,0,10,32
419153,1,1,3,8,1,9,21
419158,1,1,3,6,0,6,17
501208,1,1,3,2,0,2,19
501227,1,1,3,1,0,1,34
501235,1,1,3,2,0,2,15
501244,1,1,3,6,0,6,22
501260,1,1,3,5,0,5,20
501272,1,1,3,5,2,7,16
501274,1,1,3,5,0,5,14
548312,1,1,3,5,4,9,24
548320,1,1,3,8,0,8,20
548349,1,1,3,9,1,10,23
548358,1,1,3,6,0,6,22
548373,1,1,3,8,0,8,21
548375,1,1,3,1,0,1,12
548380,1,1,3,2,0,2,15
548383,1,1,3,5,1,6,20
598013,1,1,3,7,0,7,20
598018,1,1,3,6,0,6,24
598027,1,1,3,6,1,7,27
598034,1,1,3,10,0,10,46
598045,1,1,3,1,1,2,17
598058,1,1,3,11,0,11,28
598074,1,1,3,2,5,7,17
729284,1,1,3,5,0,5,10
729294,1,1,3,3,2,5,16
729304,1,1,3,5,0,5,22
734032,1,1,3,7,0,7,22
734048,1,1,3,7,2,9,14
829718,1,1,3,9,0,9,28
829766,1,1,3,9,0,9,21
829776,1,1,3,5,2,7,27
829786,1,1,3,10,0,10,25
980914,1,1,3,11,2,13,19
980952,1,1,3,17,0,17,32
980968,1,1,3,9,0,9,21
980980,1,1,3,2,0,2,17
981000,1,1,3,4,0,4,18
981006,1,1,3,7,2,9,23
981014,1,1,3,6,0,6,28
1082597,1,1,3,13,2,15,34
1082604,1,1,3,5,0,5,14
1082613,1,1,3,15,0,15,44
1082617,1,1,3,14,0,14,39
1082631,1,1,3,6,0,6,14
1082649,1,1,3,7,1,8,13
335991,2,1,3,1,1,2,18
336005,2,1,3,8,1,9,31
336008,2,1,3,7,0,7,23
336040,2,1,3,9,0,9,24
392191,2,1,3,7,0,7,16
392195,2,1,3,2,0,2,10
392202,2,1,3,7,0,7,15
392208,2,1,3,8,1,9,13
392236,2,1,3,15,1,16,27
392238,2,1,3,3,0,3,13
419114,2,1,3,7,0,7,19
419118,2,1,3,5,2,7,17
419123,2,1,3,7,0,7,18
419136,2,1,3,4,0,4,19
419163,2,1,3,4,1,5,26
419166,2,1,3,4,2,6,18
501203,2,1,3,6,5,11,25
501214,2,1,3,11,0,11,23
501219,2,1,3,2,1,3,12
501224,2,1,3,8,0,8,22
501239,2,1,3,9,0,9,19
501247,2,1,3,13,0,13,28
501250,2,1,3,7,0,7,21
501267,2,1,3,14,1,15,32
548317,2,1,3,1,1,2,10
548325,2,1,3,5,0,5,18
548328,2,1,3,9,0,9,22
548333,2,1,3,0,0,0,18
548340,2,1,3,7,1,8,17
548352,2,1,3,0,1,1,15
548362,2,1,3,6,1,7,21
548368,2,1,3,8,0,8,12
548386,2,1,3,5,2,7,16
598003,2,1,3,15,0,15,20
598010,2,1,3,4,1,5,23
598021,2,1,3,10,0,10,16
598036,2,1,3,2,0,2,16
598039,2,1,3,8,0,8,32
598048,2,1,3,10,0,10,25
598055,2,1,3,10,0,10,22
598062,2,1,3,5,1,6,10
598066,2,1,3,2,3,5,24
729312,2,1,3,2,0,2,13
729320,2,1,3,5,3,8,20
733976,2,1,3,4,0,4,20
733984,2,1,3,10,0,10,23
733990,2,1,3,12,0,12,27
734002,2,1,3,12,0,12,22
734014,2,1,3,8,0,8,21
734020,2,1,3,4,0,4,12
734028,2,1,3,13,0,13,34
734042,2,1,3,13,0,13,20
734054,2,1,3,10,2,12,31
829710,2,1,3,8,0,8,13
829728,2,1,3,8,0,8,21
829738,2,1,3,5,0,5,21
829744,2,1,3,10,1,11,24
829748,2,1,3,8,0,8,24
829770,2,1,3,12,1,13,28
829796,2,1,3,10,0,10,25
829810,2,1,3,8,0,8,20
829816,2,1,3,6,1,7,21
980908,2,1,3,9,0,9,29
980920,2,1,3,6,0,6,19
980930,2,1,3,13,0,13,33
980944,2,1,3,10,0,10,31
980956,2,1,3,8,0,8,21
980964,2,1,3,11,0,11,22
980994,2,1,3,21,1,22,44
981020,2,1,3,8,0,8,23
1082593,2,1,3,15,2,17,37
1082601,2,1,3,16,0,16,31
1082608,2,1,3,1,1,2,21
1082620,2,1,3,2,1,3,21
1082622,2,1,3,8,0,8,26
1082627,2,1,3,4,0,4,16
1082636,2,1,3,14,0,14,34
1082639,2,1,3,6,0,6,31
1082644,2,1,3,17,2,19,30
1082648,2,1,3,4,2,6,27
335997,1,2,3,1,0,1,17
336011,1,2,3,3,1,4,11
336017,1,2,3,7,0,7,18
336021,1,2,3,10,0,10,14
336031,1,2,3,2,0,2,22
336034,1,2,3,4,0,4,11
336039,1,2,3,9,0,9,22
392187,1,2,3,3,0,3,12
392196,1,2,3,18,0,18,32
392199,1,2,3,3,0,3,13
392209,1,2,3,7,0,7,15
392218,1,2,3,2,1,3,13
392241,1,2,3,8,0,8,15
419114,1,2,3,4,0,4,15
419128,1,2,3,9,0,9,17
419138,1,2,3,5,1,6,17
419150,1,2,3,1,0,1,18
501210,1,2,3,10,0,10,14
501237,1,2,3,20,0,20,28
501249,1,2,3,5,0,5,17
501273,1,2,3,12,0,12,24
501275,1,2,3,10,0,10,46
548315,1,2,3,19,0,19,30
548323,1,2,3,11,0,11,26
548341,1,2,3,8,0,8,23
548355,1,2,3,2,0,2,10
548367,1,2,3,14,0,14,25
548372,1,2,3,4,0,4,11
548377,1,2,3,8,0,8,19
598004,1,2,3,6,1,7,9
598009,1,2,3,5,1,6,19
598017,1,2,3,5,0,5,11
598032,1,2,3,4,0,4,28
598041,1,2,3,16,1,17,39
598047,1,2,3,5,1,6,15
598050,1,2,3,3,0,3,15
598059,1,2,3,9,1,10,16
598062,1,2,3,6,0,6,11
598069,1,2,3,6,1,7,18
598073,1,2,3,15,1,16,33
729310,1,2,3,6,0,6,11
729318,1,2,3,1,0,1,26
734004,1,2,3,1,0,1,6
734010,1,2,3,13,0,13,22
734026,1,2,3,7,0,7,14
734040,1,2,3,10,0,10,16
829724,1,2,3,1,2,3,23
829768,1,2,3,5,1,6,25
829790,1,2,3,23,1,24,45
829800,1,2,3,6,0,6,20
829824,1,2,3,10,4,14,24
829826,1,2,3,10,0,10,21
980912,1,2,3,4,0,4,12
980926,1,2,3,6,0,6,19
980932,1,2,3,9,0,9,15
980936,1,2,3,11,0,11,22
980942,1,2,3,10,0,10,19
980964,1,2,3,3,1,4,15
980982,1,2,3,10,1,11,24
980986,1,2,3,1,0,1,12
980992,1,2,3,7,0,7,10
981004,1,2,3,6,0,6,17
1082595,1,2,3,6,1,7,26
1082598,1,2,3,11,0,11,18
1082602,1,2,3,17,0,17,24
1082610,1,2,3,12,0,12,25
1082621,1,2,3,5,2,7,17
1082628,1,2,3,5,0,5,21
1082636,1,2,3,8,0,8,20
1082646,1,2,3,2,0,2,19
335987,2,2,3,2,1,3,12
335990,2,2,3,11,0,11,22
336001,2,2,3,1,0,1,13
336003,2,2,3,10,0,10,27
336007,2,2,3,8,0,8,24
336015,2,2,3,7,1,8,17
336028,2,2,3,0,2,2,6
392190,2,2,3,9,2,11,25
392193,2,2,3,2,0,2,15
392204,2,2,3,7,0,7,17
392213,2,2,3,2,1,3,24
392223,2,2,3,6,1,7,22
392226,2,2,3,9,1,10,17
392229,2,2,3,1,0,1,18
392237,2,2,3,4,0,4,10
392243,2,2,3,7,0,7,24
392244,2,2,3,9,2,11,16
419117,2,2,3,10,0,10,20
419120,2,2,3,3,0,3,35
419124,2,2,3,9,1,10,16
419133,2,2,3,7,2,9,22
419141,2,2,3,9,0,9,19
419145,2,2,3,7,0,7,25
419153,2,2,3,4,0,4,11
419156,2,2,3,4,0,4,18
419159,2,2,3,9,0,9,16
419162,2,2,3,7,0,7,12
419167,2,2,3,5,0,5,24
419169,2,2,3,1,0,1,15
501205,2,2,3,9,2,11,22
501213,2,2,3,7,1,8,16
501216,2,2,3,7,0,7,25
501227,2,2,3,4,0,4,17
501232,2,2,3,1,6,7,33
501252,2,2,3,36,1,37,66
501257,2,2,3,11,1,12,32
501260,2,2,3,7,0,7,46
501265,2,2,3,1,0,1,6
501271,2,2,3,5,0,5,13
501276,2,2,3,3,0,3,18
548320,2,2,3,1,0,1,8
548329,2,2,3,17,0,17,28
548332,2,2,3,9,4,13,17
548336,2,2,3,8,1,9,17
548349,2,2,3,13,0,13,22
548361,2,2,3,8,0,8,26
548365,2,2,3,1,0,1,8
548381,2,2,3,3,0,3,30
598013,2,2,3,7,1,8,19
598022,2,2,3,10,0,10,20
598028,2,2,3,6,2,8,21
598038,2,2,3,8,4,12,22
598053,2,2,3,6,0,6,22
729286,2,2,3,7,0,7,17
729292,2,2,3,5,0,5,16
729304,2,2,3,10,0,10,20
733982,2,2,3,8,0,8,14
733988,2,2,3,25,3,28,43
733996,2,2,3,1,0,1,9
734018,2,2,3,4,0,4,14
734032,2,2,3,2,0,2,9
829718,2,2,3,13,0,13,18
829742,2,2,3,8,0,8,12
829750,2,2,3,19,0,19,31
829754,2,2,3,15,0,15,28
829762,2,2,3,6,0,6,24
829776,2,2,3,14,0,14,36
829784,2,2,3,8,0,8,18
829808,2,2,3,16,1,17,33
829812,2,2,3,2,1,3,44
980958,2,2,3,7,0,7,29
980974,2,2,3,3,0,3,10
981000,2,2,3,17,0,17,32
981016,2,2,3,3,0,3,19
981018,2,2,3,7,1,8,25
981024,2,2,3,6,2,8,26
1082591,2,2,3,16,0,16,28
1082607,2,2,3,7,0,7,25
1082617,2,2,3,13,2,15,22
1082624,2,2,3,14,0,14,25
1082633,2,2,3,1,0,1,23
335988,1,3,3,6,1,7,27
335994,1,3,3,14,4,18,34
336001,1,3,3,5,2,7,18
336006,1,3,3,2,0,2,13
336010,1,3,3,1,1,2,12
336012,1,3,3,4,0,4,14
336018,1,3,3,1,1,2,22
336023,1,3,3,5,0,5,18
336045,1,3,3,4,0,4,16
392190,1,3,3,13,0,13,28
392201,1,3,3,10,0,10,28
392207,1,3,3,12,0,12,17
392211,1,3,3,3,0,3,19
392214,1,3,3,6,0,6,21
392219,1,3,3,16,0,16,29
392229,1,3,3,12,0,12,32
392236,1,3,3,10,0,10,27
392239,1,3,3,7,0,7,24
392243,1,3,3,11,0,11,26
419118,1,3,3,6,0,6,16
419130,1,3,3,7,2,9,31
419142,1,3,3,8,0,8,31
419147,1,3,3,6,6,12,24
419152,1,3,3,4,0,4,21
419160,1,3,3,5,0,5,18
419168,1,3,3,13,0,13,25
419170,1,3,3,7,0,7,13
501203,1,3,3,7,0,7,18
501211,1,3,3,2,2,4,6
501216,1,3,3,7,0,7,13
501220,1,3,3,1,1,2,11
501231,1,3,3,10,0,10,20
501241,1,3,3,7,0,7,13
501250,1,3,3,2,0,2,7
501254,1,3,3,10,0,10,25
501258,1,3,3,8,0,8,25
501266,1,3,3,14,0,14,19
501271,1,3,3,4,1,5,12
501276,1,3,3,10,0,10,26
548311,1,3,3,5,1,6,15
548316,1,3,3,6,0,6,15
548321,1,3,3,13,1,14,26
548327,1,3,3,5,0,5,13
548335,1,3,3,1,0,1,9
548352,1,3,3,9,1,10,15
548357,1,3,3,5,1,6,17
548360,1,3,3,3,0,3,18
548376,1,3,3,6,0,6,17
548384,1,3,3,0,0,0,4
548385,1,3,3,6,0,6,25
548386,1,3,3,10,1,11,17
598025,1,3,3,3,1,4,15
598039,1,3,3,14,0,14,25
598043,1,3,3,1,0,1,7
598046,1,3,3,12,0,12,22
598056,1,3,3,2,0,2,13
598063,1,3,3,9,0,9,16
598067,1,3,3,2,0,2,11
598075,1,3,3,9,0,9,27
729288,1,3,3,13,1,14,33
729298,1,3,3,9,0,9,23
729302,1,3,3,10,0,10,18
733976,1,3,3,6,0,6,20
734018,1,3,3,13,0,13,21
734028,1,3,3,5,1,6,11
734034,1,3,3,8,0,8,32
829712,1,3,3,6,4,10,36
829716,1,3,3,6,7,13,24
829728,1,3,3,16,0,16,39
829740,1,3,3,6,0,6,17
829750,1,3,3,1,0,1,17
829758,1,3,3,22,0,22,36
829770,1,3,3,11,1,12,23
829784,1,3,3,11,0,11,17
829794,1,3,3,15,0,15,23
829802,1,3,3,4,0,4,15
829806,1,3,3,5,0,5,6
335998,2,3,3,5,5,10,18
336014,2,3,3,3,1,4,28
336030,2,3,3,9,0,9,27
336034,2,3,3,14,6,20,27
336038,2,3,3,19,0,19,34
336042,2,3,3,4,0,4,22
336044,2,3,3,1,1,2,16
392186,2,3,3,2,0,2,18
392194,2,3,3,9,0,9,30
392207,2,3,3,1,0,1,10
392222,2,3,3,8,1,9,19
392232,2,3,3,0,1,1,18
419115,2,3,3,10,0,10,22
419121,2,3,3,2,0,2,23
419126,2,3,3,6,0,6,14
419128,2,3,3,7,1,8,18
419134,2,3,3,3,0,3,18
419138,2,3,3,24,0,24,38
419158,2,3,3,7,5,12,34
419164,2,3,3,5,0,5,13
501226,2,3,3,10,2,12,22
501233,2,3,3,8,1,9,11
501245,2,3,3,8,0,8,16
501273,2,3,3,0,1,1,13
548323,2,3,3,7,0,7,14
548337,2,3,3,9,0,9,23
548348,2,3,3,12,0,12,20
548366,2,3,3,1,4,5,15
548369,2,3,3,5,0,5,15
548373,2,3,3,14,0,14,30
598007,2,3,3,4,0,4,14
598012,2,3,3,5,0,5,14
598017,2,3,3,2,0,2,6
598020,2,3,3,2,1,3,10
598027,2,3,3,4,1,5,17
598031,2,3,3,9,0,9,24
598035,2,3,3,9,1,10,27
598051,2,3,3,1,0,1,10
598073,2,3,3,7,1,8,19
598078,2,3,3,5,2,7,12
729308,2,3,3,13,0,13,15
729316,2,3,3,7,1,8,20
733986,2,3,3,8,0,8,23
733992,2,3,3,5,0,5,13
734000,2,3,3,2,0,2,16
734008,2,3,3,8,0,8,28
734040,2,3,3,15,0,15,35
734050,2,3,3,4,0,4,20
734052,2,3,3,8,1,9,36
829734,2,3,3,11,0,11,29
829778,2,3,3,8,0,8,22
829814,2,3,3,7,0,7,17
829822,2,3,3,4,0,4,23
829826,2,3,3,11,0,11,21
829828,2,3,3,2,1,3,15
335992,1,4,3,10,0,10,16
335996,1,4,3,7,0,7,15
336008,1,4,3,7,0,7,23
336024,1,4,3,11,1,12,25
336033,1,4,3,1,0,1,9
336040,1,4,3,3,0,3,24
336044,1,4,3,4,1,5,16
392188,1,4,3,9,1,10,31
392191,1,4,3,6,0,6,15
392200,1,4,3,5,0,5,12
392205,1,4,3,4,0,4,10
392227,1,4,3,10,2,12,22
392234,1,4,3,2,1,3,15
419113,1,4,3,2,1,3,15
419117,1,4,3,6,2,8,18
419126,1,4,3,5,0,5,18
419137,1,4,3,11,0,11,25
419141,1,4,3,9,0,9,17
419148,1,4,3,5,0,5,28
419161,1,4,3,5,3,8,16
419164,1,4,3,12,1,13,34
501207,1,4,3,4,0,4,9
501225,1,4,3,24,1,25,52
501239,1,4,3,11,1,12,22
501253,1,4,3,4,0,4,22
501256,1,4,3,10,0,10,18
501262,1,4,3,6,0,6,12
501265,1,4,3,3,0,3,17
548328,1,4,3,1,2,3,17
548333,1,4,3,9,0,9,24
548336,1,4,3,5,0,5,15
548344,1,4,3,14,0,14,23
548348,1,4,3,4,1,5,25
548364,1,4,3,7,0,7,30
548374,1,4,3,4,1,5,24
548379,1,4,3,10,0,10,15
598012,1,4,3,4,0,4,20
598019,1,4,3,2,0,2,10
598021,1,4,3,14,0,14,21
598026,1,4,3,9,1,10,16
598033,1,4,3,7,0,7,24
598036,1,4,3,9,1,10,15
598057,1,4,3,5,0,5,11
598071,1,4,3,9,0,9,11
729300,1,4,3,16,0,16,19
729312,1,4,3,6,0,6,15
733978,1,4,3,7,0,7,20
733992,1,4,3,1,0,1,22
733996,1,4,3,6,4,10,26
734002,1,4,3,8,1,9,30
734030,1,4,3,1,0,1,24
734038,1,4,3,6,0,6,26
734052,1,4,3,7,1,8,19
734054,1,4,3,6,0,6,21
829722,1,4,3,17,0,17,32
829730,1,4,3,4,1,5,16
829738,1,4,3,12,0,12,18
829772,1,4,3,1,0,1,10
829796,1,4,3,18,0,18,28
829808,1,4,3,4,0,4,38
829814,1,4,3,10,0,10,24
980910,1,4,3,7,0,7,20
980918,1,4,3,0,0,0,12
980930,1,4,3,5,1,6,17
980940,1,4,3,5,0,5,19
980960,1,4,3,13,0,13,26
980976,1,4,3,13,0,13,24
980996,1,4,3,3,0,3,22
981010,1,4,3,6,1,7,17
1082601,1,4,3,9,0,9,30
1082612,1,4,3,10,1,11,26
1082616,1,4,3,6,0,6,22
1082633,1,4,3,4,0,4,15
1082637,1,4,3,10,0,10,13
1082639,1,4,3,6,2,8,19
1082641,1,4,3,3,0,3,32
1082645,1,4,3,8,0,8,19
335988,2,4,3,11,0,11,27
336000,2,4,3,9,1,10,21
336004,2,4,3,11,0,11,28
336011,2,4,3,8,1,9,22
336018,2,4,3,5,0,5,21
336021,2,4,3,4,0,4,17
336027,2,4,3,15,0,15,30
336036,2,4,3,12,0,12,35
392196,2,4,3,4,1,5,19
392209,2,4,3,5,1,6,10
392212,2,4,3,7,0,7,13
392215,2,4,3,5,2,7,10
392219,2,4,3,12,0,12,23
392221,2,4,3,9,0,9,29
392231,2,4,3,2,0,2,18
392239,2,4,3,6,0,6,12
419122,2,4,3,1,0,1,11
419129,2,4,3,15,0,15,26
419132,2,4,3,3,0,3,10
419144,2,4,3,10,2,12,31
419151,2,4,3,12,0,12,31
419154,2,4,3,1,1,2,13
501211,2,4,3,9,1,10,25
501217,2,4,3,9,1,10,26
501228,2,4,3,6,1,7,25
501242,2,4,3,3,0,3,6
501249,2,4,3,14,1,15,20
501259,2,4,3,12,0,12,25
501269,2,4,3,8,0,8,22
548314,2,4,3,3,0,3,18
548318,2,4,3,2,0,2,9
548324,2,4,3,1,0,1,14
548339,2,4,3,10,0,10,26
548355,2,4,3,10,0,10,27
548359,2,4,3,3,2,5,13
548371,2,4,3,4,0,4,11
548376,2,4,3,4,1,5,26
598008,2,4,3,2,0,2,23
598030,2,4,3,11,0,11,26
598042,2,4,3,3,2,5,17
598046,2,4,3,3,0,3,16
598050,2,4,3,5,0,5,24
598061,2,4,3,10,0,10,17
598064,2,4,3,17,2,19,40
598069,2,4,3,1,0,1,13
729288,2,4,3,17,0,17,31
729296,2,4,3,5,1,6,12
729318,2,4,3,2,0,2,14
734012,2,4,3,15,0,15,39
734024,2,4,3,14,2,16,33
734044,2,4,3,2,2,4,16
734048,2,4,3,9,0,9,17
829714,2,4,3,11,0,11,32
829746,2,4,3,9,0,9,12
829758,2,4,3,13,0,13,21
829764,2,4,3,2,2,4,13
829780,2,4,3,12,0,12,28
829790,2,4,3,1,0,1,20
829804,2,4,3,9,0,9,26
980924,2,4,3,10,0,10,26
980946,2,4,3,11,0,11,21
980968,2,4,3,1,5,6,13
980982,2,4,3,12,1,13,25
980990,2,4,3,5,0,5,11
981004,2,4,3,12,0,12,31
1082594,2,4,3,8,0,8,27
1082598,2,4,3,11,1,12,26
1082605,2,4,3,11,0,11,17
1082609,2,4,3,1,1,2,17
1082623,2,4,3,2,1,3,28
1082626,2,4,3,2,0,2,17
335989,1,5,3,0,0,0,17
336005,1,5,3,9,1,10,21
336013,1,5,3,9,0,9,21
336028,1,5,3,12,0,12,30
336038,1,5,3,10,0,10,25
336043,1,5,3,7,0,7,15
392195,1,5,3,16,0,16,24
392215,1,5,3,4,1,5,26
392222,1,5,3,5,0,5,13
392230,1,5,3,6,0,6,20
392238,1,5,3,1,1,2,28
419116,1,5,3,10,0,10,25
419120,1,5,3,2,1,3,17
419123,1,5,3,13,0,13,27
419129,1,5,3,13,0,13,30
419134,1,5,3,6,1,7,30
419146,1,5,3,1,5,6,22
419159,1,5,3,8,0,8,21
419163,1,5,3,6,0,6,14
501214,1,5,3,9,1,10,22
501219,1,5,3,6,1,7,20
501245,1,5,3,1,0,1,16
501257,1,5,3,9,0,9,23
501263,1,5,3,10,0,10,18
548314,1,5,3,16,0,16,32
548317,1,5,3,11,0,11,15
548325,1,5,3,5,0,5,16
548329,1,5,3,0,0,0,11
548337,1,5,3,6,0,6,19
548354,1,5,3,17,1,18,34
548359,1,5,3,7,0,7,15
548366,1,5,3,9,0,9,19
548370,1,5,3,6,0,6,19
548378,1,5,3,5,0,5,13
548382,1,5,3,8,1,9,18
598006,1,5,3,11,0,11,22
598010,1,5,3,6,1,7,13
598014,1,5,3,5,1,6,20
598024,1,5,3,11,0,11,22
598028,1,5,3,0,0,0,10
598031,1,5,3,14,0,14,24
598048,1,5,3,10,2,12,20
598077,1,5,3,9,0,9,20
729296,1,5,3,9,0,9,22
729320,1,5,3,2,0,2,15
733984,1,5,3,7,0,7,21
734008,1,5,3,3,5,8,16
734016,1,5,3,1,0,1,20
734046,1,5,3,9,1,10,15
829714,1,5,3,6,1,7,15
829746,1,5,3,7,1,8,22
829754,1,5,3,8,0,8,17
829782,1,5,3,2,2,4,16
829816,1,5,3,8,0,8,31
335992,2,5,3,14,1,15,28
335995,2,5,3,5,0,5,19
335997,2,5,3,7,0,7,25
336010,2,5,3,7,1,8,14
336016,2,5,3,8,1,9,20
336020,2,5,3,3,1,4,11
336024,2,5,3,2,0,2,10
336032,2,5,3,3,0,3,19
336041,2,5,3,11,0,11,20
336045,2,5,3,0,5,5,19
392187,2,5,3,0,1,1,7
392200,2,5,3,6,0,6,15
392203,2,5,3,8,0,8,20
392207,2,5,3,0,4,4,14
392210,2,5,3,2,0,2,5
392218,2,5,3,8,0,8,12
392225,2,5,3,5,1,6,14
392235,2,5,3,2,0,2,10
419112,2,5,3,14,0,14,22
419131,2,5,3,5,0,5,19
419139,2,5,3,10,0,10,20
419142,2,5,3,6,2,8,23
419148,2,5,3,14,3,17,35
419155,2,5,3,2,0,2,11
501204,2,5,3,1,1,2,21
501209,2,5,3,9,4,13,26
501225,2,5,3,6,0,6,18
501230,2,5,3,3,1,4,20
501236,2,5,3,5,0,5,12
501240,2,5,3,8,0,8,27
501254,2,5,3,7,0,7,25
501268,2,5,3,4,0,4,24
548322,2,5,3,3,0,3,12
548331,2,5,3,8,0,8,25
548341,2,5,3,7,0,7,25
548350,2,5,3,8,0,8,22
548363,2,5,3,16,0,16,21
598019,2,5,3,4,0,4,23
598037,2,5,3,0,0,0,7
598041,2,5,3,0,0,0,21
598052,2,5,3,8,0,8,19
598054,2,5,3,10,1,11,18
598057,2,5,3,6,0,6,12
598063,2,5,3,11,0,11,14
598068,2,5,3,7,0,7,18
598070,2,5,3,1,1,2,16
598076,2,5,3,2,0,2,15
729290,2,5,3,3,0,3,13
729302,2,5,3,3,0,3,13
729310,2,5,3,11,0,11,24
733980,2,5,3,5,2,7,21
733994,2,5,3,5,0,5,16
734004,2,5,3,14,0,14,24
734022,2,5,3,10,0,10,27
734038,2,5,3,7,0,7,23
829720,2,5,3,13,0,13,23
829726,2,5,3,3,0,3,15
829732,2,5,3,3,0,3,14
829740,2,5,3,11,0,11,19
829774,2,5,3,10,2,12,30
829792,2,5,3,9,0,9,21
829802,2,5,3,6,0,6,12
829824,2,5,3,7,0,7,21
336000,1,6,3,5,1,6,17
336003,1,6,3,9,1,10,27
336014,1,6,3,11,0,11,30
336020,1,6,3,8,0,8,23
336025,1,6,3,2,0,2,14
336027,1,6,3,10,0,10,24
392194,1,6,3,6,0,6,14
392203,1,6,3,10,0,10,25
392228,1,6,3,1,0,1,18
392231,1,6,3,4,2,6,19
392235,1,6,3,3,0,3,15
392237,1,6,3,12,0,12,14
392242,1,6,3,10,0,10,23
419121,1,6,3,9,0,9,28
419133,1,6,3,10,0,10,39
419136,1,6,3,15,2,17,38
419139,1,6,3,8,1,9,24
419145,1,6,3,14,0,14,25
419154,1,6,3,5,5,10,29
501206,1,6,3,6,0,6,23
501209,1,6,3,9,0,9,16
501228,1,6,3,10,2,12,26
501232,1,6,3,7,1,8,24
501238,1,6,3,7,0,7,11
501243,1,6,3,6,0,6,21
501270,1,6,3,13,0,13,16
548347,1,6,3,15,0,15,23
548350,1,6,3,6,0,6,19
548362,1,6,3,15,2,17,34
548369,1,6,3,6,0,6,18
598003,1,6,3,9,0,9,26
598015,1,6,3,2,2,4,16
598022,1,6,3,5,0,5,21
598040,1,6,3,4,5,9,17
598049,1,6,3,8,0,8,12
598054,1,6,3,1,0,1,22
598064,1,6,3,12,0,12,22
729286,1,6,3,8,0,8,15
733980,1,6,3,6,0,6,22
733986,1,6,3,8,1,9,17
733990,1,6,3,4,0,4,18
733998,1,6,3,4,0,4,14
734024,1,6,3,6,2,8,19
734044,1,6,3,9,0,9,21
829720,1,6,3,13,0,13,26
829736,1,6,3,4,1,5,20
829744,1,6,3,7,0,7,12
829752,1,6,3,10,0,10,21
829762,1,6,3,6,1,7,17
829788,1,6,3,8,0,8,15
829818,1,6,3,10,0,10,18
980908,1,6,3,2,0,2,25
980938,1,6,3,2,3,5,16
980956,1,6,3,10,0,10,23
980970,1,6,3,5,1,6,17
981002,1,6,3,0,0,0,4
981016,1,6,3,7,1,8,21
1082599,1,6,3,15,1,16,29
1082605,1,6,3,5,0,5,22
1082608,1,6,3,17,0,17,36
1082622,1,6,3,14,0,14,31
1082626,1,6,3,5,0,5,7
1082642,1,6,3,2,0,2,11
335989,2,6,3,5,0,5,26
335993,2,6,3,12,0,12,30
336006,2,6,3,5,1,6,31
336009,2,6,3,2,0,2,6
336022,2,6,3,2,0,2,18
336031,2,6,3,8,0,8,31
336037,2,6,3,6,0,6,35
336043,2,6,3,8,1,9,22
392188,2,6,3,11,2,13,41
392199,2,6,3,7,0,7,20
392206,2,6,3,11,1,12,28
392211,2,6,3,9,0,9,20
392216,2,6,3,17,0,17,28
392220,2,6,3,9,0,9,20
392224,2,6,3,5,0,5,17
392240,2,6,3,11,0,11,30
419113,2,6,3,8,4,12,22
419116,2,6,3,16,0,16,40
419119,2,6,3,3,1,4,29
419125,2,6,3,3,0,3,32
419149,2,6,3,5,1,6,17
419157,2,6,3,16,1,17,31
419160,2,6,3,5,0,5,12
419165,2,6,3,7,0,7,21
501218,2,6,3,12,0,12,24
501221,2,6,3,9,0,9,27
501235,2,6,3,2,0,2,16
501248,2,6,3,2,1,3,11
501251,2,6,3,2,1,3,7
501258,2,6,3,17,0,17,34
501262,2,6,3,0,0,0,15
548312,2,6,3,10,0,10,26
548315,2,6,3,5,1,6,30
548321,2,6,3,12,0,12,31
548326,2,6,3,7,0,7,14
548330,2,6,3,0,4,4,18
548334,2,6,3,6,0,6,29
548338,2,6,3,2,0,2,14
548342,2,6,3,7,0,7,22
548354,2,6,3,14,0,14,28
548374,2,6,3,7,0,7,28
548377,2,6,3,6,0,6,24
548379,2,6,3,7,0,7,21
548383,2,6,3,1,0,1,25
548385,2,6,3,2,2,4,21
598006,2,6,3,12,0,12,22
598011,2,6,3,6,1,7,17
598025,2,6,3,8,1,9,22
598029,2,6,3,7,0,7,17
598033,2,6,3,7,0,7,12
598045,2,6,3,7,0,7,19
598059,2,6,3,9,0,9,25
598067,2,6,3,5,0,5,17
598072,2,6,3,11,5,16,33
729294,2,6,3,13,0,13,31
729298,2,6,3,3,0,3,11
729306,2,6,3,8,0,8,20
729314,2,6,3,2,0,2,14
734010,2,6,3,7,1,8,18
734016,2,6,3,6,0,6,25
734036,2,6,3,2,0,2,24
829712,2,6,3,7,0,7,20
829730,2,6,3,6,3,9,24
829766,2,6,3,2,2,4,15
829772,2,6,3,1,1,2,23
829782,2,6,3,16,1,17,31
829798,2,6,3,2,0,2,15
829806,2,6,3,2,0,2,16
980918,2,6,3,0,0,0,9
980926,2,6,3,9,0,9,33
980950,2,6,3,4,1,5,7
980966,2,6,3,6,1,7,31
980976,2,6,3,6,0,6,16
980988,2,6,3,7,0,7,20
980998,2,6,3,8,0,8,21
981008,2,6,3,4,0,4,14
1082595,2,6,3,8,0,8,21
1082611,2,6,3,9,0,9,24
1082614,2,6,3,5,0,5,19
1082630,2,6,3,12,0,12,28
1082632,2,6,3,9,1,10,25
1082635,2,6,3,14,0,14,20
1082640,2,6,3,7,0,7,22
1082646,2,6,3,4,0,4,17
335990,1,7,3,5,1,6,19
335999,1,7,3,0,1,1,15
336009,1,7,3,3,0,3,17
336029,1,7,3,9,0,9,39
336037,1,7,3,9,0,9,25
336041,1,7,3,9,0,9,15
392186,1,7,3,10,0,10,20
392202,1,7,3,4,6,10,26
392208,1,7,3,1,2,3,18
392213,1,7,3,9,0,9,21
392220,1,7,3,2,0,2,11
392223,1,7,3,12,2,14,22
392232,1,7,3,1,0,1,8
392240,1,7,3,8,2,10,23
419112,1,7,3,10,0,10,36
419119,1,7,3,7,0,7,29
419124,1,7,3,1,6,7,18
419135,1,7,3,5,0,5,19
419143,1,7,3,9,1,10,28
419151,1,7,3,8,0,8,16
419155,1,7,3,10,2,12,24
419157,1,7,3,2,4,6,22
419162,1,7,3,2,1,3,16
419166,1,7,3,7,0,7,14
419167,1,7,3,7,5,12,23
501215,1,7,3,2,0,2,21
501226,1,7,3,1,0,1,10
501229,1,7,3,10,0,10,25
501236,1,7,3,11,0,11,22
501242,1,7,3,1,0,1,14
501246,1,7,3,5,0,5,19
501251,1,7,3,20,0,20,35
501268,1,7,3,7,0,7,14
548322,1,7,3,20,1,21,26
548330,1,7,3,2,0,2,5
548339,1,7,3,7,1,8,11
548356,1,7,3,6,1,7,11
548365,1,7,3,1,0,1,3
548368,1,7,3,5,0,5,18
598007,1,7,3,5,1,6,17
598011,1,7,3,8,0,8,14
598016,1,7,3,16,1,17,28
598029,1,7,3,1,0,1,7
598038,1,7,3,16,0,16,28
598042,1,7,3,2,1,3,13
598044,1,7,3,8,1,9,19
598051,1,7,3,5,1,6,11
598055,1,7,3,2,0,2,13
598068,1,7,3,15,0,15,25
598078,1,7,3,5,0,5,16
729292,1,7,3,7,0,7,17
729308,1,7,3,9,0,9,20
729314,1,7,3,2,0,2,16
733988,1,7,3,4,2,6,25
734000,1,7,3,8,0,8,16
734014,1,7,3,8,3,11,23
734022,1,7,3,6,0,6,14
734036,1,7,3,11,0,11,24
734050,1,7,3,4,0,4,17
829710,1,7,3,12,0,12,21
829726,1,7,3,5,0,5,22
829734,1,7,3,6,0,6,8
829742,1,7,3,10,0,10,23
829756,1,7,3,4,0,4,23
829774,1,7,3,8,0,8,26
829780,1,7,3,6,0,6,22
829810,1,7,3,6,0,6,16
829822,1,7,3,4,0,4,15
829828,1,7,3,11,0,11,28
980906,1,7,3,8,0,8,20
980922,1,7,3,9,1,10,19
980928,1,7,3,2,0,2,12
980946,1,7,3,2,0,2,13
980990,1,7,3,1,0,1,8
980998,1,7,3,3,0,3,17
981012,1,7,3,6,0,6,25
1082592,1,7,3,9,0,9,28
1082614,1,7,3,7,2,9,29
1082635,1,7,3,7,1,8,18
1082638,1,7,3,15,1,16,20
1082644,1,7,3,6,0,6,18
1082650,1,7,3,2,0,2,9
335994,2,7,3,12,0,12,25
335996,2,7,3,4,0,4,18
336002,2,7,3,0,1,1,17
336013,2,7,3,2,0,2,8
336017,2,7,3,7,0,7,17
336023,2,7,3,2,2,4,23
336026,2,7,3,23,0,23,44
336033,2,7,3,1,1,2,36
392197,2,7,3,6,2,8,12
392202,2,7,3,1,1,2,17
392205,2,7,3,3,0,3,8
392217,2,7,3,4,0,4,11
392227,2,7,3,3,1,4,9
392230,2,7,3,4,0,4,13
419119,2,7,3,4,0,4,33
419127,2,7,3,5,2,7,31
419130,2,7,3,5,2,7,26
419137,2,7,3,8,0,8,19
419147,2,7,3,7,0,7,23
419170,2,7,3,5,1,6,9
501206,2,7,3,6,1,7,13
501210,2,7,3,14,1,15,26
501223,2,7,3,1,0,1,12
501256,2,7,3,0,0,0,19
501261,2,7,3,2,0,2,11
501272,2,7,3,9,1,10,24
501274,2,7,3,2,1,3,24
501275,2,7,3,2,0,2,22
548311,2,7,3,11,1,12,23
548313,2,7,3,2,0,2,7
548319,2,7,3,2,0,2,10
548344,2,7,3,7,0,7,19
548347,2,7,3,1,0,1,19
548351,2,7,3,2,0,2,9
548360,2,7,3,6,0,6,14
548372,2,7,3,8,0,8,15
548375,2,7,3,1,0,1,8
548382,2,7,3,6,3,9,21
548384,2,7,3,6,1,7,27
598004,2,7,3,6,1,7,11
598024,2,7,3,4,0,4,10
598034,2,7,3,3,4,7,13
598060,2,7,3,9,0,9,17
598065,2,7,3,10,0,10,23
598071,2,7,3,5,0,5,18
598075,2,7,3,5,0,5,17
598077,2,7,3,3,0,3,21
729284,2,7,3,7,0,7,16
729322,2,7,3,4,0,4,12
733978,2,7,3,5,1,6,23
734006,2,7,3,6,0,6,9
734030,2,7,3,9,0,9,29
734046,2,7,3,15,0,15,34
829722,2,7,3,3,0,3,13
829752,2,7,3,8,2,10,21
829788,2,7,3,6,0,6,14
829794,2,7,3,13,0,13,23
829800,2,7,3,14,0,14,25
829820,2,7,3,13,0,13,21
980914,2,7,3,9,0,9,27
980932,2,7,3,6,0,6,14
980938,2,7,3,19,0,19,32
980952,2,7,3,10,0,10,26
980962,2,7,3,16,0,16,24
980978,2,7,3,11,0,11,20
980986,2,7,3,10,2,12,16
1082597,2,7,3,9,1,10,25
1082600,2,7,3,7,0,7,28
1082602,2,7,3,0,1,1,8
1082606,2,7,3,5,6,11,25
1082612,2,7,3,13,0,13,34
1082618,2,7,3,13,0,13,27
1082625,2,7,3,16,0,16,40
1082628,2,7,3,16,1,17,32
1082641,2,7,3,6,0,6,29
1082647,2,7,3,10,0,10,19
1082649,2,7,3,10,0,10,24
335991,1,8,3,7,0,7,21
335993,1,8,3,6,0,6,15
335995,1,8,3,10,0,10,32
336004,1,8,3,10,0,10,26
336007,1,8,3,2,0,2,19
336016,1,8,3,12,0,12,25
336036,1,8,3,12,0,12,25
336042,1,8,3,6,0,6,13
392193,1,8,3,6,2,8,35
392197,1,8,3,6,1,7,22
392206,1,8,3,3,0,3,22
392210,1,8,3,9,0,9,27
392217,1,8,3,4,1,5,13
392221,1,8,3,8,1,9,25
392225,1,8,3,8,0,8,19
392244,1,8,3,2,0,2,15
419115,1,8,3,14,0,14,41
419122,1,8,3,15,0,15,43
419125,1,8,3,6,0,6,24
419131,1,8,3,4,1,5,23
419156,1,8,3,5,1,6,16
419165,1,8,3,3,0,3,18
419169,1,8,3,5,1,6,14
501204,1,8,3,7,0,7,27
501213,1,8,3,6,0,6,20
501217,1,8,3,5,0,5,18
501221,1,8,3,6,0,6,20
501234,1,8,3,6,0,6,10
501248,1,8,3,5,0,5,19
501255,1,8,3,8,0,8,20
501261,1,8,3,3,0,3,5
501269,1,8,3,9,0,9,24
548319,1,8,3,2,0,2,9
548326,1,8,3,3,0,3,12
548331,1,8,3,10,0,10,26
548334,1,8,3,3,0,3,19
548340,1,8,3,13,0,13,21
548346,1,8,3,9,0,9,29
548351,1,8,3,7,1,8,20
548353,1,8,3,10,0,10,14
548361,1,8,3,2,0,2,24
548371,1,8,3,7,0,7,27
548381,1,8,3,6,0,6,16
335999,2,8,3,9,0,9,29
336012,2,8,3,11,0,11,15
336019,2,8,3,5,1,6,17
336025,2,8,3,6,0,6,27
336029,2,8,3,6,0,6,18
336039,2,8,3,6,0,6,17
392189,2,8,3,10,0,10,24
392201,2,8,3,16,1,17,48
392214,2,8,3,6,0,6,7
392228,2,8,3,2,1,3,33
392233,2,8,3,8,1,9,29
392234,2,8,3,7,0,7,30
392241,2,8,3,3,1,4,16
392242,2,8,3,16,1,17,41
419111,2,8,3,15,0,15,31
419135,2,8,3,6,0,6,26
419140,2,8,3,9,0,9,32
419143,2,8,3,7,0,7,20
419146,2,8,3,7,0,7,29
419150,2,8,3,4,0,4,15
419152,2,8,3,5,2,7,16
419161,2,8,3,5,1,6,23
419168,2,8,3,8,0,8,10
501208,2,8,3,6,0,6,14
501229,2,8,3,10,0,10,25
501241,2,8,3,19,1,20,38
501244,2,8,3,11,0,11,21
501264,2,8,3,6,0,6,18
548316,2,8,3,5,0,5,21
548357,2,8,3,8,0,8,17
548364,2,8,3,6,0,6,16
548378,2,8,3,6,3,9,26
501205,1,9,3,3,1,4,27
501212,1,9,3,3,0,3,13
501224,1,9,3,15,0,15,26
501230,1,9,3,10,1,11,22
501247,1,9,3,10,0,10,17
501252,1,9,3,9,0,9,21
501259,1,9,3,9,0,9,30
501215,2,9,3,17,0,17,25
501220,2,9,3,10,0,10,20
501234,2,9,3,4,0,4,6
501238,2,9,3,3,5,8,18
501243,2,9,3,4,0,4,30
501263,2,9,3,6,1,7,45
501266,2,9,3,4,0,4,14
501218,1,10,3,2,0,2,21
501223,1,10,3,6,0,6,16
501233,1,10,3,13,1,14,22
501240,1,10,3,8,0,8,24
501264,1,10,3,7,0,7,25
501267,1,10,3,7,0,7,17
548313,1,10,3,2,5,7,9
548318,1,10,3,5,1,6,21
548324,1,10,3,9,1,10,18
548332,1,10,3,12,0,12,30
548338,1,10,3,10,1,11,14
548342,1,10,3,5,0,5,7
548363,1,10,3,8,0,8,15
598008,1,10,3,11,0,11,13
598020,1,10,3,2,2,4,23
598030,1,10,3,8,0,8,28
598052,1,10,3,14,0,14,30
598060,1,10,3,2,0,2,14
598066,1,10,3,14,0,14,30
598072,1,10,3,9,0,9,25
501207,2,10,3,11,0,11,17
501212,2,10,3,7,0,7,27
501231,2,10,3,7,0,7,19
501237,2,10,3,14,0,14,27
501246,2,10,3,6,0,6,12
501253,2,10,3,10,1,11,21
501255,2,10,3,6,0,6,30
548327,2,10,3,15,0,15,31
548335,2,10,3,5,2,7,22
548346,2,10,3,8,0,8,19
548353,2,10,3,10,0,10,21
548356,2,10,3,6,0,6,19
548358,2,10,3,3,1,4,22
548367,2,10,3,4,0,4,14
548370,2,10,3,5,0,5,16
548380,2,10,3,2,0,2,13
598005,2,10,3,2,0,2,5
598014,2,10,3,17,0,17,30
598016,2,10,3,9,0,9,22
598023,2,10,3,9,0,9,28
598032,2,10,3,8,0,8,19
598040,2,10,3,8,0,8,18
598043,2,10,3,5,0,5,26
598047,2,10,3,8,0,8,20
598058,2,10,3,3,0,3,22
598005,1,11,3,8,0,8,18
598023,1,11,3,10,0,10,15
598035,1,11,3,1,0,1,13
598037,1,11,3,7,0,7,14
598053,1,11,3,5,0,5,17
598061,1,11,3,7,1,8,23
598065,1,11,3,4,1,5,36
598070,1,11,3,1,0,1,5
598076,1,11,3,3,0,3,6
729290,1,11,3,8,5,13,17
729306,1,11,3,7,0,7,22
729316,1,11,3,1,0,1,16
729322,1,11,3,5,1,6,21
733982,1,11,3,5,0,5,20
733994,1,11,3,9,0,9,28
734006,1,11,3,10,3,13,18
734012,1,11,3,7,1,8,18
734020,1,11,3,6,1,7,21
734042,1,11,3,5,5,10,24
829732,1,11,3,5,1,6,19
829748,1,11,3,9,0,9,20
829764,1,11,3,5,0,5,15
829778,1,11,3,21,1,22,35
829792,1,11,3,10,0,10,28
829798,1,11,3,10,0,10,25
829804,1,11,3,9,0,9,28
829812,1,11,3,10,2,12,27
829820,1,11,3,1,1,2,10
980920,1,11,3,4,1,5,19
980948,1,11,3,6,0,6,13
980958,1,11,3,6,1,7,21
980978,1,11,3,9,0,9,23
980984,1,11,3,7,0,7,18
980988,1,11,3,2,0,2,11
981008,1,11,3,7,0,7,17
981020,1,11,3,3,0,3,15
981024,1,11,3,9,0,9,21
1082591,1,11,3,6,0,6,29
1082600,1,11,3,8,0,8,13
1082609,1,11,3,8,1,9,18
1082611,1,11,3,6,0,6,18
1082615,1,11,3,8,0,8,20
1082623,1,11,3,9,0,9,22
1082627,1,11,3,17,0,17,35
1082630,1,11,3,10,0,10,25
1082648,1,11,3,7,0,7,20
598009,2,11,3,6,1,7,19
598015,2,11,3,5,0,5,7
598018,2,11,3,13,0,13,24
598026,2,11,3,3,0,3,11
598044,2,11,3,3,0,3,19
598049,2,11,3,6,0,6,23
598056,2,11,3,12,1,13,24
598074,2,11,3,3,1,4,17
729300,2,11,3,6,0,6,22
733998,2,11,3,5,2,7,24
734026,2,11,3,10,0,10,26
734034,2,11,3,12,0,12,34
829716,2,11,3,9,0,9,24
829724,2,11,3,5,0,5,41
829736,2,11,3,7,0,7,17
829756,2,11,3,7,0,7,21
829786,2,11,3,8,0,8,23
980912,2,11,3,13,0,13,35
980928,2,11,3,8,0,8,22
980934,2,11,3,6,1,7,30
980940,2,11,3,18,0,18,30
980972,2,11,3,3,0,3,26
980996,2,11,3,4,0,4,20
981014,2,11,3,11,0,11,22
981022,2,11,3,10,1,11,22
1082596,2,11,3,21,0,21,32
1082604,2,11,3,9,0,9,19
1082634,2,11,3,9,0,9,23
1082638,2,11,3,11,0,11,21
1082643,2,11,3,5,0,5,25
980916,1,12,3,7,0,7,23
980924,1,12,3,3,0,3,13
980944,1,12,3,11,0,11,17
980954,1,12,3,5,0,5,18
980962,1,12,3,14,0,14,22
980974,1,12,3,9,0,9,31
980994,1,12,3,8,0,8,19
1082594,1,12,3,4,0,4,7
1082603,1,12,3,8,0,8,23
1082607,1,12,3,13,4,17,28
1082618,1,12,3,7,0,7,25
1082620,1,12,3,10,1,11,25
1082624,1,12,3,9,0,9,18
1082634,1,12,3,6,0,6,12
1082647,1,12,3,10,0,10,19
980906,2,12,3,5,0,5,18
980936,2,12,3,5,1,6,18
980948,2,12,3,8,0,8,13
980970,2,12,3,3,0,3,16
980984,2,12,3,4,0,4,9
981002,2,12,3,14,0,14,30
981010,2,12,3,7,0,7,27
1082592,2,12,3,12,0,12,35
1082599,2,12,3,7,0,7,24
1082615,2,12,3,10,0,10,15
1082629,2,12,3,5,1,6,17
1082631,2,12,3,18,1,19,30
1082642,2,12,3,4,0,4,22
1082645,2,12,3,8,1,9,18
1082650,2,12,3,7,0,7,21
980934,1,13,3,9,1,10,24
980950,1,13,3,14,0,14,42
980966,1,13,3,3,0,3,17
980972,1,13,3,3,0,3,3
981018,1,13,3,2,0,2,9
981022,1,13,3,3,0,3,19
1082593,1,13,3,6,0,6,22
1082596,1,13,3,12,0,12,25
1082606,1,13,3,6,0,6,21
1082625,1,13,3,15,0,15,36
1082629,1,13,3,12,0,12,24
1082632,1,13,3,7,0,7,20
1082640,1,13,3,6,0,6,21
1082643,1,13,3,13,0,13,33
980910,2,13,3,11,0,11,23
980916,2,13,3,14,0,14,27
980922,2,13,3,5,0,5,20
980942,2,13,3,15,1,16,31
980954,2,13,3,22,2,24,33
980960,2,13,3,4,0,4,18
980980,2,13,3,13,0,13,23
980992,2,13,3,6,0,6,15
981006,2,13,3,7,1,8,28
981012,2,13,3,18,0,18,26
1082603,2,13,3,6,0,6,33
1082610,2,13,3,19,0,19,23
1082613,2,13,3,14,1,15,40
1082616,2,13,3,11,0,11,25
1082621,2,13,3,6,0,6,19
1082637,2,13,3,6,0,6,23
335987,1,1,4,17,6,23,50
335998,1,1,4,6,0,6,38
336002,1,1,4,10,1,11,33
336015,1,1,4,6,0,6,25
336019,1,1,4,9,0,9,28
336022,1,1,4,5,0,5,22
336026,1,1,4,3,2,5,21
336030,1,1,4,3,0,3,19
336032,1,1,4,2,0,2,14
392189,1,1,4,10,0,10,12
392204,1,1,4,14,0,14,37
392212,1,1,4,5,1,6,15
392216,1,1,4,9,0,9,42
392224,1,1,4,1,0,1,16
392226,1,1,4,2,0,2,17
392233,1,1,4,9,1,10,25
419111,1,1,4,7,1,8,22
419127,1,1,4,4,0,4,29
419132,1,1,4,5,0,5,33
419140,1,1,4,4,1,5,29
419144,1,1,4,5,1,6,31
419149,1,1,4,5,1,6,38
419153,1,1,4,9,0,9,30
419158,1,1,4,0,1,1,18
501208,1,1,4,7,0,7,26
501227,1,1,4,9,0,9,43
501235,1,1,4,13,0,13,28
501244,1,1,4,5,0,5,27
501260,1,1,4,1,1,2,22
501272,1,1,4,14,0,14,30
501274,1,1,4,2,0,2,16
548312,1,1,4,6,1,7,31
548320,1,1,4,15,0,15,35
548349,1,1,4,8,2,10,33
548358,1,1,4,3,7,10,32
548373,1,1,4,11,0,11,32
548375,1,1,4,9,1,10,22
548380,1,1,4,6,0,6,21
548383,1,1,4,8,0,8,28
598013,1,1,4,5,0,5,25
598018,1,1,4,6,1,7,31
598027,1,1,4,5,1,6,33
598034,1,1,4,2,0,2,48
598045,1,1,4,3,0,3,20
598058,1,1,4,7,0,7,35
598074,1,1,4,3,0,3,20
729284,1,1,4,10,0,10,20
729294,1,1,4,2,0,2,18
729304,1,1,4,6,0,6,28
734032,1,1,4,6,0,6,28
734048,1,1,4,16,1,17,31
829718,1,1,4,11,1,12,40
829766,1,1,4,16,0,16,37
829776,1,1,4,7,0,7,34
829786,1,1,4,10,1,11,36
980914,1,1,4,3,0,3,22
980952,1,1,4,6,0,6,38
980968,1,1,4,9,0,9,30
980980,1,1,4,4,0,4,21
981000,1,1,4,15,0,15,33
981006,1,1,4,11,0,11,34
981014,1,1,4,5,1,6,34
1082597,1,1,4,10,0,10,44
1082604,1,1,4,5,1,6,20
1082613,1,1,4,3,0,3,47
1082617,1,1,4,8,5,13,52
1082631,1,1,4,4,1,5,19
1082649,1,1,4,8,1,9,22
335991,2,1,4,3,0,3,21
336005,2,1,4,8,0,8,39
336008,2,1,4,2,0,2,25
336040,2,1,4,10,0,10,34
392191,2,1,4,14,0,14,30
392195,2,1,4,15,0,15,25
392202,2,1,4,0,0,0,17
392208,2,1,4,2,0,2,15
392236,2,1,4,6,0,6,33
392238,2,1,4,7,0,7,20
419114,2,1,4,17,0,17,36
419118,2,1,4,12,0,12,29
419123,2,1,4,9,0,9,27
419136,2,1,4,1,0,1,20
419163,2,1,4,4,0,4,30
419166,2,1,4,12,0,12,30
501203,2,1,4,14,0,14,39
501214,2,1,4,8,0,8,31
501219,2,1,4,6,1,7,19
501224,2,1,4,5,0,5,27
501239,2,1,4,15,0,15,34
501247,2,1,4,5,0,5,33
501250,2,1,4,4,0,4,25
501267,2,1,4,1,0,1,33
548317,2,1,4,3,0,3,13
548325,2,1,4,4,0,4,22
548328,2,1,4,11,0,11,33
548333,2,1,4,14,0,14,32
548340,2,1,4,8,1,9,26
548352,2,1,4,4,2,6,21
548362,2,1,4,16,0,16,37
548368,2,1,4,3,1,4,16
548386,2,1,4,18,2,20,36
598003,2,1,4,9,0,9,29
598010,2,1,4,3,0,3,26
598021,2,1,4,3,0,3,19
598036,2,1,4,12,0,12,28
598039,2,1,4,1,0,1,33
598048,2,1,4,10,0,10,35
598055,2,1,4,7,0,7,29
598062,2,1,4,12,0,12,22
598066,2,1,4,1,0,1,25
729312,2,1,4,6,0,6,19
729320,2,1,4,1,0,1,21
733976,2,1,4,15,0,15,35
733984,2,1,4,8,0,8,31
733990,2,1,4,3,0,3,30
734002,2,1,4,19,0,19,41
734014,2,1,4,10,0,10,31
734020,2,1,4,2,0,2,14
734028,2,1,4,2,0,2,36
734042,2,1,4,6,0,6,26
734054,2,1,4,9,0,9,40
829710,2,1,4,5,1,6,19
829728,2,1,4,12,0,12,33
829738,2,1,4,5,0,5,26
829744,2,1,4,7,0,7,31
829748,2,1,4,11,0,11,35
829770,2,1,4,14,0,14,42
829796,2,1,4,15,0,15,40
829810,2,1,4,9,0,9,29
829816,2,1,4,10,5,15,36
980908,2,1,4,6,1,7,36
980920,2,1,4,6,0,6,25
980930,2,1,4,11,0,11,44
980944,2,1,4,9,2,11,42
980956,2,1,4,6,1,7,28
980964,2,1,4,10,0,10,32
980994,2,1,4,11,2,13,57
981020,2,1,4,7,4,11,34
1082593,2,1,4,9,0,9,46
1082601,2,1,4,6,5,11,42
1082608,2,1,4,7,0,7,28
1082620,2,1,4,6,1,7,28
1082622,2,1,4,4,0,4,30
1082627,2,1,4,9,0,9,25
1082636,2,1,4,25,0,25,59
1082639,2,1,4,8,0,8,39
1082644,2,1,4,5,0,5,35
1082648,2,1,4,14,0,14,41
335997,1,2,4,12,0,12,29
336011,1,2,4,4,0,4,15
336017,1,2,4,9,0,9,27
336021,1,2,4,10,0,10,24
336031,1,2,4,7,0,7,29
336034,1,2,4,5,0,5,16
336039,1,2,4,9,1,10,32
392187,1,2,4,2,0,2,14
392196,1,2,4,6,1,7,39
392199,1,2,4,13,0,13,26
392209,1,2,4,12,0,12,27
392218,1,2,4,3,0,3,16
392241,1,2,4,10,0,10,25
419114,1,2,4,0,1,1,16
419128,1,2,4,2,0,2,19
419138,1,2,4,11,0,11,28
419150,1,2,4,6,1,7,25
501210,1,2,4,2,0,2,16
501237,1,2,4,9,0,9,37
501249,1,2,4,21,0,21,38
501273,1,2,4,6,0,6,30
501275,1,2,4,11,0,11,57
548315,1,2,4,6,1,7,37
548323,1,2,4,11,0,11,37
548341,1,2,4,2,0,2,25
548355,1,2,4,14,0,14,24
548367,1,2,4,1,3,4,29
548372,1,2,4,2,0,2,13
548377,1,2,4,11,0,11,30
598004,1,2,4,7,0,7,16
598009,1,2,4,3,1,4,23
598017,1,2,4,6,0,6,17
598032,1,2,4,5,0,5,33
598041,1,2,4,5,0,5,44
598047,1,2,4,5,0,5,20
598050,1,2,4,7,0,7,22
598059,1,2,4,6,1,7,23
598062,1,2,4,2,1,3,14
598069,1,2,4,5,0,5,23
598073,1,2,4,13,0,13,46
729310,1,2,4,1,0,1,12
729318,1,2,4,0,0,0,26
734004,1,2,4,9,0,9,15
734010,1,2,4,6,0,6,28
734026,1,2,4,6,0,6,20
734040,1,2,4,12,0,12,28
829724,1,2,4,5,0,5,28
829768,1,2,4,8,0,8,33
829790,1,2,4,6,0,6,51
829800,1,2,4,0,0,0,20
829824,1,2,4,3,1,4,28
829826,1,2,4,2,0,2,23
980912,1,2,4,14,1,15,27
980926,1,2,4,15,1,16,35
980932,1,2,4,17,0,17,32
980936,1,2,4,7,0,7,29
980942,1,2,4,8,0,8,27
980964,1,2,4,10,0,10,25
980982,1,2,4,20,0,20,44
980986,1,2,4,5,0,5,17
980992,1,2,4,5,0,5,15
981004,1,2,4,17,1,18,35
1082595,1,2,4,4,0,4,30
1082598,1,2,4,1,0,1,19
1082602,1,2,4,4,0,4,28
1082610,1,2,4,8,0,8,33
1082621,1,2,4,4,1,5,22
1082628,1,2,4,9,1,10,31
1082636,1,2,4,9,0,9,29
1082646,1,2,4,8,0,8,27
335987,2,2,4,3,1,4,16
335990,2,2,4,5,0,5,27
336001,2,2,4,7,0,7,20
336003,2,2,4,13,2,15,42
336007,2,2,4,6,0,6,30
336015,2,2,4,2,0,2,19
336028,2,2,4,9,0,9,15
392190,2,2,4,5,1,6,31
392193,2,2,4,4,0,4,19
392204,2,2,4,13,2,15,32
392213,2,2,4,17,0,17,41
392223,2,2,4,5,0,5,27
392226,2,2,4,10,0,10,27
392229,2,2,4,10,1,11,29
392237,2,2,4,6,0,6,16
392243,2,2,4,14,1,15,39
392244,2,2,4,5,0,5,21
419117,2,2,4,5,7,12,32
419120,2,2,4,8,1,9,44
419124,2,2,4,12,0,12,28
419133,2,2,4,11,0,11,33
419141,2,2,4,9,0,9,28
419145,2,2,4,1,0,1,26
419153,2,2,4,9,2,11,22
419156,2,2,4,9,0,9,27
419159,2,2,4,18,0,18,34
419162,2,2,4,10,0,10,22
419167,2,2,4,7,0,7,31
419169,2,2,4,6,0,6,21
501205,2,2,4,8,1,9,31
501213,2,2,4,6,0,6,22
501216,2,2,4,5,0,5,30
501227,2,2,4,14,1,15,32
501232,2,2,4,11,1,12,45
501252,2,2,4,1,0,1,67
501257,2,2,4,10,0,10,42
501260,2,2,4,3,1,4,50
501265,2,2,4,10,1,11,17
501271,2,2,4,18,0,18,31
501276,2,2,4,6,0,6,24
548320,2,2,4,6,0,6,14
548329,2,2,4,10,0,10,38
548332,2,2,4,18,0,18,35
548336,2,2,4,1,0,1,18
548349,2,2,4,9,0,9,31
548361,2,2,4,0,0,0,26
548365,2,2,4,14,0,14,22
548381,2,2,4,5,1,6,36
598013,2,2,4,0,0,0,19
598022,2,2,4,11,1,12,32
598028,2,2,4,10,0,10,31
598038,2,2,4,3,0,3,25
598053,2,2,4,2,0,2,24
729286,2,2,4,10,1,11,28
729292,2,2,4,1,0,1,17
729304,2,2,4,12,1,13,33
733982,2,2,4,2,0,2,16
733988,2,2,4,6,0,6,49
733996,2,2,4,8,0,8,17
734018,2,2,4,2,0,2,16
734032,2,2,4,8,0,8,17
829718,2,2,4,1,4,5,23
829742,2,2,4,4,0,4,16
829750,2,2,4,2,0,2,33
829754,2,2,4,8,0,8,36
829762,2,2,4,8,0,8,32
829776,2,2,4,13,0,13,49
829784,2,2,4,7,0,7,25
829808,2,2,4,6,0,6,39
829812,2,2,4,14,0,14,58
980958,2,2,4,7,1,8,37
980974,2,2,4,14,1,15,25
981000,2,2,4,12,0,12,44
981016,2,2,4,9,0,9,28
981018,2,2,4,0,0,0,25
981024,2,2,4,16,0,16,42
1082591,2,2,4,14,1,15,43
1082607,2,2,4,10,0,10,35
1082617,2,2,4,2,0,2,24
1082624,2,2,4,4,1,5,30
1082633,2,2,4,4,0,4,27
335988,1,3,4,6,0,6,33
335994,1,3,4,1,0,1,35
336001,1,3,4,4,0,4,22
336006,1,3,4,13,2,15,28
336010,1,3,4,4,0,4,16
336012,1,3,4,5,2,7,21
336018,1,3,4,4,1,5,27
336023,1,3,4,2,0,2,20
336045,1,3,4,12,1,13,29
392190,1,3,4,8,0,8,36
392201,1,3,4,7,3,10,38
392207,1,3,4,2,0,2,19
392211,1,3,4,9,0,9,28
392214,1,3,4,13,0,13,34
392219,1,3,4,6,0,6,35
392229,1,3,4,0,0,0,32
392236,1,3,4,6,2,8,35
392239,1,3,4,11,0,11,35
392243,1,3,4,8,1,9,35
419118,1,3,4,2,0,2,18
419130,1,3,4,4,1,5,36
419142,1,3,4,6,0,6,37
419147,1,3,4,2,1,3,27
419152,1,3,4,12,1,13,34
419160,1,3,4,5,0,5,23
419168,1,3,4,2,0,2,27
419170,1,3,4,7,0,7,20
501203,1,3,4,6,2,8,26
501211,1,3,4,7,0,7,13
501216,1,3,4,5,0,5,18
501220,1,3,4,8,0,8,19
501231,1,3,4,9,0,9,29
501241,1,3,4,3,4,7,20
501250,1,3,4,1,1,2,9
501254,1,3,4,9,0,9,34
501258,1,3,4,2,0,2,27
501266,1,3,4,4,0,4,23
501271,1,3,4,4,1,5,17
501276,1,3,4,4,6,10,36
548311,1,3,4,13,0,13,28
548316,1,3,4,5,0,5,20
548321,1,3,4,0,2,2,28
548327,1,3,4,18,0,18,31
548335,1,3,4,8,0,8,17
548352,1,3,4,11,0,11,26
548357,1,3,4,9,0,9,26
548360,1,3,4,3,1,4,22
548376,1,3,4,1,0,1,18
548384,1,3,4,10,0,10,14
548385,1,3,4,6,0,6,31
548386,1,3,4,14,0,14,31
598025,1,3,4,10,0,10,25
598039,1,3,4,14,1,15,40
598043,1,3,4,3,0,3,10
598046,1,3,4,5,0,5,27
598056,1,3,4,13,0,13,26
598063,1,3,4,4,2,6,22
598067,1,3,4,8,1,9,20
598075,1,3,4,2,0,2,29
729288,1,3,4,6,2,8,41
729298,1,3,4,2,0,2,25
729302,1,3,4,2,0,2,20
733976,1,3,4,9,0,9,29
734018,1,3,4,3,1,4,25
734028,1,3,4,16,0,16,27
734034,1,3,4,2,0,2,34
829712,1,3,4,1,1,2,38
829716,1,3,4,9,1,10,34
829728,1,3,4,12,1,13,52
829740,1,3,4,11,0,11,28
829750,1,3,4,12,0,12,29
829758,1,3,4,11,0,11,47
829770,1,3,4,14,1,15,38
829784,1,3,4,5,0,5,22
829794,1,3,4,7,0,7,30
829802,1,3,4,1,1,2,17
829806,1,3,4,5,0,5,11
335998,2,3,4,5,2,7,25
336014,2,3,4,6,0,6,34
336030,2,3,4,3,0,3,30
336034,2,3,4,13,0,13,40
336038,2,3,4,6,0,6,40
336042,2,3,4,12,1,13,35
336044,2,3,4,9,0,9,25
392186,2,3,4,1,0,1,19
392194,2,3,4,10,4,14,44
392207,2,3,4,0,0,0,14
392222,2,3,4,4,0,4,23
392232,2,3,4,6,0,6,24
419115,2,3,4,9,0,9,31
419121,2,3,4,9,0,9,32
419126,2,3,4,10,1,11,25
419128,2,3,4,2,1,3,21
419134,2,3,4,8,0,8,26
419138,2,3,4,3,0,3,41
419158,2,3,4,11,0,11,45
419164,2,3,4,13,0,13,26
501226,2,3,4,13,0,13,35
501233,2,3,4,6,2,8,19
501245,2,3,4,10,0,10,26
501273,2,3,4,2,1,3,16
548323,2,3,4,10,1,11,25
548337,2,3,4,6,0,6,29
548348,2,3,4,11,0,11,31
548366,2,3,4,12,1,13,28
548369,2,3,4,10,0,10,25
548373,2,3,4,2,0,2,32
598007,2,3,4,15,1,16,30
598012,2,3,4,10,0,10,24
598017,2,3,4,4,0,4,10
598020,2,3,4,12,0,12,22
598027,2,3,4,5,0,5,22
598031,2,3,4,13,1,14,38
598035,2,3,4,14,1,15,42
598051,2,3,4,8,0,8,18
598073,2,3,4,10,0,10,29
598078,2,3,4,10,0,10,22
729308,2,3,4,17,0,17,32
729316,2,3,4,5,0,5,25
733986,2,3,4,18,0,18,41
733992,2,3,4,8,0,8,21
734000,2,3,4,11,2,13,29
734008,2,3,4,11,1,12,40
734040,2,3,4,17,1,18,53
734050,2,3,4,18,0,18,38
734052,2,3,4,19,1,20,56
829734,2,3,4,19,2,21,50
829778,2,3,4,14,1,15,37
829814,2,3,4,10,1,11,28
829822,2,3,4,10,0,10,33
829826,2,3,4,2,0,2,23
829828,2,3,4,5,1,6,21
335992,1,4,4,8,0,8,24
335996,1,4,4,10,0,10,25
336008,1,4,4,8,1,9,32
336024,1,4,4,9,1,10,35
336033,1,4,4,11,0,11,20
336040,1,4,4,2,1,3,27
336044,1,4,4,12,0,12,28
392188,1,4,4,10,0,10,41
392191,1,4,4,7,0,7,22
392200,1,4,4,9,0,9,21
392205,1,4,4,8,0,8,18
392227,1,4,4,7,2,9,31
392234,1,4,4,11,0,11,26
419113,1,4,4,18,0,18,33
419117,1,4,4,7,1,8,26
419126,1,4,4,3,0,3,21
419137,1,4,4,9,0,9,34
419141,1,4,4,13,0,13,30
419148,1,4,4,1,1,2,30
419161,1,4,4,8,0,8,24
419164,1,4,4,2,0,2,36
501207,1,4,4,8,0,8,17
501225,1,4,4,15,0,15,67
501239,1,4,4,5,0,5,27
501253,1,4,4,2,1,3,25
501256,1,4,4,4,0,4,22
501262,1,4,4,7,0,7,19
501265,1,4,4,6,2,8,25
548328,1,4,4,2,2,4,21
548333,1,4,4,5,0,5,29
548336,1,4,4,5,0,5,20
548344,1,4,4,3,0,3,26
548348,1,4,4,5,0,5,30
548364,1,4,4,8,0,8,38
548374,1,4,4,2,0,2,26
548379,1,4,4,2,0,2,17
598012,1,4,4,11,0,11,31
598019,1,4,4,0,0,0,10
598021,1,4,4,4,0,4,25
598026,1,4,4,1,0,1,17
598033,1,4,4,10,0,10,34
598036,1,4,4,8,0,8,23
598057,1,4,4,13,0,13,24
598071,1,4,4,5,0,5,16
729300,1,4,4,7,0,7,26
729312,1,4,4,13,0,13,28
733978,1,4,4,8,1,9,29
733992,1,4,4,9,1,10,32
733996,1,4,4,9,0,9,35
734002,1,4,4,5,0,5,35
734030,1,4,4,9,0,9,33
734038,1,4,4,11,0,11,37
734052,1,4,4,23,1,24,43
734054,1,4,4,3,0,3,24
829722,1,4,4,5,1,6,38
829730,1,4,4,6,2,8,24
829738,1,4,4,5,0,5,23
829772,1,4,4,1,0,1,11
829796,1,4,4,4,0,4,32
829808,1,4,4,11,0,11,49
829814,1,4,4,7,0,7,31
980910,1,4,4,11,0,11,31
980918,1,4,4,5,0,5,17
980930,1,4,4,9,0,9,26
980940,1,4,4,1,1,2,21
980960,1,4,4,8,0,8,34
980976,1,4,4,8,4,12,36
980996,1,4,4,11,0,11,33
981010,1,4,4,8,0,8,25
1082601,1,4,4,14,1,15,45
1082612,1,4,4,6,0,6,32
1082616,1,4,4,2,1,3,25
1082633,1,4,4,4,0,4,19
1082637,1,4,4,6,2,8,21
1082639,1,4,4,9,0,9,28
1082641,1,4,4,17,2,19,51
1082645,1,4,4,4,0,4,23
335988,2,4,4,10,0,10,37
336000,2,4,4,13,0,13,34
336004,2,4,4,5,0,5,33
336011,2,4,4,9,1,10,32
336018,2,4,4,8,0,8,29
336021,2,4,4,8,0,8,25
336027,2,4,4,4,0,4,34
336036,2,4,4,15,0,15,50
392196,2,4,4,10,0,10,29
392209,2,4,4,11,0,11,21
392212,2,4,4,22,0,22,35
392215,2,4,4,5,1,6,16
392219,2,4,4,4,1,5,28
392221,2,4,4,11,0,11,40
392231,2,4,4,10,3,13,31
392239,2,4,4,13,0,13,25
419122,2,4,4,6,1,7,18
419129,2,4,4,15,0,15,41
419132,2,4,4,13,0,13,23
419144,2,4,4,13,0,13,44
419151,2,4,4,10,0,10,41
419154,2,4,4,12,1,13,26
501211,2,4,4,13,0,13,38
501217,2,4,4,8,2,10,36
501228,2,4,4,0,0,0,25
501242,2,4,4,9,0,9,15
501249,2,4,4,7,0,7,27
501259,2,4,4,4,2,6,31
501269,2,4,4,3,0,3,25
548314,2,4,4,17,0,17,35
548318,2,4,4,2,0,2,11
548324,2,4,4,6,0,6,20
548339,2,4,4,6,0,6,32
548355,2,4,4,8,0,8,35
548359,2,4,4,8,1,9,22
548371,2,4,4,13,0,13,24
548376,2,4,4,6,0,6,32
598008,2,4,4,21,0,21,44
598030,2,4,4,10,0,10,36
598042,2,4,4,6,0,6,23
598046,2,4,4,7,0,7,23
598050,2,4,4,3,0,3,27
598061,2,4,4,5,0,5,22
598064,2,4,4,5,0,5,45
598069,2,4,4,7,1,8,21
729288,2,4,4,8,1,9,40
729296,2,4,4,5,0,5,17
729318,2,4,4,8,0,8,22
734012,2,4,4,16,0,16,55
734024,2,4,4,12,1,13,46
734044,2,4,4,1,0,1,17
734048,2,4,4,7,0,7,24
829714,2,4,4,7,0,7,39
829746,2,4,4,12,1,13,25
829758,2,4,4,7,0,7,28
829764,2,4,4,4,0,4,17
829780,2,4,4,5,0,5,33
829790,2,4,4,5,0,5,25
829804,2,4,4,11,0,11,37
980924,2,4,4,4,0,4,30
980946,2,4,4,7,0,7,28
980968,2,4,4,3,0,3,16
980982,2,4,4,10,1,11,36
980990,2,4,4,9,1,10,21
981004,2,4,4,13,0,13,44
1082594,2,4,4,11,0,11,38
1082598,2,4,4,17,0,17,43
1082605,2,4,4,9,0,9,26
1082609,2,4,4,4,1,5,22
1082623,2,4,4,9,0,9,37
1082626,2,4,4,11,0,11,28
335989,1,5,4,10,0,10,27
336005,1,5,4,5,0,5,26
336013,1,5,4,5,0,5,26
336028,1,5,4,2,2,4,34
336038,1,5,4,14,0,14,39
336043,1,5,4,14,0,14,29
392195,1,5,4,7,0,7,31
392215,1,5,4,11,0,11,37
392222,1,5,4,9,0,9,22
392230,1,5,4,7,0,7,27
392238,1,5,4,4,0,4,32
419116,1,5,4,6,0,6,31
419120,1,5,4,1,2,3,20
419123,1,5,4,8,1,9,36
419129,1,5,4,6,1,7,37
419134,1,5,4,17,0,17,47
419146,1,5,4,12,0,12,34
419159,1,5,4,0,0,0,21
419163,1,5,4,10,0,10,24
501214,1,5,4,3,0,3,25
501219,1,5,4,6,0,6,26
501245,1,5,4,5,1,6,22
501257,1,5,4,1,1,2,25
501263,1,5,4,3,0,3,21
548314,1,5,4,7,3,10,42
548317,1,5,4,6,1,7,22
548325,1,5,4,7,0,7,23
548329,1,5,4,15,0,15,26
548337,1,5,4,15,0,15,34
548354,1,5,4,4,0,4,38
548359,1,5,4,15,0,15,30
548366,1,5,4,1,0,1,20
548370,1,5,4,10,0,10,29
548378,1,5,4,6,0,6,19
548382,1,5,4,8,0,8,26
598006,1,5,4,5,5,10,32
598010,1,5,4,8,0,8,21
598014,1,5,4,9,1,10,30
598024,1,5,4,7,0,7,29
598028,1,5,4,4,0,4,14
598031,1,5,4,8,0,8,32
598048,1,5,4,6,0,6,26
598077,1,5,4,3,0,3,23
729296,1,5,4,10,0,10,32
729320,1,5,4,8,0,8,23
733984,1,5,4,12,0,12,33
734008,1,5,4,8,0,8,24
734016,1,5,4,7,0,7,27
734046,1,5,4,5,0,5,20
829714,1,5,4,2,0,2,17
829746,1,5,4,9,0,9,31
829754,1,5,4,13,0,13,30
829782,1,5,4,7,0,7,23
829816,1,5,4,12,0,12,43
335992,2,5,4,12,2,14,42
335995,2,5,4,15,1,16,35
335997,2,5,4,6,0,6,31
336010,2,5,4,9,1,10,24
336016,2,5,4,7,1,8,28
336020,2,5,4,1,2,3,14
336024,2,5,4,17,1,18,28
336032,2,5,4,7,0,7,26
336041,2,5,4,2,1,3,23
336045,2,5,4,8,0,8,27
392187,2,5,4,1,1,2,9
392200,2,5,4,8,0,8,23
392203,2,5,4,1,0,1,21
392207,2,5,4,4,0,4,18
392210,2,5,4,2,0,2,7
392218,2,5,4,3,0,3,15
392225,2,5,4,5,1,6,20
392235,2,5,4,1,3,4,14
419112,2,5,4,12,0,12,34
419131,2,5,4,16,4,20,39
419139,2,5,4,10,1,11,31
419142,2,5,4,2,4,6,29
419148,2,5,4,20,0,20,55
419155,2,5,4,6,0,6,17
501204,2,5,4,6,0,6,27
501209,2,5,4,14,1,15,41
501225,2,5,4,13,0,13,31
501230,2,5,4,2,1,3,23
501236,2,5,4,5,0,5,17
501240,2,5,4,2,0,2,29
501254,2,5,4,3,0,3,28
501268,2,5,4,8,0,8,32
548322,2,5,4,11,0,11,23
548331,2,5,4,14,0,14,39
548341,2,5,4,5,1,6,31
548350,2,5,4,2,0,2,24
548363,2,5,4,8,0,8,29
598019,2,5,4,10,2,12,35
598037,2,5,4,5,1,6,13
598041,2,5,4,11,0,11,32
598052,2,5,4,13,1,14,33
598054,2,5,4,4,5,9,27
598057,2,5,4,8,0,8,20
598063,2,5,4,4,0,4,18
598068,2,5,4,4,0,4,22
598070,2,5,4,1,0,1,17
598076,2,5,4,10,0,10,25
729290,2,5,4,4,2,6,19
729302,2,5,4,10,0,10,23
729310,2,5,4,4,0,4,28
733980,2,5,4,5,1,6,27
733994,2,5,4,11,0,11,27
734004,2,5,4,6,1,7,31
734022,2,5,4,11,0,11,38
734038,2,5,4,4,1,5,28
829720,2,5,4,12,0,12,35
829726,2,5,4,9,0,9,24
829732,2,5,4,7,1,8,22
829740,2,5,4,13,0,13,32
829774,2,5,4,9,0,9,39
829792,2,5,4,9,0,9,30
829802,2,5,4,9,0,9,21
829824,2,5,4,9,0,9,30
336000,1,6,4,11,1,12,29
336003,1,6,4,16,2,18,45
336014,1,6,4,9,0,9,39
336020,1,6,4,6,0,6,29
336025,1,6,4,18,2,20,34
336027,1,6,4,9,0,9,33
392194,1,6,4,15,0,15,29
392203,1,6,4,5,1,6,31
392228,1,6,4,8,0,8,26
392231,1,6,4,3,0,3,22
392235,1,6,4,4,0,4,19
392237,1,6,4,2,0,2,16
392242,1,6,4,9,1,10,33
419121,1,6,4,8,0,8,36
419133,1,6,4,8,1,9,48
419136,1,6,4,7,0,7,45
419139,1,6,4,7,1,8,32
419145,1,6,4,10,0,10,35
419154,1,6,4,12,0,12,41
501206,1,6,4,0,0,0,23
501209,1,6,4,5,2,7,23
501228,1,6,4,9,0,9,35
501232,1,6,4,4,1,5,29
501238,1,6,4,6,2,8,19
501243,1,6,4,6,0,6,27
501270,1,6,4,9,0,9,25
548347,1,6,4,11,0,11,34
548350,1,6,4,5,0,5,24
548362,1,6,4,7,0,7,41
548369,1,6,4,3,0,3,21
598003,1,6,4,8,0,8,34
598015,1,6,4,9,0,9,25
598022,1,6,4,13,0,13,34
598040,1,6,4,2,1,3,20
598049,1,6,4,5,3,8,20
598054,1,6,4,2,0,2,24
598064,1,6,4,0,0,0,22
729286,1,6,4,2,0,2,17
733980,1,6,4,11,0,11,33
733986,1,6,4,17,0,17,34
733990,1,6,4,2,0,2,20
733998,1,6,4,9,0,9,23
734024,1,6,4,18,0,18,37
734044,1,6,4,9,0,9,30
829720,1,6,4,18,0,18,44
829736,1,6,4,6,0,6,26
829744,1,6,4,10,0,10,22
829752,1,6,4,14,0,14,35
829762,1,6,4,12,1,13,30
829788,1,6,4,14,0,14,29
829818,1,6,4,16,0,16,34
980908,1,6,4,1,0,1,26
980938,1,6,4,12,0,12,28
980956,1,6,4,7,0,7,30
980970,1,6,4,10,0,10,27
981002,1,6,4,11,0,11,15
981016,1,6,4,12,0,12,33
1082599,1,6,4,9,1,10,39
1082605,1,6,4,5,0,5,27
1082608,1,6,4,5,0,5,41
1082622,1,6,4,10,0,10,41
1082626,1,6,4,6,0,6,13
1082642,1,6,4,15,0,15,26
335989,2,6,4,10,0,10,36
335993,2,6,4,2,0,2,32
336006,2,6,4,12,0,12,43
336009,2,6,4,16,0,16,22
336022,2,6,4,9,1,10,28
336031,2,6,4,14,0,14,45
336037,2,6,4,3,0,3,38
336043,2,6,4,1,0,1,23
392188,2,6,4,5,0,5,46
392199,2,6,4,11,0,11,31
392206,2,6,4,3,0,3,31
392211,2,6,4,1,1,2,22
392216,2,6,4,10,0,10,38
392220,2,6,4,3,0,3,23
392224,2,6,4,7,6,13,30
392240,2,6,4,11,0,11,41
419113,2,6,4,5,0,5,27
419116,2,6,4,3,0,3,43
419119,2,6,4,5,0,5,38
419125,2,6,4,3,0,3,35
419149,2,6,4,5,1,6,23
419157,2,6,4,13,0,13,44
419160,2,6,4,4,2,6,18
419165,2,6,4,12,0,12,33
501218,2,6,4,11,0,11,35
501221,2,6,4,1,0,1,28
501235,2,6,4,12,0,12,28
501248,2,6,4,5,0,5,16
501251,2,6,4,5,0,5,12
501258,2,6,4,6,0,6,40
501262,2,6,4,1,2,3,18
548312,2,6,4,8,0,8,34
548315,2,6,4,2,0,2,32
548321,2,6,4,2,0,2,33
548326,2,6,4,6,0,6,20
548330,2,6,4,4,0,4,22
548334,2,6,4,13,0,13,42
548338,2,6,4,2,0,2,16
548342,2,6,4,12,0,12,34
548354,2,6,4,7,0,7,35
548374,2,6,4,4,0,4,32
548377,2,6,4,15,0,15,39
548379,2,6,4,7,0,7,28
548383,2,6,4,14,1,15,40
548385,2,6,4,6,0,6,27
598006,2,6,4,1,0,1,23
598011,2,6,4,10,0,10,27
598025,2,6,4,3,1,4,26
598029,2,6,4,17,0,17,34
598033,2,6,4,0,0,0,12
598045,2,6,4,8,0,8,27
598059,2,6,4,5,1,6,31
598067,2,6,4,11,0,11,28
598072,2,6,4,4,0,4,37
729294,2,6,4,8,0,8,39
729298,2,6,4,6,0,6,17
729306,2,6,4,9,0,9,29
729314,2,6,4,8,0,8,22
734010,2,6,4,7,1,8,26
734016,2,6,4,4,0,4,29
734036,2,6,4,9,0,9,33
829712,2,6,4,12,1,13,33
829730,2,6,4,7,0,7,31
829766,2,6,4,8,1,9,24
829772,2,6,4,2,1,3,26
829782,2,6,4,0,1,1,32
829798,2,6,4,6,0,6,21
829806,2,6,4,8,0,8,24
980918,2,6,4,3,0,3,12
980926,2,6,4,8,1,9,42
980950,2,6,4,9,0,9,16
980966,2,6,4,9,1,10,41
980976,2,6,4,7,0,7,23
980988,2,6,4,12,0,12,32
980998,2,6,4,19,0,19,40
981008,2,6,4,7,1,8,22
1082595,2,6,4,11,0,11,32
1082611,2,6,4,8,0,8,32
1082614,2,6,4,1,1,2,21
1082630,2,6,4,12,0,12,40
1082632,2,6,4,15,1,16,41
1082635,2,6,4,6,0,6,26
1082640,2,6,4,10,0,10,32
1082646,2,6,4,8,0,8,25
335990,1,7,4,3,0,3,22
335999,1,7,4,3,0,3,18
336009,1,7,4,8,1,9,26
336029,1,7,4,5,0,5,44
336037,1,7,4,15,0,15,40
336041,1,7,4,1,0,1,16
392186,1,7,4,7,0,7,27
392202,1,7,4,12,0,12,38
392208,1,7,4,4,2,6,24
392213,1,7,4,0,0,0,21
392220,1,7,4,4,1,5,16
392223,1,7,4,7,0,7,29
392232,1,7,4,8,0,8,16
392240,1,7,4,3,1,4,27
419112,1,7,4,4,1,5,41
419119,1,7,4,17,0,17,46
419124,1,7,4,13,1,14,32
419135,1,7,4,8,3,11,30
419143,1,7,4,11,0,11,39
419151,1,7,4,15,0,15,31
419155,1,7,4,10,0,10,34
419157,1,7,4,8,4,12,34
419162,1,7,4,5,0,5,21
419166,1,7,4,7,1,8,22
419167,1,7,4,7,1,8,31
501215,1,7,4,10,0,10,31
501226,1,7,4,11,0,11,21
501229,1,7,4,11,0,11,36
501236,1,7,4,6,0,6,28
501242,1,7,4,5,0,5,19
501246,1,7,4,4,1,5,24
501251,1,7,4,5,1,6,41
501268,1,7,4,2,1,3,17
548322,1,7,4,7,0,7,33
548330,1,7,4,2,0,2,7
548339,1,7,4,11,0,11,22
548356,1,7,4,13,0,13,24
548365,1,7,4,2,0,2,5
548368,1,7,4,11,0,11,29
598007,1,7,4,5,1,6,23
598011,1,7,4,4,2,6,20
598016,1,7,4,7,0,7,35
598029,1,7,4,5,0,5,12
598038,1,7,4,3,0,3,31
598042,1,7,4,3,0,3,16
598044,1,7,4,10,2,12,31
598051,1,7,4,4,0,4,15
598055,1,7,4,20,0,20,33
598068,1,7,4,1,1,2,27
598078,1,7,4,2,0,2,18
729292,1,7,4,2,2,4,21
729308,1,7,4,5,0,5,25
729314,1,7,4,4,1,5,21
733988,1,7,4,7,0,7,32
734000,1,7,4,1,1,2,18
734014,1,7,4,9,0,9,32
734022,1,7,4,6,1,7,21
734036,1,7,4,11,1,12,36
734050,1,7,4,6,0,6,23
829710,1,7,4,7,0,7,28
829726,1,7,4,4,0,4,26
829734,1,7,4,4,1,5,13
829742,1,7,4,12,1,13,36
829756,1,7,4,7,0,7,30
829774,1,7,4,11,1,12,38
829780,1,7,4,5,1,6,28
829810,1,7,4,9,0,9,25
829822,1,7,4,6,1,7,22
829828,1,7,4,11,1,12,40
980906,1,7,4,8,1,9,29
980922,1,7,4,0,0,0,19
980928,1,7,4,8,3,11,23
980946,1,7,4,5,0,5,18
980990,1,7,4,4,0,4,12
980998,1,7,4,14,0,14,31
981012,1,7,4,12,0,12,37
1082592,1,7,4,13,0,13,41
1082614,1,7,4,7,1,8,37
1082635,1,7,4,13,0,13,31
1082638,1,7,4,2,0,2,22
1082644,1,7,4,10,4,14,32
1082650,1,7,4,2,0,2,11
335994,2,7,4,5,1,6,31
335996,2,7,4,2,1,3,21
336002,2,7,4,8,0,8,25
336013,2,7,4,12,1,13,21
336017,2,7,4,3,2,5,22
336023,2,7,4,12,2,14,37
336026,2,7,4,4,0,4,48
336033,2,7,4,3,1,4,40
392197,2,7,4,10,1,11,23
392202,2,7,4,6,1,7,24
392205,2,7,4,4,0,4,12
392217,2,7,4,8,1,9,20
392227,2,7,4,5,0,5,14
392230,2,7,4,6,0,6,19
419119,2,7,4,5,0,5,43
419127,2,7,4,13,1,14,45
419130,2,7,4,8,0,8,34
419137,2,7,4,9,1,10,29
419147,2,7,4,6,2,8,31
419170,2,7,4,2,0,2,11
501206,2,7,4,5,1,6,19
501210,2,7,4,7,0,7,33
501223,2,7,4,8,0,8,20
501256,2,7,4,7,1,8,27
501261,2,7,4,7,1,8,19
501272,2,7,4,9,0,9,33
501274,2,7,4,10,0,10,34
501275,2,7,4,6,0,6,28
548311,2,7,4,10,1,11,34
548313,2,7,4,4,0,4,11
548319,2,7,4,0,0,0,10
548344,2,7,4,7,0,7,26
548347,2,7,4,10,1,11,30
548351,2,7,4,9,1,10,19
548360,2,7,4,12,0,12,26
548372,2,7,4,9,0,9,24
548375,2,7,4,6,0,6,14
548382,2,7,4,6,0,6,27
548384,2,7,4,14,0,14,41
598004,2,7,4,12,0,12,23
598024,2,7,4,5,1,6,16
598034,2,7,4,15,0,15,28
598060,2,7,4,7,0,7,24
598065,2,7,4,7,0,7,30
598071,2,7,4,9,0,9,27
598075,2,7,4,7,3,10,27
598077,2,7,4,11,0,11,32
729284,2,7,4,1,0,1,17
729322,2,7,4,0,1,1,13
733978,2,7,4,7,0,7,30
734006,2,7,4,7,0,7,16
734030,2,7,4,13,1,14,43
734046,2,7,4,18,1,19,53
829722,2,7,4,2,1,3,16
829752,2,7,4,14,0,14,35
829788,2,7,4,11,0,11,25
829794,2,7,4,12,0,12,35
829800,2,7,4,4,0,4,29
829820,2,7,4,10,0,10,31
980914,2,7,4,8,2,10,37
980932,2,7,4,10,0,10,24
980938,2,7,4,13,0,13,45
980952,2,7,4,10,1,11,37
980962,2,7,4,14,1,15,39
980978,2,7,4,10,0,10,30
980986,2,7,4,7,0,7,23
1082597,2,7,4,10,2,12,37
1082600,2,7,4,11,0,11,39
1082602,2,7,4,2,0,2,10
1082606,2,7,4,7,0,7,32
1082612,2,7,4,17,0,17,51
1082618,2,7,4,8,0,8,35
1082625,2,7,4,3,0,3,43
1082628,2,7,4,4,0,4,36
1082641,2,7,4,7,1,8,37
1082647,2,7,4,8,2,10,29
1082649,2,7,4,6,0,6,30
335991,1,8,4,0,0,0,21
335993,1,8,4,1,0,1,16
335995,1,8,4,1,0,1,33
336004,1,8,4,3,1,4,30
336007,1,8,4,2,1,3,22
336016,1,8,4,4,0,4,29
336036,1,8,4,10,0,10,35
336042,1,8,4,2,0,2,15
392193,1,8,4,8,4,12,47
392197,1,8,4,12,2,14,36
392206,1,8,4,4,0,4,26
392210,1,8,4,6,1,7,34
392217,1,8,4,8,0,8,21
392221,1,8,4,6,0,6,31
392225,1,8,4,9,0,9,28
392244,1,8,4,3,0,3,18
419115,1,8,4,6,0,6,47
419122,1,8,4,3,0,3,46
419125,1,8,4,10,0,10,34
419131,1,8,4,11,0,11,34
419156,1,8,4,4,0,4,20
419165,1,8,4,13,1,14,32
419169,1,8,4,1,0,1,15
501204,1,8,4,3,0,3,30
501213,1,8,4,5,1,6,26
501217,1,8,4,10,0,10,28
501221,1,8,4,9,1,10,30
501234,1,8,4,4,3,7,17
501248,1,8,4,5,0,5,24
501255,1,8,4,8,1,9,29
501261,1,8,4,8,1,9,14
501269,1,8,4,10,0,10,34
548319,1,8,4,9,0,9,18
548326,1,8,4,14,0,14,26
548331,1,8,4,6,7,13,39
548334,1,8,4,5,0,5,24
548340,1,8,4,9,0,9,30
548346,1,8,4,10,0,10,39
548351,1,8,4,9,0,9,29
548353,1,8,4,6,1,7,21
548361,1,8,4,6,1,7,31
548371,1,8,4,6,0,6,33
548381,1,8,4,3,1,4,20
335999,2,8,4,8,0,8,37
336012,2,8,4,8,1,9,24
336019,2,8,4,9,1,10,27
336025,2,8,4,16,1,17,44
336029,2,8,4,2,0,2,20
336039,2,8,4,9,0,9,26
392189,2,8,4,6,0,6,30
392201,2,8,4,12,0,12,60
392214,2,8,4,8,0,8,15
392228,2,8,4,7,0,7,40
392233,2,8,4,10,1,11,40
392234,2,8,4,4,0,4,34
392241,2,8,4,6,1,7,23
392242,2,8,4,14,1,15,56
419111,2,8,4,9,0,9,40
419135,2,8,4,8,1,9,35
419140,2,8,4,9,0,9,41
419143,2,8,4,10,0,10,30
419146,2,8,4,1,0,1,30
419150,2,8,4,6,1,7,22
419152,2,8,4,15,1,16,32
419161,2,8,4,10,0,10,33
419168,2,8,4,7,0,7,17
501208,2,8,4,3,0,3,17
501229,2,8,4,6,0,6,31
501241,2,8,4,5,1,6,44
501244,2,8,4,10,0,10,31
501264,2,8,4,6,6,12,30
548316,2,8,4,9,2,11,32
548357,2,8,4,8,0,8,25
548364,2,8,4,4,1,5,21
548378,2,8,4,8,0,8,34
501205,1,9,4,7,0,7,34
501212,1,9,4,9,0,9,22
501224,1,9,4,7,0,7,33
501230,1,9,4,6,0,6,28
501247,1,9,4,6,0,6,23
501252,1,9,4,8,0,8,29
501259,1,9,4,4,1,5,35
501215,2,9,4,5,0,5,30
501220,2,9,4,9,0,9,29
501234,2,9,4,5,0,5,11
501238,2,9,4,8,1,9,27
501243,2,9,4,21,2,23,53
501263,2,9,4,14,0,14,59
501266,2,9,4,12,1,13,27
501218,1,10,4,6,1,7,28
501223,1,10,4,0,1,1,17
501233,1,10,4,0,0,0,22
501240,1,10,4,3,0,3,27
501264,1,10,4,6,0,6,31
501267,1,10,4,1,0,1,18
548313,1,10,4,10,1,11,20
548318,1,10,4,7,0,7,28
548324,1,10,4,8,1,9,27
548332,1,10,4,6,1,7,37
548338,1,10,4,12,1,13,27
548342,1,10,4,7,0,7,14
548363,1,10,4,7,0,7,22
598008,1,10,4,4,1,5,18
598020,1,10,4,9,0,9,32
598030,1,10,4,9,0,9,37
598052,1,10,4,12,1,13,43
598060,1,10,4,4,0,4,18
598066,1,10,4,4,0,4,34
598072,1,10,4,7,0,7,32
501207,2,10,4,9,1,10,27
501212,2,10,4,3,1,4,31
501231,2,10,4,8,0,8,27
501237,2,10,4,3,0,3,30
501246,2,10,4,5,4,9,21
501253,2,10,4,9,0,9,30
501255,2,10,4,8,0,8,38
548327,2,10,4,11,1,12,43
548335,2,10,4,4,0,4,26
548346,2,10,4,10,1,11,30
548353,2,10,4,8,0,8,29
548356,2,10,4,1,0,1,20
548358,2,10,4,6,0,6,28
548367,2,10,4,12,0,12,26
548370,2,10,4,9,0,9,25
548380,2,10,4,8,0,8,21
598005,2,10,4,8,0,8,13
598014,2,10,4,20,1,21,51
598016,2,10,4,4,0,4,26
598023,2,10,4,10,0,10,38
598032,2,10,4,8,0,8,27
598040,2,10,4,7,0,7,25
598043,2,10,4,9,2,11,37
598047,2,10,4,4,1,5,25
598058,2,10,4,3,0,3,25
598005,1,11,4,2,1,3,21
598023,1,11,4,1,0,1,16
598035,1,11,4,11,4,15,28
598037,1,11,4,1,0,1,15
598053,1,11,4,8,0,8,25
598061,1,11,4,5,0,5,28
598065,1,11,4,3,0,3,39
598070,1,11,4,2,1,3,8
598076,1,11,4,6,0,6,12
729290,1,11,4,6,1,7,24
729306,1,11,4,10,0,10,32
729316,1,11,4,7,4,11,27
729322,1,11,4,10,0,10,31
733982,1,11,4,9,0,9,29
733994,1,11,4,8,1,9,37
734006,1,11,4,6,0,6,24
734012,1,11,4,3,2,5,23
734020,1,11,4,7,0,7,28
734042,1,11,4,13,0,13,37
829732,1,11,4,6,0,6,25
829748,1,11,4,10,0,10,30
829764,1,11,4,15,0,15,30
829778,1,11,4,12,0,12,47
829792,1,11,4,7,5,12,40
829798,1,11,4,5,1,6,31
829804,1,11,4,17,1,18,46
829812,1,11,4,5,1,6,33
829820,1,11,4,3,0,3,13
980920,1,11,4,7,0,7,26
980948,1,11,4,6,0,6,19
980958,1,11,4,7,0,7,28
980978,1,11,4,11,0,11,34
980984,1,11,4,1,0,1,19
980988,1,11,4,15,0,15,26
981008,1,11,4,15,0,15,32
981020,1,11,4,6,0,6,21
981024,1,11,4,6,0,6,27
1082591,1,11,4,4,0,4,33
1082600,1,11,4,4,0,4,17
1082609,1,11,4,3,0,3,21
1082611,1,11,4,10,0,10,28
1082615,1,11,4,8,0,8,28
1082623,1,11,4,11,0,11,33
1082627,1,11,4,17,0,17,52
1082630,1,11,4,15,0,15,40
1082648,1,11,4,4,1,5,25
598009,2,11,4,1,0,1,20
598015,2,11,4,8,0,8,15
598018,2,11,4,4,1,5,29
598026,2,11,4,5,0,5,16
598044,2,11,4,1,0,1,20
598049,2,11,4,7,0,7,30
598056,2,11,4,4,1,5,29
598074,2,11,4,7,1,8,25
729300,2,11,4,7,2,9,31
733998,2,11,4,13,0,13,37
734026,2,11,4,12,2,14,40
734034,2,11,4,5,0,5,39
829716,2,11,4,8,0,8,32
829724,2,11,4,2,0,2,43
829736,2,11,4,2,1,3,20
829756,2,11,4,18,0,18,39
829786,2,11,4,3,0,3,26
980912,2,11,4,3,0,3,38
980928,2,11,4,3,0,3,25
980934,2,11,4,18,0,18,48
980940,2,11,4,17,0,17,47
980972,2,11,4,5,0,5,31
980996,2,11,4,10,1,11,31
981014,2,11,4,7,0,7,29
981022,2,11,4,11,0,11,33
1082596,2,11,4,8,0,8,40
1082604,2,11,4,13,0,13,32
1082634,2,11,4,2,0,2,25
1082638,2,11,4,5,0,5,26
1082643,2,11,4,2,0,2,27
980916,1,12,4,5,0,5,28
980924,1,12,4,14,0,14,27
980944,1,12,4,7,0,7,24
980954,1,12,4,4,0,4,22
980962,1,12,4,14,0,14,36
980974,1,12,4,6,0,6,37
980994,1,12,4,5,0,5,24
1082594,1,12,4,13,0,13,20
1082603,1,12,4,12,0,12,35
1082607,1,12,4,13,0,13,41
1082618,1,12,4,6,0,6,31
1082620,1,12,4,4,1,5,30
1082624,1,12,4,6,0,6,24
1082634,1,12,4,7,0,7,19
1082647,1,12,4,5,0,5,24
980906,2,12,4,5,0,5,23
980936,2,12,4,5,0,5,23
980948,2,12,4,9,2,11,24
980970,2,12,4,12,0,12,28
980984,2,12,4,10,0,10,19
981002,2,12,4,1,1,2,32
981010,2,12,4,6,1,7,34
1082592,2,12,4,4,0,4,39
1082599,2,12,4,7,0,7,31
1082615,2,12,4,9,0,9,24
1082629,2,12,4,7,0,7,24
1082631,2,12,4,12,5,17,47
1082642,2,12,4,14,0,14,36
1082645,2,12,4,12,0,12,30
1082650,2,12,4,2,0,2,23
980934,1,13,4,2,0,2,26
980950,1,13,4,9,0,9,51
980966,1,13,4,6,1,7,24
980972,1,13,4,8,0,8,11
981018,1,13,4,1,0,1,10
981022,1,13,4,4,0,4,23
1082593,1,13,4,7,0,7,29
1082596,1,13,4,6,1,7,32
1082606,1,13,4,3,0,3,24
1082625,1,13,4,10,0,10,46
1082629,1,13,4,11,0,11,35
1082632,1,13,4,15,0,15,35
1082640,1,13,4,10,0,10,31
1082643,1,13,4,1,1,2,35
980910,2,13,4,13,0,13,36
980916,2,13,4,11,0,11,38
980922,2,13,4,8,1,9,29
980942,2,13,4,10,0,10,41
980954,2,13,4,14,1,15,48
980960,2,13,4,6,0,6,24
980980,2,13,4,6,5,11,34
980992,2,13,4,10,1,11,26
981006,2,13,4,11,0,11,39
981012,2,13,4,7,0,7,33
1082603,2,13,4,10,1,11,44
1082610,2,13,4,13,1,14,37
1082613,2,13,4,15,1,16,56
1082616,2,13,4,11,0,11,36
1082621,2,13,4,1,3,4,23
1082637,2,13,4,13,0,13,36
335987,1,1,5,10,0,10,60
335998,1,1,5,12,0,12,50
336002,1,1,5,5,0,5,38
336015,1,1,5,11,0,11,36
336019,1,1,5,5,0,5,33
336022,1,1,5,6,0,6,28
336026,1,1,5,1,0,1,22
336030,1,1,5,9,0,9,28
336032,1,1,5,10,0,10,24
392189,1,1,5,1,2,3,15
392204,1,1,5,7,0,7,44
392212,1,1,5,8,0,8,23
392216,1,1,5,6,0,6,48
392224,1,1,5,9,0,9,25
392226,1,1,5,10,0,10,27
392233,1,1,5,4,0,4,29
419111,1,1,5,7,2,9,31
419127,1,1,5,5,0,5,34
419132,1,1,5,11,1,12,45
419140,1,1,5,6,5,11,40
419144,1,1,5,15,0,15,46
419149,1,1,5,1,2,3,41
419153,1,1,5,21,0,21,51
419158,1,1,5,2,1,3,21
501208,1,1,5,7,1,8,34
501227,1,1,5,1,0,1,44
501235,1,1,5,6,0,6,34
501244,1,1,5,8,0,8,35
501260,1,1,5,4,0,4,26
501272,1,1,5,14,0,14,44
501274,1,1,5,3,0,3,19
548312,1,1,5,3,0,3,34
548320,1,1,5,12,0,12,47
548349,1,1,5,7,0,7,40
548358,1,1,5,13,4,17,49
548373,1,1,5,7,0,7,39
548375,1,1,5,3,0,3,25
548380,1,1,5,1,0,1,22
548383,1,1,5,8,0,8,36
598013,1,1,5,6,0,6,31
598018,1,1,5,10,1,11,42
598027,1,1,5,11,0,11,44
598034,1,1,5,6,0,6,54
598045,1,1,5,8,1,9,29
598058,1,1,5,9,0,9,44
598074,1,1,5,7,0,7,27
729284,1,1,5,6,2,8,28
729294,1,1,5,9,0,9,27
729304,1,1,5,9,1,10,38
734032,1,1,5,6,1,7,35
734048,1,1,5,11,0,11,42
829718,1,1,5,6,0,6,46
829766,1,1,5,2,0,2,39
829776,1,1,5,10,0,10,44
829786,1,1,5,9,0,9,45
980914,1,1,5,12,0,12,34
980952,1,1,5,9,1,10,48
980968,1,1,5,2,0,2,32
980980,1,1,5,0,0,0,21
981000,1,1,5,9,0,9,42
981006,1,1,5,2,0,2,36
981014,1,1,5,7,0,7,41
1082597,1,1,5,4,0,4,48
1082604,1,1,5,12,1,13,33
1082613,1,1,5,10,0,10,57
1082617,1,1,5,4,0,4,56
1082631,1,1,5,8,0,8,27
1082649,1,1,5,2,1,3,25
335991,2,1,5,2,0,2,23
336005,2,1,5,5,0,5,44
336008,2,1,5,4,0,4,29
336040,2,1,5,10,1,11,45
392191,2,1,5,16,1,17,47
392195,2,1,5,2,1,3,28
392202,2,1,5,15,0,15,39
392208,2,1,5,6,0,6,21
392236,2,1,5,1,0,1,34
392238,2,1,5,0,1,1,21
419114,2,1,5,16,0,16,52
419118,2,1,5,5,0,5,34
419123,2,1,5,10,0,10,37
419136,2,1,5,12,0,12,32
419163,2,1,5,7,1,8,38
419166,2,1,5,11,0,11,41
501203,2,1,5,5,0,5,44
501214,2,1,5,13,0,13,44
501219,2,1,5,4,0,4,23
501224,2,1,5,1,0,1,28
501239,2,1,5,6,0,6,40
501247,2,1,5,6,1,7,40
501250,2,1,5,6,0,6,31
501267,2,1,5,10,0,10,43
548317,2,1,5,10,0,10,23
548325,2,1,5,3,1,4,26
548328,2,1,5,5,3,8,41
548333,2,1,5,14,1,15,47
548340,2,1,5,5,1,6,32
548352,2,1,5,10,0,10,31
548362,2,1,5,13,0,13,50
548368,2,1,5,7,0,7,23
548386,2,1,5,5,0,5,41
598003,2,1,5,10,1,11,40
598010,2,1,5,10,0,10,36
598021,2,1,5,11,4,15,34
598036,2,1,5,8,0,8,36
598039,2,1,5,17,1,18,51
598048,2,1,5,5,0,5,40
598055,2,1,5,1,0,1,30
598062,2,1,5,5,0,5,27
598066,2,1,5,5,0,5,30
729312,2,1,5,0,0,0,19
729320,2,1,5,9,0,9,30
733976,2,1,5,3,0,3,38
733984,2,1,5,8,0,8,39
733990,2,1,5,10,2,12,42
734002,2,1,5,6,1,7,48
734014,2,1,5,9,0,9,40
734020,2,1,5,7,0,7,21
734028,2,1,5,9,0,9,45
734042,2,1,5,15,2,17,43
734054,2,1,5,8,0,8,48
829710,2,1,5,13,0,13,32
829728,2,1,5,3,0,3,36
829738,2,1,5,12,0,12,38
829744,2,1,5,4,0,4,35
829748,2,1,5,5,0,5,40
829770,2,1,5,10,0,10,52
829796,2,1,5,14,1,15,55
829810,2,1,5,8,1,9,38
829816,2,1,5,6,2,8,44
980908,2,1,5,6,0,6,42
980920,2,1,5,3,0,3,28
980930,2,1,5,10,1,11,55
980944,2,1,5,7,0,7,49
980956,2,1,5,5,0,5,33
980964,2,1,5,2,0,2,34
980994,2,1,5,3,6,9,66
981020,2,1,5,9,0,9,43
1082593,2,1,5,7,0,7,53
1082601,2,1,5,18,0,18,60
1082608,2,1,5,6,0,6,34
1082620,2,1,5,10,0,10,38
1082622,2,1,5,6,0,6,36
1082627,2,1,5,11,0,11,36
1082636,2,1,5,24,2,26,85
1082639,2,1,5,10,0,10,49
1082644,2,1,5,14,0,14,49
1082648,2,1,5,5,0,5,46
335997,1,2,5,13,0,13,42
336011,1,2,5,4,0,4,19
336017,1,2,5,7,0,7,34
336021,1,2,5,12,0,12,36
336031,1,2,5,5,1,6,35
336034,1,2,5,6,0,6,22
336039,1,2,5,6,1,7,39
392187,1,2,5,3,0,3,17
392196,1,2,5,8,0,8,47
392199,1,2,5,7,2,9,35
392209,1,2,5,0,0,0,27
392218,1,2,5,7,0,7,23
392241,1,2,5,6,0,6,31
419114,1,2,5,2,0,2,18
419128,1,2,5,8,2,10,29
419138,1,2,5,4,1,5,33
419150,1,2,5,13,1,14,39
501210,1,2,5,1,3,4,20
501237,1,2,5,3,0,3,40
501249,1,2,5,9,0,9,47
501273,1,2,5,8,1,9,39
501275,1,2,5,10,0,10,67
548315,1,2,5,2,2,4,41
548323,1,2,5,14,0,14,51
548341,1,2,5,0,2,2,27
548355,1,2,5,1,0,1,25
548367,1,2,5,11,1,12,41
548372,1,2,5,16,5,21,34
548377,1,2,5,8,1,9,39
598004,1,2,5,12,0,12,28
598009,1,2,5,10,0,10,33
598017,1,2,5,9,0,9,26
598032,1,2,5,28,0,28,61
598041,1,2,5,3,2,5,49
598047,1,2,5,3,0,3,23
598050,1,2,5,4,0,4,26
598059,1,2,5,9,0,9,32
598062,1,2,5,2,0,2,16
598069,1,2,5,18,0,18,41
598073,1,2,5,20,0,20,66
729310,1,2,5,4,0,4,16
729318,1,2,5,8,0,8,34
734004,1,2,5,7,0,7,22
734010,1,2,5,5,0,5,33
734026,1,2,5,3,0,3,23
734040,1,2,5,3,0,3,31
829724,1,2,5,10,1,11,39
829768,1,2,5,14,0,14,47
829790,1,2,5,6,1,7,58
829800,1,2,5,8,1,9,29
829824,1,2,5,9,1,10,38
829826,1,2,5,2,0,2,25
980912,1,2,5,16,0,16,43
980926,1,2,5,15,0,15,50
980932,1,2,5,9,0,9,41
980936,1,2,5,8,0,8,37
980942,1,2,5,11,0,11,38
980964,1,2,5,5,0,5,30
980982,1,2,5,5,0,5,49
980986,1,2,5,2,0,2,19
980992,1,2,5,11,1,12,27
981004,1,2,5,18,0,18,53
1082595,1,2,5,1,1,2,32
1082598,1,2,5,3,0,3,22
1082602,1,2,5,6,0,6,34
1082610,1,2,5,3,0,3,36
1082621,1,2,5,1,0,1,23
1082628,1,2,5,9,0,9,40
1082636,1,2,5,5,0,5,34
1082646,1,2,5,3,0,3,30
335987,2,2,5,8,0,8,24
335990,2,2,5,9,1,10,37
336001,2,2,5,12,0,12,32
336003,2,2,5,6,0,6,48
336007,2,2,5,5,1,6,36
336015,2,2,5,12,1,13,32
336028,2,2,5,2,1,3,18
392190,2,2,5,8,1,9,40
392193,2,2,5,4,2,6,25
392204,2,2,5,8,0,8,40
392213,2,2,5,10,0,10,51
392223,2,2,5,4,0,4,31
392226,2,2,5,8,1,9,36
392229,2,2,5,1,0,1,30
392237,2,2,5,3,0,3,19
392243,2,2,5,10,0,10,49
392244,2,2,5,12,0,12,33
419117,2,2,5,11,0,11,43
419120,2,2,5,8,0,8,52
419124,2,2,5,12,0,12,40
419133,2,2,5,4,0,4,37
419141,2,2,5,12,0,12,40
419145,2,2,5,10,0,10,36
419153,2,2,5,10,1,11,33
419156,2,2,5,4,1,5,32
419159,2,2,5,8,0,8,42
419162,2,2,5,8,0,8,30
419167,2,2,5,10,0,10,41
419169,2,2,5,5,0,5,26
501205,2,2,5,13,0,13,44
501213,2,2,5,5,0,5,27
501216,2,2,5,1,0,1,31
501227,2,2,5,14,0,14,46
501232,2,2,5,17,0,17,62
501252,2,2,5,3,2,5,72
501257,2,2,5,8,0,8,50
501260,2,2,5,7,1,8,58
501265,2,2,5,10,0,10,27
501271,2,2,5,3,0,3,34
501276,2,2,5,14,0,14,38
548320,2,2,5,6,0,6,20
548329,2,2,5,4,0,4,42
548332,2,2,5,5,0,5,40
548336,2,2,5,7,0,7,25
548349,2,2,5,1,0,1,32
548361,2,2,5,9,1,10,36
548365,2,2,5,5,0,5,27
548381,2,2,5,1,0,1,37
598013,2,2,5,2,0,2,21
598022,2,2,5,11,0,11,43
598028,2,2,5,10,5,15,46
598038,2,2,5,9,0,9,34
598053,2,2,5,15,0,15,39
729286,2,2,5,9,0,9,37
729292,2,2,5,7,0,7,24
729304,2,2,5,1,0,1,34
733982,2,2,5,16,0,16,32
733988,2,2,5,4,0,4,53
733996,2,2,5,5,0,5,22
734018,2,2,5,1,0,1,17
734032,2,2,5,12,1,13,30
829718,2,2,5,6,0,6,29
829742,2,2,5,10,0,10,26
829750,2,2,5,1,0,1,34
829754,2,2,5,1,0,1,37
829762,2,2,5,11,0,11,43
829776,2,2,5,3,0,3,52
829784,2,2,5,9,0,9,34
829808,2,2,5,8,2,10,49
829812,2,2,5,10,0,10,68
980958,2,2,5,5,0,5,42
980974,2,2,5,12,0,12,37
981000,2,2,5,9,0,9,53
981016,2,2,5,10,0,10,38
981018,2,2,5,3,0,3,28
981024,2,2,5,13,0,13,55
1082591,2,2,5,4,1,5,48
1082607,2,2,5,4,0,4,39
1082617,2,2,5,4,0,4,28
1082624,2,2,5,2,1,3,33
1082633,2,2,5,10,0,10,37
335988,1,3,5,8,1,9,42
335994,1,3,5,5,0,5,40
336001,1,3,5,3,0,3,25
336006,1,3,5,9,0,9,37
336010,1,3,5,14,0,14,30
336012,1,3,5,9,1,10,31
336018,1,3,5,10,1,11,38
336023,1,3,5,3,0,3,23
336045,1,3,5,10,0,10,39
392190,1,3,5,20,0,20,56
392201,1,3,5,17,0,17,55
392207,1,3,5,7,0,7,26
392211,1,3,5,7,1,8,36
392214,1,3,5,9,2,11,45
392219,1,3,5,10,0,10,45
392229,1,3,5,11,0,11,43
392236,1,3,5,7,0,7,42
392239,1,3,5,9,0,9,44
392243,1,3,5,11,0,11,46
419118,1,3,5,4,0,4,22
419130,1,3,5,2,0,2,38
419142,1,3,5,13,0,13,50
419147,1,3,5,8,0,8,35
419152,1,3,5,7,0,7,41
419160,1,3,5,8,3,11,34
419168,1,3,5,1,3,4,31
419170,1,3,5,9,0,9,29
501203,1,3,5,6,0,6,32
501211,1,3,5,13,1,14,27
501216,1,3,5,15,0,15,33
501220,1,3,5,13,0,13,32
501231,1,3,5,6,0,6,35
501241,1,3,5,6,0,6,26
501250,1,3,5,2,1,3,12
501254,1,3,5,13,0,13,47
501258,1,3,5,12,0,12,39
501266,1,3,5,1,0,1,24
501271,1,3,5,0,0,0,17
501276,1,3,5,12,0,12,48
548311,1,3,5,6,0,6,34
548316,1,3,5,18,0,18,38
548321,1,3,5,6,1,7,35
548327,1,3,5,8,0,8,39
548335,1,3,5,11,0,11,28
548352,1,3,5,6,0,6,32
548357,1,3,5,21,0,21,47
548360,1,3,5,23,1,24,46
548376,1,3,5,6,0,6,24
548384,1,3,5,8,0,8,22
548385,1,3,5,8,0,8,39
548386,1,3,5,4,0,4,35
598025,1,3,5,9,0,9,34
598039,1,3,5,9,0,9,49
598043,1,3,5,16,0,16,26
598046,1,3,5,5,0,5,32
598056,1,3,5,18,0,18,44
598063,1,3,5,4,0,4,26
598067,1,3,5,10,0,10,30
598075,1,3,5,9,1,10,39
729288,1,3,5,17,1,18,59
729298,1,3,5,5,0,5,30
729302,1,3,5,12,0,12,32
733976,1,3,5,4,0,4,33
734018,1,3,5,4,0,4,29
734028,1,3,5,6,0,6,33
734034,1,3,5,5,0,5,39
829712,1,3,5,11,0,11,49
829716,1,3,5,5,2,7,41
829728,1,3,5,12,0,12,64
829740,1,3,5,8,0,8,36
829750,1,3,5,8,1,9,38
829758,1,3,5,4,0,4,51
829770,1,3,5,10,0,10,48
829784,1,3,5,7,0,7,29
829794,1,3,5,14,0,14,44
829802,1,3,5,6,0,6,23
829806,1,3,5,5,0,5,16
335998,2,3,5,10,0,10,35
336014,2,3,5,7,1,8,42
336030,2,3,5,6,0,6,36
336034,2,3,5,2,0,2,42
336038,2,3,5,15,0,15,55
336042,2,3,5,5,1,6,41
336044,2,3,5,5,0,5,30
392186,2,3,5,13,1,14,33
392194,2,3,5,12,0,12,56
392207,2,3,5,8,0,8,26
392222,2,3,5,1,1,2,25
392232,2,3,5,10,0,10,34
419115,2,3,5,0,0,0,31
419121,2,3,5,18,0,18,50
419126,2,3,5,8,1,9,34
419128,2,3,5,1,0,1,22
419134,2,3,5,24,0,24,50
419138,2,3,5,5,1,6,47
419158,2,3,5,15,0,15,60
419164,2,3,5,10,1,11,37
501226,2,3,5,3,0,3,38
501233,2,3,5,0,0,0,19
501245,2,3,5,11,2,13,39
501273,2,3,5,8,0,8,24
548323,2,3,5,7,0,7,32
548337,2,3,5,11,0,11,40
548348,2,3,5,14,0,14,45
548366,2,3,5,2,0,2,30
548369,2,3,5,13,0,13,38
548373,2,3,5,12,0,12,44
598007,2,3,5,2,0,2,32
598012,2,3,5,7,0,7,31
598017,2,3,5,6,1,7,17
598020,2,3,5,3,0,3,25
598027,2,3,5,4,0,4,26
598031,2,3,5,7,0,7,45
598035,2,3,5,4,0,4,46
598051,2,3,5,3,0,3,21
598073,2,3,5,8,0,8,37
598078,2,3,5,7,0,7,29
729308,2,3,5,3,2,5,37
729316,2,3,5,11,0,11,36
733986,2,3,5,6,0,6,47
733992,2,3,5,13,0,13,34
734000,2,3,5,5,0,5,34
734008,2,3,5,2,0,2,42
734040,2,3,5,6,0,6,59
734050,2,3,5,5,0,5,43
734052,2,3,5,8,3,11,67
829734,2,3,5,21,1,22,72
829778,2,3,5,11,0,11,48
829814,2,3,5,12,0,12,40
829822,2,3,5,13,0,13,46
829826,2,3,5,5,0,5,28
829828,2,3,5,5,0,5,26
335992,1,4,5,14,0,14,38
335996,1,4,5,17,1,18,43
336008,1,4,5,11,1,12,44
336024,1,4,5,6,0,6,41
336033,1,4,5,10,0,10,30
336040,1,4,5,10,0,10,37
336044,1,4,5,2,0,2,30
392188,1,4,5,10,1,11,52
392191,1,4,5,14,0,14,36
392200,1,4,5,5,2,7,28
392205,1,4,5,4,1,5,23
392227,1,4,5,12,0,12,43
392234,1,4,5,7,0,7,33
419113,1,4,5,6,0,6,39
419117,1,4,5,7,2,9,35
419126,1,4,5,9,0,9,30
419137,1,4,5,3,4,7,41
419141,1,4,5,6,0,6,36
419148,1,4,5,12,0,12,42
419161,1,4,5,10,0,10,34
419164,1,4,5,7,0,7,43
501207,1,4,5,5,4,9,26
501225,1,4,5,6,0,6,73
501239,1,4,5,6,2,8,35
501253,1,4,5,4,0,4,29
501256,1,4,5,8,0,8,30
501262,1,4,5,8,2,10,29
501265,1,4,5,4,0,4,29
548328,1,4,5,3,0,3,24
548333,1,4,5,5,0,5,34
548336,1,4,5,7,0,7,27
548344,1,4,5,8,1,9,35
548348,1,4,5,8,0,8,38
548364,1,4,5,3,1,4,42
548374,1,4,5,12,0,12,38
548379,1,4,5,1,0,1,18
598012,1,4,5,7,0,7,38
598019,1,4,5,11,0,11,21
598021,1,4,5,4,0,4,29
598026,1,4,5,12,0,12,29
598033,1,4,5,2,0,2,36
598036,1,4,5,10,0,10,33
598057,1,4,5,4,0,4,28
598071,1,4,5,5,1,6,22
729300,1,4,5,12,0,12,38
729312,1,4,5,6,3,9,37
733978,1,4,5,2,0,2,31
733992,1,4,5,4,1,5,37
733996,1,4,5,9,1,10,45
734002,1,4,5,12,1,13,48
734030,1,4,5,1,0,1,34
734038,1,4,5,9,0,9,46
734052,1,4,5,13,1,14,57
734054,1,4,5,6,0,6,30
829722,1,4,5,8,0,8,46
829730,1,4,5,9,0,9,33
829738,1,4,5,14,0,14,37
829772,1,4,5,5,0,5,16
829796,1,4,5,9,0,9,41
829808,1,4,5,7,0,7,56
829814,1,4,5,4,0,4,35
980910,1,4,5,14,0,14,45
980918,1,4,5,6,0,6,23
980930,1,4,5,9,0,9,35
980940,1,4,5,14,0,14,35
980960,1,4,5,15,2,17,51
980976,1,4,5,4,0,4,40
980996,1,4,5,4,0,4,37
981010,1,4,5,12,3,15,40
1082601,1,4,5,1,7,8,53
1082612,1,4,5,7,0,7,39
1082616,1,4,5,10,1,11,36
1082633,1,4,5,10,0,10,29
1082637,1,4,5,8,0,8,29
1082639,1,4,5,10,1,11,39
1082641,1,4,5,9,0,9,60
1082645,1,4,5,6,0,6,29
335988,2,4,5,10,0,10,47
336000,2,4,5,9,0,9,43
336004,2,4,5,4,0,4,37
336011,2,4,5,12,0,12,44
336018,2,4,5,2,0,2,31
336021,2,4,5,8,0,8,33
336027,2,4,5,21,1,22,56
336036,2,4,5,13,0,13,63
392196,2,4,5,5,5,10,39
392209,2,4,5,7,0,7,28
392212,2,4,5,9,0,9,44
392215,2,4,5,9,0,9,25
392219,2,4,5,19,0,19,47
392221,2,4,5,1,1,2,42
392231,2,4,5,0,0,0,31
392239,2,4,5,1,0,1,26
419122,2,4,5,4,0,4,22
419129,2,4,5,18,0,18,59
419132,2,4,5,7,1,8,31
419144,2,4,5,8,0,8,52
419151,2,4,5,5,0,5,46
419154,2,4,5,6,0,6,32
501211,2,4,5,11,0,11,49
501217,2,4,5,22,1,23,59
501228,2,4,5,8,1,9,34
501242,2,4,5,2,1,3,18
501249,2,4,5,6,0,6,33
501259,2,4,5,4,0,4,35
501269,2,4,5,10,1,11,36
548314,2,4,5,4,1,5,40
548318,2,4,5,2,0,2,13
548324,2,4,5,8,0,8,28
548339,2,4,5,10,0,10,42
548355,2,4,5,9,0,9,44
548359,2,4,5,4,1,5,27
548371,2,4,5,3,1,4,28
548376,2,4,5,2,0,2,34
598008,2,4,5,10,0,10,54
598030,2,4,5,7,1,8,44
598042,2,4,5,15,0,15,38
598046,2,4,5,3,1,4,27
598050,2,4,5,6,0,6,33
598061,2,4,5,7,0,7,29
598064,2,4,5,6,0,6,51
598069,2,4,5,10,0,10,31
729288,2,4,5,12,0,12,52
729296,2,4,5,13,0,13,30
729318,2,4,5,9,0,9,31
734012,2,4,5,11,0,11,66
734024,2,4,5,8,1,9,55
734044,2,4,5,12,1,13,30
734048,2,4,5,15,0,15,39
829714,2,4,5,7,0,7,46
829746,2,4,5,8,0,8,33
829758,2,4,5,7,0,7,35
829764,2,4,5,4,0,4,21
829780,2,4,5,9,0,9,42
829790,2,4,5,4,0,4,29
829804,2,4,5,5,0,5,42
980924,2,4,5,13,0,13,43
980946,2,4,5,5,0,5,33
980968,2,4,5,11,0,11,27
980982,2,4,5,6,1,7,43
980990,2,4,5,5,0,5,26
981004,2,4,5,8,2,10,54
1082594,2,4,5,10,0,10,48
1082598,2,4,5,7,0,7,50
1082605,2,4,5,7,0,7,33
1082609,2,4,5,10,0,10,32
1082623,2,4,5,5,0,5,42
1082626,2,4,5,11,0,11,39
335989,1,5,5,6,0,6,33
336005,1,5,5,12,0,12,38
336013,1,5,5,5,0,5,31
336028,1,5,5,9,0,9,43
336038,1,5,5,13,0,13,52
336043,1,5,5,14,0,14,43
392195,1,5,5,9,0,9,40
392215,1,5,5,7,0,7,44
392222,1,5,5,3,0,3,25
392230,1,5,5,12,0,12,39
392238,1,5,5,6,0,6,38
419116,1,5,5,14,0,14,45
419120,1,5,5,7,0,7,27
419123,1,5,5,6,0,6,42
419129,1,5,5,12,0,12,49
419134,1,5,5,2,0,2,49
419146,1,5,5,3,0,3,37
419159,1,5,5,3,0,3,24
419163,1,5,5,8,0,8,32
501214,1,5,5,3,1,4,29
501219,1,5,5,2,0,2,28
501245,1,5,5,14,0,14,36
501257,1,5,5,7,0,7,32
501263,1,5,5,1,0,1,22
548314,1,5,5,6,0,6,48
548317,1,5,5,7,0,7,29
548325,1,5,5,10,0,10,33
548329,1,5,5,8,0,8,34
548337,1,5,5,2,0,2,36
548354,1,5,5,12,0,12,50
548359,1,5,5,14,1,15,45
548366,1,5,5,5,0,5,25
548370,1,5,5,5,0,5,34
548378,1,5,5,12,0,12,31
548382,1,5,5,5,0,5,31
598006,1,5,5,4,0,4,36
598010,1,5,5,6,0,6,27
598014,1,5,5,10,0,10,40
598024,1,5,5,12,1,13,42
598028,1,5,5,11,0,11,25
598031,1,5,5,15,1,16,48
598048,1,5,5,2,0,2,28
598077,1,5,5,9,1,10,33
729296,1,5,5,8,1,9,41
729320,1,5,5,2,0,2,25
733984,1,5,5,10,1,11,44
734008,1,5,5,1,0,1,25
734016,1,5,5,16,0,16,43
734046,1,5,5,9,1,10,30
829714,1,5,5,3,0,3,20
829746,1,5,5,1,2,3,34
829754,1,5,5,6,0,6,36
829782,1,5,5,13,0,13,36
829816,1,5,5,9,0,9,52
335992,2,5,5,5,1,6,48
335995,2,5,5,22,0,22,57
335997,2,5,5,7,1,8,39
336010,2,5,5,10,0,10,34
336016,2,5,5,5,0,5,33
336020,2,5,5,1,0,1,15
336024,2,5,5,1,0,1,29
336032,2,5,5,16,0,16,42
336041,2,5,5,8,1,9,32
336045,2,5,5,9,0,9,36
392187,2,5,5,3,1,4,13
392200,2,5,5,4,0,4,27
392203,2,5,5,10,0,10,31
392207,2,5,5,2,0,2,28
392210,2,5,5,13,0,13,20
392218,2,5,5,10,0,10,25
392225,2,5,5,5,0,5,25
392235,2,5,5,4,1,5,19
419112,2,5,5,4,0,4,38
419131,2,5,5,12,0,12,51
419139,2,5,5,2,0,2,33
419142,2,5,5,18,0,18,47
419148,2,5,5,9,1,10,65
419155,2,5,5,3,0,3,20
501204,2,5,5,1,1,2,29
501209,2,5,5,2,0,2,43
501225,2,5,5,6,1,7,38
501230,2,5,5,6,0,6,29
501236,2,5,5,0,0,0,17
501240,2,5,5,0,0,0,29
501254,2,5,5,10,0,10,38
501268,2,5,5,5,0,5,37
548322,2,5,5,12,0,12,35
548331,2,5,5,10,1,11,50
548341,2,5,5,4,0,4,35
548350,2,5,5,5,1,6,30
548363,2,5,5,12,0,12,41
598019,2,5,5,9,0,9,44
598037,2,5,5,7,1,8,21
598041,2,5,5,3,1,4,36
598052,2,5,5,7,0,7,40
598054,2,5,5,9,0,9,36
598057,2,5,5,11,0,11,31
598063,2,5,5,1,0,1,19
598068,2,5,5,5,0,5,27
598070,2,5,5,13,0,13,30
598076,2,5,5,3,0,3,28
729290,2,5,5,8,1,9,28
729302,2,5,5,14,0,14,37
729310,2,5,5,3,1,4,32
733980,2,5,5,4,0,4,31
733994,2,5,5,4,1,5,32
734004,2,5,5,6,1,7,38
734022,2,5,5,3,0,3,41
734038,2,5,5,3,0,3,31
829720,2,5,5,2,0,2,37
829726,2,5,5,9,0,9,33
829732,2,5,5,4,1,5,27
829740,2,5,5,10,0,10,42
829774,2,5,5,10,0,10,49
829792,2,5,5,5,0,5,35
829802,2,5,5,11,0,11,32
829824,2,5,5,4,0,4,34
336000,1,6,5,11,0,11,40
336003,1,6,5,8,0,8,53
336014,1,6,5,6,0,6,45
336020,1,6,5,8,2,10,39
336025,1,6,5,6,0,6,40
336027,1,6,5,12,1,13,46
392194,1,6,5,17,0,17,46
392203,1,6,5,5,0,5,36
392228,1,6,5,4,2,6,32
392231,1,6,5,0,5,5,27
392235,1,6,5,7,0,7,26
392237,1,6,5,12,0,12,28
392242,1,6,5,7,1,8,41
419121,1,6,5,13,1,14,50
419133,1,6,5,10,0,10,58
419136,1,6,5,11,0,11,56
419139,1,6,5,12,1,13,45
419145,1,6,5,12,1,13,48
419154,1,6,5,3,0,3,44
501206,1,6,5,4,0,4,27
501209,1,6,5,6,1,7,30
501228,1,6,5,16,1,17,52
501232,1,6,5,5,0,5,34
501238,1,6,5,12,0,12,31
501243,1,6,5,11,0,11,38
501270,1,6,5,1,1,2,27
548347,1,6,5,6,0,6,40
548350,1,6,5,9,2,11,35
548362,1,6,5,2,0,2,43
548369,1,6,5,2,1,3,24
598003,1,6,5,7,0,7,41
598015,1,6,5,3,0,3,28
598022,1,6,5,7,1,8,42
598040,1,6,5,4,0,4,24
598049,1,6,5,3,0,3,23
598054,1,6,5,17,0,17,41
598064,1,6,5,10,0,10,32
729286,1,6,5,0,0,0,17
733980,1,6,5,2,0,2,35
733986,1,6,5,3,0,3,37
733990,1,6,5,6,0,6,26
733998,1,6,5,13,1,14,37
734024,1,6,5,9,1,10,47
734044,1,6,5,13,0,13,43
829720,1,6,5,2,0,2,46
829736,1,6,5,1,1,2,28
829744,1,6,5,4,0,4,26
829752,1,6,5,8,0,8,43
829762,1,6,5,4,0,4,34
829788,1,6,5,14,0,14,43
829818,1,6,5,8,0,8,42
980908,1,6,5,8,1,9,35
980938,1,6,5,7,0,7,35
980956,1,6,5,2,0,2,32
980970,1,6,5,12,1,13,40
981002,1,6,5,10,0,10,25
981016,1,6,5,8,0,8,41
1082599,1,6,5,8,0,8,47
1082605,1,6,5,13,1,14,41
1082608,1,6,5,9,0,9,50
1082622,1,6,5,2,5,7,48
1082626,1,6,5,9,0,9,22
1082642,1,6,5,13,1,14,40
335989,2,6,5,12,0,12,48
335993,2,6,5,5,0,5,37
336006,2,6,5,11,0,11,54
336009,2,6,5,7,0,7,29
336022,2,6,5,4,0,4,32
336031,2,6,5,14,1,15,60
336037,2,6,5,12,0,12,50
336043,2,6,5,1,0,1,24
392188,2,6,5,11,1,12,58
392199,2,6,5,8,0,8,39
392206,2,6,5,4,0,4,35
392211,2,6,5,16,0,16,38
392216,2,6,5,11,0,11,49
392220,2,6,5,9,1,10,33
392224,2,6,5,15,0,15,45
392240,2,6,5,5,0,5,46
419113,2,6,5,1,2,3,30
419116,2,6,5,2,2,4,47
419119,2,6,5,4,0,4,47
419125,2,6,5,6,0,6,41
419149,2,6,5,15,1,16,39
419157,2,6,5,10,1,11,55
419160,2,6,5,4,4,8,26
419165,2,6,5,4,0,4,37
501218,2,6,5,17,0,17,52
501221,2,6,5,5,0,5,33
501235,2,6,5,6,0,6,34
501248,2,6,5,4,4,8,24
501251,2,6,5,1,0,1,13
501258,2,6,5,6,0,6,46
501262,2,6,5,7,0,7,25
548312,2,6,5,4,1,5,39
548315,2,6,5,8,0,8,40
548321,2,6,5,11,0,11,44
548326,2,6,5,6,1,7,27
548330,2,6,5,12,0,12,34
548334,2,6,5,2,0,2,44
548338,2,6,5,13,0,13,29
548342,2,6,5,12,0,12,46
548354,2,6,5,12,4,16,51
548374,2,6,5,4,0,4,36
548377,2,6,5,8,0,8,47
548379,2,6,5,6,0,6,34
548383,2,6,5,6,1,7,47
548385,2,6,5,7,1,8,35
598006,2,6,5,10,0,10,33
598011,2,6,5,15,0,15,42
598025,2,6,5,4,0,4,30
598029,2,6,5,17,0,17,51
598033,2,6,5,2,0,2,14
598045,2,6,5,5,0,5,32
598059,2,6,5,17,0,17,48
598067,2,6,5,6,0,6,34
598072,2,6,5,2,1,3,40
729294,2,6,5,4,0,4,43
729298,2,6,5,1,0,1,18
729306,2,6,5,8,0,8,37
729314,2,6,5,1,2,3,25
734010,2,6,5,5,5,10,36
734016,2,6,5,0,1,1,30
734036,2,6,5,10,0,10,43
829712,2,6,5,6,0,6,39
829730,2,6,5,9,0,9,40
829766,2,6,5,10,0,10,34
829772,2,6,5,7,0,7,33
829782,2,6,5,6,3,9,41
829798,2,6,5,12,1,13,34
829806,2,6,5,0,0,0,24
980918,2,6,5,7,1,8,20
980926,2,6,5,8,0,8,50
980950,2,6,5,3,0,3,19
980966,2,6,5,10,0,10,51
980976,2,6,5,11,1,12,35
980988,2,6,5,9,0,9,41
980998,2,6,5,7,0,7,47
981008,2,6,5,13,1,14,36
1082595,2,6,5,5,0,5,37
1082611,2,6,5,15,0,15,47
1082614,2,6,5,0,0,0,21
1082630,2,6,5,6,0,6,46
1082632,2,6,5,17,0,17,58
1082635,2,6,5,5,0,5,31
1082640,2,6,5,15,0,15,47
1082646,2,6,5,14,1,15,40
335990,1,7,5,18,1,19,41
335999,1,7,5,3,1,4,22
336009,1,7,5,9,0,9,35
336029,1,7,5,4,0,4,48
336037,1,7,5,3,0,3,43
336041,1,7,5,11,1,12,28
392186,1,7,5,8,0,8,35
392202,1,7,5,7,0,7,45
392208,1,7,5,7,0,7,31
392213,1,7,5,2,0,2,23
392220,1,7,5,9,0,9,25
392223,1,7,5,11,2,13,42
392232,1,7,5,16,2,18,34
392240,1,7,5,0,1,1,28
419112,1,7,5,8,3,11,52
419119,1,7,5,10,0,10,56
419124,1,7,5,5,0,5,37
419135,1,7,5,12,0,12,42
419143,1,7,5,8,0,8,47
419151,1,7,5,14,0,14,45
419155,1,7,5,6,1,7,41
419157,1,7,5,5,0,5,39
419162,1,7,5,6,2,8,29
419166,1,7,5,7,0,7,29
419167,1,7,5,7,1,8,39
501215,1,7,5,3,1,4,35
501226,1,7,5,10,0,10,31
501229,1,7,5,11,0,11,47
501236,1,7,5,1,0,1,29
501242,1,7,5,5,0,5,24
501246,1,7,5,11,0,11,35
501251,1,7,5,9,0,9,50
501268,1,7,5,3,0,3,20
548322,1,7,5,11,0,11,44
548330,1,7,5,9,0,9,16
548339,1,7,5,6,0,6,28
548356,1,7,5,3,1,4,28
548365,1,7,5,3,4,7,12
548368,1,7,5,14,0,14,43
598007,1,7,5,5,0,5,28
598011,1,7,5,1,1,2,22
598016,1,7,5,2,0,2,37
598029,1,7,5,6,0,6,18
598038,1,7,5,7,0,7,38
598042,1,7,5,11,1,12,28
598044,1,7,5,0,1,1,32
598051,1,7,5,5,1,6,21
598055,1,7,5,3,2,5,38
598068,1,7,5,8,0,8,35
598078,1,7,5,7,0,7,25
729292,1,7,5,9,1,10,31
729308,1,7,5,1,0,1,26
729314,1,7,5,10,0,10,31
733988,1,7,5,7,2,9,41
734000,1,7,5,14,0,14,32
734014,1,7,5,3,0,3,35
734022,1,7,5,13,0,13,34
734036,1,7,5,13,5,18,54
734050,1,7,5,10,1,11,34
829710,1,7,5,8,1,9,37
829726,1,7,5,1,0,1,27
829734,1,7,5,7,0,7,20
829742,1,7,5,9,0,9,45
829756,1,7,5,5,1,6,36
829774,1,7,5,5,0,5,43
829780,1,7,5,18,0,18,46
829810,1,7,5,9,0,9,34
829822,1,7,5,13,0,13,35
829828,1,7,5,6,1,7,47
980906,1,7,5,1,0,1,30
980922,1,7,5,5,2,7,26
980928,1,7,5,8,0,8,31
980946,1,7,5,7,0,7,25
980990,1,7,5,2,0,2,14
980998,1,7,5,2,0,2,33
981012,1,7,5,8,0,8,45
1082592,1,7,5,7,0,7,48
1082614,1,7,5,10,0,10,47
1082635,1,7,5,10,0,10,41
1082638,1,7,5,7,0,7,29
1082644,1,7,5,5,2,7,39
1082650,1,7,5,4,1,5,16
335994,2,7,5,19,0,19,50
335996,2,7,5,13,0,13,34
336002,2,7,5,4,0,4,29
336013,2,7,5,8,0,8,29
336017,2,7,5,8,6,14,36
336023,2,7,5,19,1,20,57
336026,2,7,5,3,2,5,53
336033,2,7,5,16,0,16,56
392197,2,7,5,19,0,19,42
392202,2,7,5,0,0,0,39
392205,2,7,5,0,1,1,13
392217,2,7,5,7,0,7,27
392227,2,7,5,21,0,21,35
392230,2,7,5,3,1,4,23
419119,2,7,5,2,0,2,49
419127,2,7,5,6,0,6,51
419130,2,7,5,14,2,16,50
419137,2,7,5,8,0,8,37
419147,2,7,5,7,0,7,38
419170,2,7,5,10,0,10,21
501206,2,7,5,2,1,3,22
501210,2,7,5,0,0,0,33
501223,2,7,5,7,0,7,27
501256,2,7,5,1,0,1,28
501261,2,7,5,5,0,5,24
501272,2,7,5,3,0,3,36
501274,2,7,5,16,1,17,51
501275,2,7,5,13,0,13,41
548311,2,7,5,3,0,3,37
548313,2,7,5,9,1,10,21
548319,2,7,5,5,0,5,15
548344,2,7,5,3,0,3,29
548347,2,7,5,6,0,6,36
548351,2,7,5,7,1,8,27
548360,2,7,5,12,0,12,38
548372,2,7,5,3,1,4,28
548375,2,7,5,6,0,6,20
548382,2,7,5,11,1,12,39
548384,2,7,5,6,0,6,47
598004,2,7,5,4,0,4,27
598024,2,7,5,6,2,8,24
598034,2,7,5,2,0,2,30
598060,2,7,5,2,0,2,26
598065,2,7,5,5,0,5,35
598071,2,7,5,7,3,10,37
598075,2,7,5,13,0,13,40
598077,2,7,5,4,0,4,36
729284,2,7,5,8,0,8,25
729322,2,7,5,11,0,11,24
733978,2,7,5,12,0,12,42
734006,2,7,5,16,0,16,32
734030,2,7,5,10,0,10,53
734046,2,7,5,7,1,8,61
829722,2,7,5,0,1,1,17
829752,2,7,5,3,0,3,38
829788,2,7,5,11,0,11,36
829794,2,7,5,15,0,15,50
829800,2,7,5,5,1,6,35
829820,2,7,5,5,1,6,37
980914,2,7,5,12,1,13,50
980932,2,7,5,18,1,19,43
980938,2,7,5,2,0,2,47
980952,2,7,5,8,0,8,45
980962,2,7,5,4,0,4,43
980978,2,7,5,1,0,1,31
980986,2,7,5,7,0,7,30
1082597,2,7,5,7,0,7,44
1082600,2,7,5,3,0,3,42
1082602,2,7,5,8,0,8,18
1082606,2,7,5,15,0,15,47
1082612,2,7,5,17,0,17,68
1082618,2,7,5,0,0,0,35
1082625,2,7,5,9,0,9,52
1082628,2,7,5,10,1,11,47
1082641,2,7,5,14,1,15,52
1082647,2,7,5,12,0,12,41
1082649,2,7,5,2,0,2,32
335991,1,8,5,2,0,2,23
335993,1,8,5,7,0,7,23
335995,1,8,5,15,0,15,48
336004,1,8,5,7,1,8,38
336007,1,8,5,11,1,12,34
336016,1,8,5,12,0,12,41
336036,1,8,5,4,0,4,39
336042,1,8,5,3,0,3,18
392193,1,8,5,2,0,2,49
392197,1,8,5,7,1,8,44
392206,1,8,5,4,0,4,30
392210,1,8,5,1,0,1,35
392217,1,8,5,14,1,15,36
392221,1,8,5,13,0,13,44
392225,1,8,5,4,0,4,32
392244,1,8,5,5,0,5,23
419115,1,8,5,6,2,8,55
419122,1,8,5,7,0,7,53
419125,1,8,5,10,0,10,44
419131,1,8,5,6,2,8,42
419156,1,8,5,6,2,8,28
419165,1,8,5,2,0,2,34
419169,1,8,5,4,1,5,20
501204,1,8,5,10,0,10,40
501213,1,8,5,7,1,8,34
501217,1,8,5,10,0,10,38
501221,1,8,5,4,2,6,36
501234,1,8,5,2,0,2,19
501248,1,8,5,6,0,6,30
501255,1,8,5,10,0,10,39
501261,1,8,5,9,0,9,23
501269,1,8,5,12,1,13,47
548319,1,8,5,9,0,9,27
548326,1,8,5,9,0,9,35
548331,1,8,5,10,0,10,49
548334,1,8,5,4,0,4,28
548340,1,8,5,4,1,5,35
548346,1,8,5,8,1,9,48
548351,1,8,5,7,0,7,36
548353,1,8,5,5,0,5,26
548361,1,8,5,8,0,8,39
548371,1,8,5,7,1,8,41
548381,1,8,5,1,0,1,21
335999,2,8,5,10,0,10,47
336012,2,8,5,6,0,6,30
336019,2,8,5,14,0,14,41
336025,2,8,5,17,0,17,61
336029,2,8,5,2,1,3,23
336039,2,8,5,5,0,5,31
392189,2,8,5,5,0,5,35
392201,2,8,5,6,0,6,66
392214,2,8,5,17,2,19,34
392228,2,8,5,0,0,0,40
392233,2,8,5,1,0,1,41
392234,2,8,5,6,0,6,40
392241,2,8,5,21,1,22,45
392242,2,8,5,3,0,3,59
419111,2,8,5,16,0,16,56
419135,2,8,5,13,0,13,48
419140,2,8,5,5,0,5,46
419143,2,8,5,6,0,6,36
419146,2,8,5,17,1,18,48
419150,2,8,5,7,1,8,30
419152,2,8,5,3,0,3,35
419161,2,8,5,3,1,4,37
419168,2,8,5,2,0,2,19
501208,2,8,5,6,0,6,23
501229,2,8,5,8,0,8,39
501241,2,8,5,12,1,13,57
501244,2,8,5,7,0,7,38
501264,2,8,5,10,0,10,40
548316,2,8,5,3,0,3,35
548357,2,8,5,15,0,15,40
548364,2,8,5,10,0,10,31
548378,2,8,5,10,0,10,44
501205,1,9,5,8,0,8,42
501212,1,9,5,2,0,2,24
501224,1,9,5,5,0,5,38
501230,1,9,5,1,0,1,29
501247,1,9,5,7,0,7,30
501252,1,9,5,11,1,12,41
501259,1,9,5,11,0,11,46
501215,2,9,5,2,0,2,32
501220,2,9,5,11,0,11,40
501234,2,9,5,10,2,12,23
501238,2,9,5,2,0,2,29
501243,2,9,5,8,0,8,61
501263,2,9,5,14,0,14,73
501266,2,9,5,2,0,2,29
501218,1,10,5,12,2,14,42
501223,1,10,5,6,0,6,23
501233,1,10,5,5,0,5,27
501240,1,10,5,10,0,10,37
501264,1,10,5,4,0,4,35
501267,1,10,5,7,0,7,25
548313,1,10,5,7,0,7,27
548318,1,10,5,6,2,8,36
548324,1,10,5,0,1,1,28
548332,1,10,5,11,0,11,48
548338,1,10,5,7,0,7,34
548342,1,10,5,4,0,4,18
548363,1,10,5,5,1,6,28
598008,1,10,5,3,0,3,21
598020,1,10,5,10,0,10,42
598030,1,10,5,10,0,10,47
598052,1,10,5,7,0,7,50
598060,1,10,5,10,1,11,29
598066,1,10,5,5,0,5,39
598072,1,10,5,5,0,5,37
501207,2,10,5,5,0,5,32
501212,2,10,5,6,0,6,37
501231,2,10,5,11,2,13,40
501237,2,10,5,4,1,5,35
501246,2,10,5,6,0,6,27
501253,2,10,5,2,0,2,32
501255,2,10,5,5,0,5,43
548327,2,10,5,5,0,5,48
548335,2,10,5,9,0,9,35
548346,2,10,5,7,2,9,39
548353,2,10,5,1,1,2,31
548356,2,10,5,11,0,11,31
548358,2,10,5,7,0,7,35
548367,2,10,5,12,0,12,38
548370,2,10,5,1,0,1,26
548380,2,10,5,11,3,14,35
598005,2,10,5,5,0,5,18
598014,2,10,5,6,1,7,58
598016,2,10,5,7,1,8,34
598023,2,10,5,1,0,1,39
598032,2,10,5,9,1,10,37
598040,2,10,5,11,1,12,37
598043,2,10,5,6,0,6,43
598047,2,10,5,10,0,10,35
598058,2,10,5,3,1,4,29
598005,1,11,5,11,0,11,32
598023,1,11,5,0,1,1,17
598035,1,11,5,9,0,9,37
598037,1,11,5,4,0,4,19
598053,1,11,5,7,0,7,32
598061,1,11,5,1,0,1,29
598065,1,11,5,5,0,5,44
598070,1,11,5,8,1,9,17
598076,1,11,5,9,0,9,21
729290,1,11,5,8,1,9,33
729306,1,11,5,15,0,15,47
729316,1,11,5,5,0,5,32
729322,1,11,5,7,0,7,38
733982,1,11,5,7,2,9,38
733994,1,11,5,9,0,9,46
734006,1,11,5,7,0,7,31
734012,1,11,5,24,2,26,49
734020,1,11,5,10,2,12,40
734042,1,11,5,0,4,4,41
829732,1,11,5,9,1,10,35
829748,1,11,5,5,1,6,36
829764,1,11,5,16,0,16,46
829778,1,11,5,15,0,15,62
829792,1,11,5,9,0,9,49
829798,1,11,5,1,0,1,32
829804,1,11,5,7,0,7,53
829812,1,11,5,17,0,17,50
829820,1,11,5,8,0,8,21
980920,1,11,5,4,0,4,30
980948,1,11,5,7,0,7,26
980958,1,11,5,5,0,5,33
980978,1,11,5,6,0,6,40
980984,1,11,5,1,1,2,21
980988,1,11,5,16,1,17,43
981008,1,11,5,10,0,10,42
981020,1,11,5,10,0,10,31
981024,1,11,5,19,0,19,46
1082591,1,11,5,9,0,9,42
1082600,1,11,5,9,0,9,26
1082609,1,11,5,4,0,4,25
1082611,1,11,5,3,0,3,31
1082615,1,11,5,6,0,6,34
1082623,1,11,5,17,0,17,50
1082627,1,11,5,14,1,15,67
1082630,1,11,5,9,0,9,49
1082648,1,11,5,2,0,2,27
598009,2,11,5,8,3,11,31
598015,2,11,5,10,0,10,25
598018,2,11,5,4,0,4,33
598026,2,11,5,9,0,9,25
598044,2,11,5,5,0,5,25
598049,2,11,5,3,0,3,33
598056,2,11,5,16,1,17,46
598074,2,11,5,5,0,5,30
729300,2,11,5,1,1,2,33
733998,2,11,5,7,0,7,44
734026,2,11,5,5,0,5,45
734034,2,11,5,4,0,4,43
829716,2,11,5,5,0,5,37
829724,2,11,5,15,0,15,58
829736,2,11,5,12,0,12,32
829756,2,11,5,6,0,6,45
829786,2,11,5,3,0,3,29
980912,2,11,5,11,0,11,49
980928,2,11,5,4,0,4,29
980934,2,11,5,5,0,5,53
980940,2,11,5,11,0,11,58
980972,2,11,5,2,0,2,33
980996,2,11,5,13,0,13,44
981014,2,11,5,9,1,10,39
981022,2,11,5,10,0,10,43
1082596,2,11,5,8,0,8,48
1082604,2,11,5,7,0,7,39
1082634,2,11,5,8,0,8,33
1082638,2,11,5,11,0,11,37
1082643,2,11,5,5,1,6,33
980916,1,12,5,12,1,13,41
980924,1,12,5,10,1,11,38
980944,1,12,5,4,0,4,28
980954,1,12,5,13,0,13,35
980962,1,12,5,8,0,8,44
980974,1,12,5,11,0,11,48
980994,1,12,5,3,0,3,27
1082594,1,12,5,12,0,12,32
1082603,1,12,5,25,0,25,60
1082607,1,12,5,9,0,9,50
1082618,1,12,5,5,1,6,37
1082620,1,12,5,12,0,12,42
1082624,1,12,5,7,0,7,31
1082634,1,12,5,5,0,5,24
1082647,1,12,5,7,0,7,31
980906,2,12,5,14,0,14,37
980936,2,12,5,8,1,9,32
980948,2,12,5,6,5,11,35
980970,2,12,5,10,0,10,38
980984,2,12,5,1,0,1,20
981002,2,12,5,1,0,1,33
981010,2,12,5,1,0,1,35
1082592,2,12,5,4,0,4,43
1082599,2,12,5,7,0,7,38
1082615,2,12,5,13,0,13,37
1082629,2,12,5,13,0,13,37
1082631,2,12,5,12,0,12,59
1082642,2,12,5,5,0,5,41
1082645,2,12,5,6,0,6,36
1082650,2,12,5,8,1,9,32
980934,1,13,5,15,0,15,41
980950,1,13,5,12,0,12,63
980966,1,13,5,3,0,3,27
980972,1,13,5,13,0,13,24
981018,1,13,5,10,0,10,20
981022,1,13,5,8,1,9,32
1082593,1,13,5,11,0,11,40
1082596,1,13,5,3,0,3,35
1082606,1,13,5,7,0,7,31
1082625,1,13,5,1,0,1,47
1082629,1,13,5,11,0,11,46
1082632,1,13,5,11,0,11,46
1082640,1,13,5,7,1,8,39
1082643,1,13,5,13,0,13,48
980910,2,13,5,7,2,9,45
980916,2,13,5,4,0,4,42
980922,2,13,5,6,0,6,35
980942,2,13,5,6,0,6,47
980954,2,13,5,14,0,14,62
980960,2,13,5,10,0,10,34
980980,2,13,5,2,0,2,36
980992,2,13,5,11,0,11,37
981006,2,13,5,6,0,6,45
981012,2,13,5,18,0,18,51
1082603,2,13,5,2,0,2,46
1082610,2,13,5,11,0,11,48
1082613,2,13,5,6,0,6,62
1082616,2,13,5,7,0,7,43
1082621,2,13,5,15,0,15,38
1082637,2,13,5,11,2,13,49
335987,1,1,6,1,0,1,61
335998,1,1,6,11,0,11,61
336002,1,1,6,2,0,2,40
336015,1,1,6,5,0,5,41
336019,1,1,6,10,0,10,43
336022,1,1,6,5,2,7,35
336026,1,1,6,4,1,5,27
336030,1,1,6,7,0,7,35
336032,1,1,6,8,0,8,32
392189,1,1,6,5,1,6,21
392204,1,1,6,1,0,1,45
392212,1,1,6,5,0,5,28
392216,1,1,6,6,0,6,54
392224,1,1,6,11,1,12,37
392226,1,1,6,11,0,11,38
392233,1,1,6,2,0,2,31
419111,1,1,6,7,0,7,38
419127,1,1,6,5,2,7,41
419132,1,1,6,4,1,5,50
419140,1,1,6,6,0,6,46
419144,1,1,6,7,0,7,53
419149,1,1,6,9,0,9,50
419153,1,1,6,9,1,10,61
419158,1,1,6,1,0,1,22
501208,1,1,6,11,1,12,46
501227,1,1,6,5,1,6,50
501235,1,1,6,8,0,8,42
501244,1,1,6,5,1,6,41
501260,1,1,6,7,0,7,33
501272,1,1,6,2,0,2,46
501274,1,1,6,6,0,6,25
548312,1,1,6,11,1,12,46
548320,1,1,6,13,0,13,60
548349,1,1,6,6,0,6,46
548358,1,1,6,18,1,19,68
548373,1,1,6,11,0,11,50
548375,1,1,6,7,0,7,32
548380,1,1,6,5,0,5,27
548383,1,1,6,12,0,12,48
598013,1,1,6,12,1,13,44
598018,1,1,6,6,0,6,48
598027,1,1,6,3,0,3,47
598034,1,1,6,7,0,7,61
598045,1,1,6,8,0,8,37
598058,1,1,6,6,0,6,50
598074,1,1,6,4,2,6,33
729284,1,1,6,3,0,3,31
729294,1,1,6,4,0,4,31
729304,1,1,6,4,0,4,42
734032,1,1,6,9,1,10,45
734048,1,1,6,13,0,13,55
829718,1,1,6,7,0,7,53
829766,1,1,6,11,0,11,50
829776,1,1,6,17,0,17,61
829786,1,1,6,6,4,10,55
980914,1,1,6,6,0,6,40
980952,1,1,6,11,0,11,59
980968,1,1,6,8,0,8,40
980980,1,1,6,6,1,7,28
981000,1,1,6,9,0,9,51
981006,1,1,6,7,1,8,44
981014,1,1,6,7,0,7,48
1082597,1,1,6,8,3,11,59
1082604,1,1,6,7,0,7,40
1082613,1,1,6,8,0,8,65
1082617,1,1,6,9,0,9,65
1082631,1,1,6,14,0,14,41
1082649,1,1,6,0,0,0,25
335991,2,1,6,3,0,3,26
336005,2,1,6,6,1,7,51
336008,2,1,6,1,1,2,31
336040,2,1,6,6,0,6,51
392191,2,1,6,13,0,13,60
392195,2,1,6,10,0,10,38
392202,2,1,6,4,0,4,43
392208,2,1,6,5,0,5,26
392236,2,1,6,22,0,22,56
392238,2,1,6,8,0,8,29
419114,2,1,6,9,0,9,61
419118,2,1,6,11,0,11,45
419123,2,1,6,1,0,1,38
419136,2,1,6,3,1,4,36
419163,2,1,6,4,0,4,42
419166,2,1,6,2,1,3,44
501203,2,1,6,7,1,8,52
501214,2,1,6,18,0,18,62
501219,2,1,6,3,0,3,26
501224,2,1,6,9,0,9,37
501239,2,1,6,4,1,5,45
501247,2,1,6,3,0,3,43
501250,2,1,6,2,0,2,33
501267,2,1,6,1,0,1,44
548317,2,1,6,3,1,4,27
548325,2,1,6,10,0,10,36
548328,2,1,6,7,0,7,48
548333,2,1,6,6,0,6,53
548340,2,1,6,10,0,10,42
548352,2,1,6,3,3,6,37
548362,2,1,6,10,0,10,60
548368,2,1,6,9,0,9,32
548386,2,1,6,15,0,15,56
598003,2,1,6,6,0,6,46
598010,2,1,6,4,0,4,40
598021,2,1,6,11,0,11,45
598036,2,1,6,9,0,9,45
598039,2,1,6,11,1,12,63
598048,2,1,6,3,5,8,48
598055,2,1,6,8,0,8,38
598062,2,1,6,3,1,4,31
598066,2,1,6,3,0,3,33
729312,2,1,6,5,0,5,24
729320,2,1,6,2,1,3,33
733976,2,1,6,1,0,1,39
733984,2,1,6,11,0,11,50
733990,2,1,6,6,4,10,52
734002,2,1,6,7,0,7,55
734014,2,1,6,4,1,5,45
734020,2,1,6,9,0,9,30
734028,2,1,6,7,0,7,52
734042,2,1,6,5,1,6,49
734054,2,1,6,11,0,11,59
829710,2,1,6,6,0,6,38
829728,2,1,6,1,1,2,38
829738,2,1,6,15,0,15,53
829744,2,1,6,12,1,13,48
829748,2,1,6,8,1,9,49
829770,2,1,6,2,0,2,54
829796,2,1,6,2,0,2,57
829810,2,1,6,11,1,12,50
829816,2,1,6,4,5,9,53
980908,2,1,6,5,0,5,47
980920,2,1,6,8,0,8,36
980930,2,1,6,10,0,10,65
980944,2,1,6,9,1,10,59
980956,2,1,6,10,0,10,43
980964,2,1,6,2,1,3,37
981020,2,1,6,3,0,3,46
1082593,2,1,6,16,4,20,73
1082601,2,1,6,16,0,16,76
1082608,2,1,6,15,0,15,49
1082620,2,1,6,7,0,7,45
1082622,2,1,6,7,4,11,47
1082627,2,1,6,8,0,8,44
1082636,2,1,6,20,0,20,105
1082639,2,1,6,12,0,12,61
1082644,2,1,6,4,0,4,53
1082648,2,1,6,2,0,2,48
335997,1,2,6,15,0,15,57
336011,1,2,6,7,0,7,26
336017,1,2,6,2,0,2,36
336021,1,2,6,9,5,14,50
336031,1,2,6,6,0,6,41
336034,1,2,6,0,1,1,23
336039,1,2,6,7,0,7,46
392187,1,2,6,12,0,12,29
392196,1,2,6,2,0,2,49
392199,1,2,6,9,1,10,45
392209,1,2,6,11,0,11,38
392218,1,2,6,5,1,6,29
392241,1,2,6,2,0,2,33
419114,1,2,6,6,0,6,24
419128,1,2,6,9,0,9,38
419138,1,2,6,17,2,19,52
419150,1,2,6,7,0,7,46
501210,1,2,6,4,0,4,24
501237,1,2,6,17,0,17,57
501249,1,2,6,1,0,1,48
501273,1,2,6,4,1,5,44
501275,1,2,6,1,0,1,68
548315,1,2,6,5,0,5,46
548323,1,2,6,4,1,5,56
548341,1,2,6,10,0,10,37
548355,1,2,6,8,0,8,33
548367,1,2,6,25,0,25,66
548372,1,2,6,5,1,6,40
548377,1,2,6,2,1,3,42
598004,1,2,6,2,1,3,31
598009,1,2,6,7,0,7,40
598017,1,2,6,7,0,7,33
598032,1,2,6,0,1,1,62
598041,1,2,6,6,0,6,55
598047,1,2,6,7,0,7,30
598050,1,2,6,5,0,5,31
598059,1,2,6,8,0,8,40
598062,1,2,6,6,0,6,22
598069,1,2,6,17,0,17,58
598073,1,2,6,10,0,10,76
729310,1,2,6,4,2,6,22
729318,1,2,6,10,0,10,44
734004,1,2,6,9,0,9,31
734010,1,2,6,1,0,1,34
734026,1,2,6,1,1,2,25
734040,1,2,6,3,0,3,34
829724,1,2,6,8,0,8,47
829768,1,2,6,3,2,5,52
829790,1,2,6,8,2,10,68
829800,1,2,6,10,0,10,39
829824,1,2,6,3,0,3,41
829826,1,2,6,4,0,4,29
980912,1,2,6,6,0,6,49
980926,1,2,6,12,1,13,63
980932,1,2,6,8,0,8,49
980936,1,2,6,10,1,11,48
980942,1,2,6,12,0,12,50
980964,1,2,6,10,0,10,40
980982,1,2,6,7,0,7,56
980986,1,2,6,6,0,6,25
980992,1,2,6,11,0,11,38
981004,1,2,6,10,0,10,63
1082595,1,2,6,9,0,9,41
1082598,1,2,6,1,0,1,23
1082602,1,2,6,7,0,7,41
1082610,1,2,6,9,0,9,45
1082621,1,2,6,12,0,12,35
1082628,1,2,6,12,0,12,52
1082636,1,2,6,5,1,6,40
1082646,1,2,6,7,0,7,37
335987,2,2,6,2,0,2,26
335990,2,2,6,3,0,3,40
336001,2,2,6,13,0,13,45
336003,2,2,6,7,0,7,55
336007,2,2,6,6,1,7,43
336015,2,2,6,3,0,3,35
336028,2,2,6,5,0,5,23
392190,2,2,6,6,0,6,46
392193,2,2,6,6,0,6,31
392204,2,2,6,6,0,6,46
392213,2,2,6,0,0,0,51
392223,2,2,6,8,0,8,39
392226,2,2,6,10,0,10,46
392229,2,2,6,3,0,3,33
392237,2,2,6,8,0,8,27
392243,2,2,6,10,0,10,59
392244,2,2,6,3,0,3,36
419117,2,2,6,18,0,18,61
419120,2,2,6,7,0,7,59
419124,2,2,6,15,0,15,55
419133,2,2,6,8,1,9,46
419141,2,2,6,11,0,11,51
419145,2,2,6,1,1,2,38
419153,2,2,6,15,0,15,48
419156,2,2,6,3,3,6,38
419159,2,2,6,17,0,17,59
419162,2,2,6,4,0,4,34
419167,2,2,6,3,0,3,44
419169,2,2,6,6,1,7,33
501205,2,2,6,4,0,4,48
501213,2,2,6,1,0,1,28
501216,2,2,6,2,0,2,33
501227,2,2,6,11,0,11,57
501232,2,2,6,3,0,3,65
501252,2,2,6,7,0,7,79
501257,2,2,6,11,1,12,62
501260,2,2,6,7,0,7,65
501265,2,2,6,7,0,7,34
501271,2,2,6,10,0,10,44
501276,2,2,6,9,0,9,47
548320,2,2,6,0,0,0,20
548329,2,2,6,12,0,12,54
548332,2,2,6,2,0,2,42
548336,2,2,6,11,0,11,36
548349,2,2,6,3,0,3,35
548361,2,2,6,10,0,10,46
548365,2,2,6,8,0,8,35
548381,2,2,6,3,0,3,40
598013,2,2,6,21,1,22,43
598022,2,2,6,5,0,5,48
598028,2,2,6,2,0,2,48
598038,2,2,6,0,1,1,35
598053,2,2,6,7,1,8,47
729286,2,2,6,13,0,13,50
729292,2,2,6,6,0,6,30
729304,2,2,6,15,0,15,49
733982,2,2,6,4,0,4,36
733988,2,2,6,11,0,11,64
733996,2,2,6,12,0,12,34
734018,2,2,6,0,0,0,17
734032,2,2,6,6,0,6,36
829718,2,2,6,12,0,12,41
829742,2,2,6,3,4,7,33
829750,2,2,6,4,0,4,38
829754,2,2,6,12,0,12,49
829762,2,2,6,7,0,7,50
829776,2,2,6,10,0,10,62
829784,2,2,6,8,0,8,42
829808,2,2,6,12,0,12,61
829812,2,2,6,15,0,15,83
980958,2,2,6,3,0,3,45
980974,2,2,6,9,0,9,46
981000,2,2,6,10,0,10,63
981016,2,2,6,11,0,11,49
981018,2,2,6,3,0,3,31
981024,2,2,6,4,0,4,59
1082591,2,2,6,6,0,6,54
1082607,2,2,6,3,0,3,42
1082617,2,2,6,9,2,11,39
1082624,2,2,6,6,0,6,39
1082633,2,2,6,9,0,9,46
335988,1,3,6,11,0,11,53
335994,1,3,6,11,2,13,53
336001,1,3,6,10,1,11,36
336006,1,3,6,10,0,10,47
336010,1,3,6,8,0,8,38
336012,1,3,6,2,1,3,34
336018,1,3,6,13,2,15,53
336023,1,3,6,5,0,5,28
336045,1,3,6,3,0,3,42
392190,1,3,6,12,0,12,68
392201,1,3,6,7,0,7,62
392207,1,3,6,14,0,14,40
392211,1,3,6,16,1,17,53
392214,1,3,6,8,0,8,53
392219,1,3,6,12,0,12,57
392229,1,3,6,9,0,9,52
392236,1,3,6,8,4,12,54
392239,1,3,6,6,0,6,50
392243,1,3,6,6,0,6,52
419118,1,3,6,9,0,9,31
419130,1,3,6,13,0,13,51
419142,1,3,6,16,0,16,66
419147,1,3,6,7,0,7,42
419152,1,3,6,14,0,14,55
419160,1,3,6,5,0,5,39
419168,1,3,6,7,1,8,39
419170,1,3,6,9,2,11,40
501203,1,3,6,13,0,13,45
501211,1,3,6,4,0,4,31
501216,1,3,6,12,0,12,45
501220,1,3,6,9,1,10,42
501231,1,3,6,10,0,10,45
501241,1,3,6,8,0,8,34
501250,1,3,6,2,1,3,15
501254,1,3,6,7,1,8,55
501258,1,3,6,3,0,3,42
501266,1,3,6,17,0,17,41
501271,1,3,6,6,0,6,23
501276,1,3,6,8,0,8,56
548311,1,3,6,4,4,8,42
548316,1,3,6,6,0,6,44
548321,1,3,6,6,0,6,41
548327,1,3,6,4,0,4,43
548335,1,3,6,13,1,14,42
548352,1,3,6,11,0,11,43
548357,1,3,6,8,1,9,56
548360,1,3,6,6,0,6,52
548376,1,3,6,1,0,1,25
548384,1,3,6,8,0,8,30
548385,1,3,6,12,1,13,52
548386,1,3,6,18,1,19,54
598025,1,3,6,5,0,5,39
598039,1,3,6,18,0,18,67
598043,1,3,6,3,0,3,29
598046,1,3,6,3,1,4,36
598056,1,3,6,6,0,6,50
598063,1,3,6,10,1,11,37
598067,1,3,6,17,0,17,47
598075,1,3,6,8,0,8,47
729288,1,3,6,11,0,11,70
729298,1,3,6,3,1,4,34
729302,1,3,6,18,1,19,51
733976,1,3,6,10,0,10,43
734018,1,3,6,10,0,10,39
734028,1,3,6,2,0,2,35
734034,1,3,6,21,0,21,60
829712,1,3,6,9,1,10,59
829716,1,3,6,8,0,8,49
829728,1,3,6,5,0,5,69
829740,1,3,6,3,0,3,39
829750,1,3,6,6,1,7,45
829758,1,3,6,2,1,3,54
829770,1,3,6,5,0,5,53
829784,1,3,6,8,0,8,37
829794,1,3,6,0,0,0,44
829802,1,3,6,13,0,13,36
829806,1,3,6,0,0,0,16
335998,2,3,6,9,1,10,45
336014,2,3,6,18,2,20,62
336030,2,3,6,6,1,7,43
336034,2,3,6,2,0,2,44
336038,2,3,6,10,0,10,65
336042,2,3,6,3,0,3,44
336044,2,3,6,5,0,5,35
392186,2,3,6,1,6,7,40
392194,2,3,6,4,1,5,61
392207,2,3,6,4,0,4,32
392222,2,3,6,12,0,12,37
392232,2,3,6,1,0,1,35
419115,2,3,6,3,0,3,34
419121,2,3,6,6,0,6,56
419126,2,3,6,5,3,8,42
419128,2,3,6,7,0,7,29
419134,2,3,6,8,0,8,58
419138,2,3,6,9,0,9,56
419158,2,3,6,7,0,7,67
419164,2,3,6,10,2,12,49
501226,2,3,6,6,0,6,44
501233,2,3,6,7,2,9,28
501245,2,3,6,4,0,4,43
501273,2,3,6,1,0,1,25
548323,2,3,6,20,0,20,52
548337,2,3,6,5,0,5,45
548348,2,3,6,3,0,3,48
548366,2,3,6,6,0,6,36
548369,2,3,6,7,0,7,45
548373,2,3,6,7,0,7,51
598007,2,3,6,4,0,4,36
598012,2,3,6,7,0,7,38
598017,2,3,6,14,0,14,31
598020,2,3,6,13,0,13,38
598027,2,3,6,1,0,1,27
598031,2,3,6,12,1,13,58
598035,2,3,6,12,0,12,58
598051,2,3,6,9,2,11,32
598073,2,3,6,19,0,19,56
598078,2,3,6,6,0,6,35
729308,2,3,6,14,0,14,51
729316,2,3,6,10,1,11,47
733986,2,3,6,1,1,2,49
733992,2,3,6,12,0,12,46
734000,2,3,6,4,0,4,38
734008,2,3,6,6,0,6,48
734040,2,3,6,5,0,5,64
734050,2,3,6,17,0,17,60
734052,2,3,6,32,1,33,100
829734,2,3,6,18,0,18,90
829778,2,3,6,6,0,6,54
829814,2,3,6,6,1,7,47
829822,2,3,6,8,0,8,54
829826,2,3,6,6,0,6,34
829828,2,3,6,5,0,5,31
335992,1,4,6,16,0,16,54
335996,1,4,6,16,1,17,60
336008,1,4,6,4,1,5,49
336024,1,4,6,10,0,10,51
336033,1,4,6,12,1,13,43
336040,1,4,6,9,1,10,47
336044,1,4,6,5,0,5,35
392188,1,4,6,14,1,15,67
392191,1,4,6,10,0,10,46
392200,1,4,6,7,3,10,38
392205,1,4,6,2,1,3,26
392227,1,4,6,8,0,8,51
392234,1,4,6,6,0,6,39
419113,1,4,6,4,1,5,44
419117,1,4,6,15,0,15,50
419126,1,4,6,8,0,8,38
419137,1,4,6,2,5,7,48
419141,1,4,6,5,0,5,41
419148,1,4,6,8,2,10,52
419161,1,4,6,9,0,9,43
419164,1,4,6,6,0,6,49
501207,1,4,6,9,1,10,36
501225,1,4,6,0,4,4,77
501239,1,4,6,5,0,5,40
501253,1,4,6,5,0,5,34
501256,1,4,6,5,4,9,39
501262,1,4,6,9,1,10,39
501265,1,4,6,1,0,1,30
548328,1,4,6,2,0,2,26
548333,1,4,6,11,0,11,45
548336,1,4,6,14,0,14,41
548344,1,4,6,9,0,9,44
548348,1,4,6,5,0,5,43
548364,1,4,6,9,0,9,51
548374,1,4,6,9,0,9,47
548379,1,4,6,2,0,2,20
598012,1,4,6,5,0,5,43
598019,1,4,6,13,0,13,34
598021,1,4,6,6,0,6,35
598026,1,4,6,7,0,7,36
598033,1,4,6,17,0,17,53
598036,1,4,6,12,0,12,45
598057,1,4,6,9,0,9,37
598071,1,4,6,13,0,13,35
729300,1,4,6,4,1,5,43
729312,1,4,6,14,0,14,51
733978,1,4,6,5,0,5,36
733992,1,4,6,1,0,1,38
733996,1,4,6,15,4,19,64
734002,1,4,6,1,0,1,49
734030,1,4,6,13,1,14,48
734038,1,4,6,7,0,7,53
734052,1,4,6,13,0,13,70
734054,1,4,6,2,0,2,32
829722,1,4,6,10,1,11,57
829730,1,4,6,8,0,8,41
829738,1,4,6,11,0,11,48
829772,1,4,6,9,2,11,27
829796,1,4,6,4,0,4,45
829808,1,4,6,15,1,16,72
829814,1,4,6,6,0,6,41
980910,1,4,6,7,0,7,52
980918,1,4,6,14,0,14,37
980930,1,4,6,6,0,6,41
980940,1,4,6,0,0,0,35
980960,1,4,6,8,0,8,59
980976,1,4,6,5,0,5,45
980996,1,4,6,10,0,10,47
981010,1,4,6,12,0,12,52
1082601,1,4,6,4,0,4,57
1082612,1,4,6,7,0,7,46
1082616,1,4,6,14,0,14,50
1082633,1,4,6,6,0,6,35
1082637,1,4,6,15,0,15,44
1082639,1,4,6,2,0,2,41
1082641,1,4,6,11,0,11,71
1082645,1,4,6,1,2,3,32
335988,2,4,6,14,2,16,63
336000,2,4,6,12,0,12,55
336004,2,4,6,4,0,4,41
336011,2,4,6,8,0,8,52
336018,2,4,6,4,0,4,35
336021,2,4,6,9,0,9,42
336027,2,4,6,17,0,17,73
336036,2,4,6,11,0,11,74
392196,2,4,6,4,1,5,44
392209,2,4,6,7,0,7,35
392212,2,4,6,6,1,7,51
392215,2,4,6,3,1,4,29
392219,2,4,6,5,1,6,53
392221,2,4,6,3,0,3,45
392231,2,4,6,1,1,2,33
392239,2,4,6,3,0,3,29
419122,2,4,6,5,0,5,27
419129,2,4,6,16,1,17,76
419132,2,4,6,11,0,11,42
419144,2,4,6,16,1,17,69
419151,2,4,6,10,0,10,56
419154,2,4,6,7,0,7,39
501211,2,4,6,16,0,16,65
501217,2,4,6,2,1,3,62
501228,2,4,6,12,0,12,46
501242,2,4,6,5,1,6,24
501249,2,4,6,5,0,5,38
501259,2,4,6,14,0,14,49
501269,2,4,6,9,0,9,45
548314,2,4,6,4,1,5,45
548318,2,4,6,6,0,6,19
548324,2,4,6,10,0,10,38
548339,2,4,6,6,0,6,48
548355,2,4,6,9,0,9,53
548359,2,4,6,5,1,6,33
548371,2,4,6,16,0,16,44
548376,2,4,6,9,0,9,43
598008,2,4,6,2,0,2,56
598030,2,4,6,11,0,11,55
598042,2,4,6,17,0,17,55
598046,2,4,6,9,0,9,36
598050,2,4,6,13,0,13,46
598061,2,4,6,12,0,12,41
598064,2,4,6,5,0,5,56
598069,2,4,6,10,0,10,41
729288,2,4,6,10,2,12,64
729296,2,4,6,7,2,9,39
729318,2,4,6,2,0,2,33
734012,2,4,6,20,0,20,86
734024,2,4,6,10,1,11,66
734044,2,4,6,14,4,18,48
734048,2,4,6,6,1,7,46
829714,2,4,6,4,1,5,51
829746,2,4,6,7,0,7,40
829758,2,4,6,4,0,4,39
829764,2,4,6,13,2,15,36
829780,2,4,6,3,0,3,45
829790,2,4,6,5,0,5,34
829804,2,4,6,5,0,5,47
980924,2,4,6,7,0,7,50
980946,2,4,6,7,0,7,40
980968,2,4,6,9,1,10,37
980982,2,4,6,7,0,7,50
980990,2,4,6,4,2,6,32
981004,2,4,6,3,2,5,59
1082594,2,4,6,8,0,8,56
1082598,2,4,6,11,1,12,62
1082605,2,4,6,7,0,7,40
1082609,2,4,6,15,4,19,51
1082623,2,4,6,17,0,17,59
1082626,2,4,6,10,1,11,50
335989,1,5,6,2,1,3,36
336005,1,5,6,3,4,7,45
336013,1,5,6,17,0,17,48
336028,1,5,6,8,0,8,51
336038,1,5,6,15,0,15,67
336043,1,5,6,15,0,15,58
392195,1,5,6,13,1,14,54
392215,1,5,6,13,0,13,57
392222,1,5,6,8,1,9,34
392230,1,5,6,1,2,3,42
392238,1,5,6,8,0,8,46
419116,1,5,6,2,0,2,47
419120,1,5,6,3,1,4,31
419123,1,5,6,14,0,14,56
419129,1,5,6,3,1,4,53
419134,1,5,6,9,0,9,58
419146,1,5,6,11,0,11,48
419159,1,5,6,6,0,6,30
419163,1,5,6,14,0,14,46
501214,1,5,6,2,0,2,31
501219,1,5,6,8,0,8,36
501245,1,5,6,11,0,11,47
501257,1,5,6,11,0,11,43
501263,1,5,6,10,0,10,32
548314,1,5,6,9,0,9,57
548317,1,5,6,8,0,8,37
548325,1,5,6,12,0,12,45
548329,1,5,6,9,0,9,43
548337,1,5,6,5,0,5,41
548354,1,5,6,6,0,6,56
548359,1,5,6,18,1,19,64
548366,1,5,6,3,0,3,28
548370,1,5,6,11,0,11,45
548378,1,5,6,10,0,10,41
548382,1,5,6,0,0,0,31
598006,1,5,6,8,1,9,45
598010,1,5,6,8,0,8,35
598014,1,5,6,4,0,4,44
598024,1,5,6,12,4,16,58
598028,1,5,6,6,0,6,31
598031,1,5,6,7,0,7,55
598048,1,5,6,4,2,6,34
598077,1,5,6,9,0,9,42
729296,1,5,6,12,1,13,54
729320,1,5,6,17,3,20,45
733984,1,5,6,6,0,6,50
734008,1,5,6,16,1,17,42
734016,1,5,6,9,0,9,52
734046,1,5,6,5,0,5,35
829714,1,5,6,15,0,15,35
829746,1,5,6,9,0,9,43
829754,1,5,6,12,0,12,48
829782,1,5,6,7,0,7,43
829816,1,5,6,14,0,14,66
335992,2,5,6,4,1,5,53
335995,2,5,6,16,0,16,73
335997,2,5,6,5,1,6,45
336010,2,5,6,10,0,10,44
336016,2,5,6,17,0,17,50
336020,2,5,6,2,4,6,21
336024,2,5,6,9,0,9,38
336032,2,5,6,0,0,0,42
336041,2,5,6,2,2,4,36
336045,2,5,6,5,0,5,41
392187,2,5,6,1,0,1,14
392200,2,5,6,5,0,5,32
392203,2,5,6,2,0,2,33
392207,2,5,6,6,0,6,38
392210,2,5,6,9,1,10,30
392218,2,5,6,6,0,6,31
392225,2,5,6,5,0,5,30
392235,2,5,6,5,0,5,24
419112,2,5,6,1,0,1,39
419131,2,5,6,3,0,3,54
419139,2,5,6,6,0,6,39
419142,2,5,6,15,0,15,62
419148,2,5,6,5,0,5,70
419155,2,5,6,9,5,14,34
501204,2,5,6,1,1,2,31
501209,2,5,6,14,0,14,57
501225,2,5,6,7,0,7,45
501230,2,5,6,5,0,5,34
501236,2,5,6,1,0,1,18
501240,2,5,6,5,0,5,34
501254,2,5,6,10,0,10,48
501268,2,5,6,15,0,15,52
548322,2,5,6,8,1,9,44
548331,2,5,6,10,2,12,62
548341,2,5,6,13,0,13,48
548350,2,5,6,10,0,10,40
548363,2,5,6,8,0,8,49
598019,2,5,6,4,0,4,48
598037,2,5,6,9,0,9,30
598041,2,5,6,9,0,9,45
598052,2,5,6,13,0,13,53
598054,2,5,6,13,0,13,49
598057,2,5,6,7,0,7,38
598063,2,5,6,5,0,5,24
598068,2,5,6,2,0,2,29
598070,2,5,6,2,1,3,33
598076,2,5,6,16,0,16,44
729290,2,5,6,2,0,2,30
729302,2,5,6,1,0,1,38
729310,2,5,6,3,1,4,36
733980,2,5,6,7,0,7,38
733994,2,5,6,5,0,5,37
734004,2,5,6,7,0,7,45
734022,2,5,6,5,1,6,47
734038,2,5,6,12,1,13,44
829720,2,5,6,5,0,5,42
829726,2,5,6,9,0,9,42
829732,2,5,6,8,1,9,36
829740,2,5,6,5,0,5,47
829774,2,5,6,6,0,6,55
829792,2,5,6,1,0,1,36
829802,2,5,6,8,0,8,40
829824,2,5,6,6,0,6,40
336000,1,6,6,5,0,5,45
336003,1,6,6,5,0,5,58
336014,1,6,6,5,0,5,50
336020,1,6,6,6,2,8,47
336025,1,6,6,7,1,8,48
336027,1,6,6,22,0,22,68
392194,1,6,6,13,0,13,59
392203,1,6,6,6,0,6,42
392228,1,6,6,24,0,24,56
392231,1,6,6,9,2,11,38
392235,1,6,6,9,0,9,35
392237,1,6,6,9,0,9,37
392242,1,6,6,8,0,8,49
419121,1,6,6,2,0,2,52
419133,1,6,6,6,0,6,64
419136,1,6,6,6,0,6,62
419139,1,6,6,7,0,7,52
419145,1,6,6,6,0,6,54
419154,1,6,6,1,0,1,45
501206,1,6,6,11,0,11,38
501209,1,6,6,0,0,0,30
501228,1,6,6,12,6,18,70
501232,1,6,6,8,0,8,42
501238,1,6,6,0,3,3,34
501243,1,6,6,3,1,4,42
501270,1,6,6,5,1,6,33
548347,1,6,6,11,3,14,54
548350,1,6,6,7,0,7,42
548362,1,6,6,7,0,7,50
548369,1,6,6,2,1,3,27
598003,1,6,6,4,0,4,45
598015,1,6,6,1,0,1,29
598022,1,6,6,1,0,1,43
598040,1,6,6,10,3,13,37
598049,1,6,6,3,0,3,26
598054,1,6,6,1,0,1,42
598064,1,6,6,8,0,8,40
729286,1,6,6,13,0,13,30
733980,1,6,6,11,0,11,46
733986,1,6,6,9,0,9,46
733990,1,6,6,3,0,3,29
733998,1,6,6,15,0,15,52
734024,1,6,6,7,1,8,55
734044,1,6,6,0,1,1,44
829720,1,6,6,5,0,5,51
829736,1,6,6,11,1,12,40
829744,1,6,6,8,0,8,34
829752,1,6,6,2,0,2,45
829762,1,6,6,3,1,4,38
829788,1,6,6,0,1,1,44
829818,1,6,6,12,0,12,54
980908,1,6,6,0,0,0,35
980938,1,6,6,5,1,6,41
980956,1,6,6,5,0,5,37
980970,1,6,6,8,0,8,48
981002,1,6,6,3,0,3,28
981016,1,6,6,2,0,2,43
1082599,1,6,6,14,1,15,62
1082605,1,6,6,8,0,8,49
1082608,1,6,6,3,0,3,53
1082622,1,6,6,5,0,5,53
1082626,1,6,6,3,0,3,25
1082642,1,6,6,13,1,14,54
335989,2,6,6,6,1,7,55
335993,2,6,6,10,1,11,48
336006,2,6,6,10,0,10,64
336009,2,6,6,8,0,8,37
336022,2,6,6,5,0,5,37
336031,2,6,6,11,0,11,71
336037,2,6,6,6,0,6,56
336043,2,6,6,4,0,4,28
392199,2,6,6,4,0,4,43
392206,2,6,6,4,2,6,41
392211,2,6,6,11,0,11,49
392216,2,6,6,6,2,8,57
392220,2,6,6,3,0,3,36
392224,2,6,6,2,0,2,47
392240,2,6,6,14,0,14,60
419113,2,6,6,9,0,9,39
419116,2,6,6,13,0,13,60
419119,2,6,6,5,0,5,54
419125,2,6,6,7,0,7,48
419149,2,6,6,5,0,5,44
419157,2,6,6,13,1,14,69
419160,2,6,6,7,0,7,33
419165,2,6,6,2,0,2,39
501218,2,6,6,8,7,15,67
501221,2,6,6,5,0,5,38
501235,2,6,6,6,1,7,41
501248,2,6,6,4,1,5,29
501251,2,6,6,10,0,10,23
501258,2,6,6,1,5,6,52
501262,2,6,6,16,1,17,42
548312,2,6,6,8,1,9,48
548315,2,6,6,6,0,6,46
548321,2,6,6,6,0,6,50
548326,2,6,6,7,0,7,34
548330,2,6,6,7,0,7,41
548334,2,6,6,20,0,20,64
548338,2,6,6,20,0,20,49
548342,2,6,6,15,0,15,61
548354,2,6,6,10,0,10,61
548374,2,6,6,1,0,1,37
548377,2,6,6,4,0,4,51
548379,2,6,6,5,5,10,44
548383,2,6,6,2,0,2,49
548385,2,6,6,11,0,11,46
598006,2,6,6,5,1,6,39
598011,2,6,6,3,1,4,46
598025,2,6,6,2,0,2,32
598029,2,6,6,9,0,9,60
598033,2,6,6,7,0,7,21
598045,2,6,6,2,0,2,34
598059,2,6,6,1,0,1,49
598067,2,6,6,15,0,15,49
598072,2,6,6,7,0,7,47
729294,2,6,6,6,0,6,49
729298,2,6,6,6,0,6,24
729306,2,6,6,6,1,7,44
729314,2,6,6,0,1,1,26
734010,2,6,6,10,0,10,46
734016,2,6,6,2,2,4,34
734036,2,6,6,4,0,4,47
829712,2,6,6,1,0,1,40
829730,2,6,6,7,0,7,47
829766,2,6,6,2,0,2,36
829772,2,6,6,8,0,8,41
829782,2,6,6,14,0,14,55
829798,2,6,6,15,0,15,49
829806,2,6,6,4,0,4,28
980918,2,6,6,8,0,8,28
980926,2,6,6,1,0,1,51
980950,2,6,6,3,0,3,22
980966,2,6,6,10,0,10,61
980976,2,6,6,16,0,16,51
980988,2,6,6,8,1,9,50
980998,2,6,6,2,0,2,49
981008,2,6,6,1,0,1,37
1082595,2,6,6,6,0,6,43
1082611,2,6,6,8,1,9,56
1082614,2,6,6,1,1,2,23
1082630,2,6,6,16,0,16,62
1082632,2,6,6,5,0,5,63
1082635,2,6,6,4,0,4,35
1082640,2,6,6,17,0,17,64
1082646,2,6,6,2,0,2,42
335990,1,7,6,6,0,6,47
335999,1,7,6,4,1,5,27
336009,1,7,6,15,0,15,50
336029,1,7,6,9,0,9,57
336037,1,7,6,17,0,17,60
336041,1,7,6,1,0,1,29
392186,1,7,6,5,0,5,40
392202,1,7,6,15,1,16,61
392208,1,7,6,9,0,9,40
392213,1,7,6,2,0,2,25
392220,1,7,6,5,0,5,30
392223,1,7,6,4,0,4,46
392232,1,7,6,15,0,15,49
392240,1,7,6,2,0,2,30
419112,1,7,6,17,0,17,69
419119,1,7,6,10,1,11,67
419124,1,7,6,8,0,8,45
419135,1,7,6,10,0,10,52
419143,1,7,6,6,0,6,53
419151,1,7,6,6,0,6,51
419155,1,7,6,6,0,6,47
419157,1,7,6,4,0,4,43
419162,1,7,6,5,0,5,34
419166,1,7,6,13,0,13,42
419167,1,7,6,15,0,15,54
501215,1,7,6,8,1,9,44
501226,1,7,6,8,1,9,40
501229,1,7,6,8,2,10,57
501236,1,7,6,2,0,2,31
501242,1,7,6,11,0,11,35
501246,1,7,6,8,6,14,49
501251,1,7,6,0,0,0,50
501268,1,7,6,6,0,6,26
548322,1,7,6,10,0,10,54
548330,1,7,6,6,1,7,23
548339,1,7,6,10,1,11,39
548356,1,7,6,14,0,14,42
548365,1,7,6,13,0,13,25
548368,1,7,6,6,0,6,49
598007,1,7,6,12,1,13,41
598011,1,7,6,16,0,16,38
598016,1,7,6,11,0,11,48
598029,1,7,6,2,0,2,20
598038,1,7,6,10,4,14,52
598042,1,7,6,8,0,8,36
598044,1,7,6,9,0,9,41
598051,1,7,6,11,0,11,32
598055,1,7,6,3,0,3,41
598068,1,7,6,12,2,14,49
598078,1,7,6,9,0,9,34
729292,1,7,6,13,5,18,49
729308,1,7,6,5,0,5,31
729314,1,7,6,6,0,6,37
733988,1,7,6,5,4,9,50
734000,1,7,6,10,0,10,42
734014,1,7,6,2,0,2,37
734022,1,7,6,7,1,8,42
734036,1,7,6,10,1,11,65
734050,1,7,6,19,0,19,53
829710,1,7,6,0,0,0,37
829726,1,7,6,4,0,4,31
829734,1,7,6,11,0,11,31
829742,1,7,6,2,1,3,48
829756,1,7,6,10,0,10,46
829774,1,7,6,3,1,4,47
829780,1,7,6,5,0,5,51
829810,1,7,6,10,2,12,46
829822,1,7,6,13,0,13,48
829828,1,7,6,14,0,14,61
980906,1,7,6,1,6,7,37
980922,1,7,6,5,0,5,31
980928,1,7,6,9,0,9,40
980946,1,7,6,13,1,14,39
980990,1,7,6,7,0,7,21
980998,1,7,6,12,0,12,45
981012,1,7,6,4,0,4,49
1082592,1,7,6,13,0,13,61
1082614,1,7,6,1,0,1,48
1082635,1,7,6,13,6,19,60
1082638,1,7,6,7,0,7,36
1082644,1,7,6,12,0,12,51
1082650,1,7,6,16,0,16,32
335994,2,7,6,2,0,2,52
335996,2,7,6,5,0,5,39
336002,2,7,6,9,0,9,38
336013,2,7,6,5,0,5,34
336017,2,7,6,3,0,3,39
336023,2,7,6,20,1,21,78
336026,2,7,6,10,5,15,68
336033,2,7,6,12,0,12,68
392197,2,7,6,5,3,8,50
392202,2,7,6,4,0,4,47
392205,2,7,6,10,0,10,23
392217,2,7,6,13,1,14,41
392227,2,7,6,7,0,7,42
392230,2,7,6,3,0,3,26
419119,2,7,6,2,0,2,56
419127,2,7,6,6,0,6,57
419130,2,7,6,13,0,13,63
419137,2,7,6,3,5,8,45
419147,2,7,6,8,0,8,46
419170,2,7,6,11,1,12,33
501206,2,7,6,8,1,9,31
501210,2,7,6,7,0,7,40
501223,2,7,6,5,0,5,32
501256,2,7,6,5,0,5,33
501261,2,7,6,2,0,2,26
501272,2,7,6,13,5,18,54
501274,2,7,6,11,0,11,62
501275,2,7,6,10,1,11,52
548311,2,7,6,16,0,16,53
548313,2,7,6,6,0,6,27
548319,2,7,6,14,0,14,29
548344,2,7,6,9,2,11,40
548347,2,7,6,13,0,13,49
548351,2,7,6,4,0,4,31
548360,2,7,6,8,0,8,46
548372,2,7,6,3,1,4,32
548375,2,7,6,6,0,6,26
548382,2,7,6,5,0,5,44
548384,2,7,6,7,0,7,54
598004,2,7,6,10,1,11,38
598024,2,7,6,2,0,2,26
598034,2,7,6,12,0,12,42
598060,2,7,6,11,0,11,37
598065,2,7,6,4,0,4,39
598071,2,7,6,14,0,14,51
598075,2,7,6,16,0,16,56
598077,2,7,6,9,0,9,45
729284,2,7,6,7,0,7,32
729322,2,7,6,8,0,8,32
733978,2,7,6,6,1,7,49
734006,2,7,6,6,0,6,38
734030,2,7,6,9,0,9,62
734046,2,7,6,9,1,10,71
829722,2,7,6,0,0,0,17
829752,2,7,6,10,0,10,48
829788,2,7,6,5,0,5,41
829794,2,7,6,11,0,11,61
829800,2,7,6,10,0,10,45
829820,2,7,6,1,0,1,38
980914,2,7,6,2,1,3,53
980932,2,7,6,7,1,8,51
980938,2,7,6,5,0,5,52
980952,2,7,6,19,0,19,64
980962,2,7,6,4,0,4,47
980978,2,7,6,1,0,1,32
980986,2,7,6,9,0,9,39
1082597,2,7,6,4,1,5,49
1082600,2,7,6,19,0,19,61
1082602,2,7,6,3,0,3,21
1082606,2,7,6,9,0,9,56
1082612,2,7,6,13,1,14,82
1082618,2,7,6,8,1,9,44
1082625,2,7,6,9,0,9,61
1082628,2,7,6,8,0,8,55
1082641,2,7,6,16,0,16,68
1082647,2,7,6,1,0,1,42
1082649,2,7,6,4,0,4,36
335991,1,8,6,16,0,16,39
335993,1,8,6,2,0,2,25
335995,1,8,6,9,1,10,58
336004,1,8,6,12,0,12,50
336007,1,8,6,7,0,7,41
336016,1,8,6,9,0,9,50
336036,1,8,6,2,1,3,42
336042,1,8,6,8,0,8,26
392193,1,8,6,13,0,13,62
392197,1,8,6,10,1,11,55
392206,1,8,6,7,0,7,37
392210,1,8,6,4,0,4,39
392217,1,8,6,1,0,1,37
392221,1,8,6,8,0,8,52
392225,1,8,6,10,0,10,42
392244,1,8,6,8,0,8,31
419115,1,8,6,1,1,2,57
419122,1,8,6,3,0,3,56
419125,1,8,6,3,0,3,47
419131,1,8,6,13,0,13,55
419156,1,8,6,7,0,7,35
419165,1,8,6,4,0,4,38
419169,1,8,6,7,0,7,27
501204,1,8,6,4,0,4,44
501213,1,8,6,7,0,7,41
501217,1,8,6,9,1,10,48
501221,1,8,6,7,0,7,43
501234,1,8,6,1,0,1,20
501248,1,8,6,13,0,13,43
501255,1,8,6,11,0,11,50
501261,1,8,6,9,0,9,32
501269,1,8,6,11,0,11,58
548319,1,8,6,18,0,18,45
548326,1,8,6,15,0,15,50
548331,1,8,6,8,0,8,57
548334,1,8,6,5,0,5,33
548340,1,8,6,4,0,4,39
548346,1,8,6,2,0,2,50
548351,1,8,6,2,0,2,38
548353,1,8,6,7,0,7,33
548361,1,8,6,7,0,7,46
548371,1,8,6,6,0,6,47
548381,1,8,6,2,0,2,23
335999,2,8,6,11,2,13,60
336012,2,8,6,20,0,20,50
336019,2,8,6,11,3,14,55
336025,2,8,6,10,0,10,71
336029,2,8,6,8,1,9,32
336039,2,8,6,2,0,2,33
392189,2,8,6,2,0,2,37
392201,2,8,6,3,0,3,69
392214,2,8,6,18,0,18,52
392228,2,8,6,9,1,10,50
392233,2,8,6,9,0,9,50
392234,2,8,6,6,0,6,46
392241,2,8,6,14,5,19,64
392242,2,8,6,24,1,25,84
419111,2,8,6,6,0,6,62
419135,2,8,6,0,2,2,50
419140,2,8,6,12,1,13,59
419143,2,8,6,4,0,4,40
419146,2,8,6,4,0,4,52
419150,2,8,6,2,0,2,32
419152,2,8,6,2,0,2,37
419161,2,8,6,7,1,8,45
419168,2,8,6,4,0,4,23
501208,2,8,6,7,0,7,30
501229,2,8,6,2,0,2,41
501241,2,8,6,7,0,7,64
501244,2,8,6,3,0,3,41
501264,2,8,6,16,1,17,57
548316,2,8,6,9,1,10,45
548357,2,8,6,7,0,7,47
548364,2,8,6,3,6,9,40
548378,2,8,6,13,1,14,58
501205,1,9,6,18,1,19,61
501212,1,9,6,13,0,13,37
501224,1,9,6,7,0,7,45
501230,1,9,6,3,0,3,32
501247,1,9,6,5,0,5,35
501252,1,9,6,8,0,8,49
501259,1,9,6,11,5,16,62
501215,2,9,6,15,3,18,50
501220,2,9,6,9,0,9,49
501234,2,9,6,6,0,6,29
501238,2,9,6,8,0,8,37
501243,2,9,6,3,3,6,67
501263,2,9,6,10,4,14,87
501266,2,9,6,11,0,11,40
501218,1,10,6,20,1,21,63
501223,1,10,6,5,5,10,33
501233,1,10,6,10,0,10,37
501240,1,10,6,12,0,12,49
501264,1,10,6,4,0,4,39
501267,1,10,6,2,2,4,29
548313,1,10,6,3,0,3,30
548318,1,10,6,2,0,2,38
548324,1,10,6,1,0,1,29
548332,1,10,6,10,0,10,58
548338,1,10,6,17,1,18,52
548342,1,10,6,10,0,10,28
548363,1,10,6,6,1,7,35
598008,1,10,6,3,0,3,24
598020,1,10,6,6,0,6,48
598030,1,10,6,0,1,1,48
598052,1,10,6,6,5,11,61
598060,1,10,6,7,0,7,36
598066,1,10,6,3,0,3,42
598072,1,10,6,1,2,3,40
501207,2,10,6,12,0,12,44
501212,2,10,6,6,1,7,44
501231,2,10,6,0,0,0,40
501237,2,10,6,7,0,7,42
501246,2,10,6,1,3,4,31
501253,2,10,6,8,0,8,40
501255,2,10,6,9,0,9,52
548327,2,10,6,8,0,8,56
548335,2,10,6,18,0,18,53
548346,2,10,6,5,0,5,44
548353,2,10,6,17,0,17,48
548356,2,10,6,6,0,6,37
548358,2,10,6,9,1,10,45
548367,2,10,6,11,1,12,50
548370,2,10,6,7,0,7,33
548380,2,10,6,5,0,5,40
598005,2,10,6,8,1,9,27
598014,2,10,6,5,1,6,64
598016,2,10,6,6,0,6,40
598023,2,10,6,2,0,2,41
598032,2,10,6,6,0,6,43
598040,2,10,6,4,2,6,43
598043,2,10,6,3,0,3,46
598047,2,10,6,4,0,4,39
598058,2,10,6,5,0,5,34
598005,1,11,6,5,1,6,38
598023,1,11,6,8,0,8,25
598035,1,11,6,3,0,3,40
598037,1,11,6,9,1,10,29
598053,1,11,6,8,0,8,40
598061,1,11,6,8,0,8,37
598065,1,11,6,7,1,8,52
598070,1,11,6,4,0,4,21
598076,1,11,6,6,0,6,27
729290,1,11,6,8,0,8,41
729306,1,11,6,8,0,8,55
729316,1,11,6,4,1,5,37
729322,1,11,6,6,0,6,44
733982,1,11,6,8,1,9,47
733994,1,11,6,3,1,4,50
734006,1,11,6,12,0,12,43
734012,1,11,6,6,0,6,55
734020,1,11,6,1,0,1,41
734042,1,11,6,8,0,8,49
829732,1,11,6,0,0,0,35
829748,1,11,6,7,0,7,43
829764,1,11,6,9,1,10,56
829778,1,11,6,13,1,14,76
829792,1,11,6,7,0,7,56
829798,1,11,6,8,1,9,41
829804,1,11,6,2,1,3,56
829812,1,11,6,16,2,18,68
829820,1,11,6,7,1,8,29
980920,1,11,6,6,0,6,36
980948,1,11,6,1,0,1,27
980958,1,11,6,14,2,16,49
980978,1,11,6,11,0,11,51
980984,1,11,6,13,0,13,34
980988,1,11,6,4,4,8,51
981008,1,11,6,4,0,4,46
981020,1,11,6,11,1,12,43
981024,1,11,6,12,1,13,59
1082591,1,11,6,17,0,17,59
1082600,1,11,6,8,0,8,34
1082609,1,11,6,3,1,4,29
1082611,1,11,6,8,0,8,39
1082615,1,11,6,11,0,11,45
1082623,1,11,6,10,0,10,60
1082627,1,11,6,9,3,12,79
1082630,1,11,6,13,4,17,66
1082648,1,11,6,3,0,3,30
598009,2,11,6,6,0,6,37
598015,2,11,6,13,0,13,38
598018,2,11,6,5,1,6,39
598026,2,11,6,8,0,8,33
598044,2,11,6,11,0,11,36
598049,2,11,6,7,1,8,41
598056,2,11,6,3,0,3,49
598074,2,11,6,15,0,15,45
729300,2,11,6,12,0,12,45
734026,2,11,6,6,0,6,51
734034,2,11,6,20,1,21,64
829716,2,11,6,9,0,9,46
829724,2,11,6,7,0,7,65
829736,2,11,6,18,0,18,50
829756,2,11,6,6,1,7,52
829786,2,11,6,4,0,4,33
980912,2,11,6,7,0,7,56
980928,2,11,6,3,1,4,33
980934,2,11,6,10,0,10,63
980940,2,11,6,7,0,7,65
980972,2,11,6,5,0,5,38
980996,2,11,6,11,0,11,55
981014,2,11,6,9,0,9,48
981022,2,11,6,3,0,3,46
1082596,2,11,6,11,0,11,59
1082604,2,11,6,6,0,6,45
1082634,2,11,6,14,0,14,47
1082638,2,11,6,6,0,6,43
1082643,2,11,6,14,0,14,47
980916,1,12,6,16,0,16,57
980924,1,12,6,9,2,11,49
980944,1,12,6,3,0,3,31
980954,1,12,6,13,0,13,48
980962,1,12,6,10,0,10,54
980974,1,12,6,12,0,12,60
980994,1,12,6,10,0,10,37
1082594,1,12,6,3,0,3,35
1082603,1,12,6,4,0,4,64
1082607,1,12,6,4,1,5,55
1082618,1,12,6,11,0,11,48
1082620,1,12,6,15,0,15,57
1082624,1,12,6,12,0,12,43
1082634,1,12,6,10,1,11,35
1082647,1,12,6,2,0,2,33
980906,2,12,6,19,1,20,57
980936,2,12,6,4,0,4,36
980948,2,12,6,10,1,11,46
980970,2,12,6,12,0,12,50
980984,2,12,6,5,0,5,25
981002,2,12,6,9,2,11,44
981010,2,12,6,9,0,9,44
1082592,2,12,6,16,0,16,59
1082599,2,12,6,11,1,12,50
1082615,2,12,6,18,0,18,55
1082629,2,12,6,6,0,6,43
1082631,2,12,6,14,1,15,74
1082642,2,12,6,11,1,12,53
1082645,2,12,6,7,0,7,43
1082650,2,12,6,6,0,6,38
980934,1,13,6,9,0,9,50
980950,1,13,6,8,0,8,71
980966,1,13,6,7,1,8,35
980972,1,13,6,2,0,2,26
981018,1,13,6,3,0,3,23
981022,1,13,6,6,0,6,38
1082593,1,13,6,12,0,12,52
1082596,1,13,6,4,1,5,40
1082606,1,13,6,15,0,15,46
1082625,1,13,6,1,0,1,48
1082629,1,13,6,9,0,9,55
1082632,1,13,6,12,0,12,58
1082640,1,13,6,11,0,11,50
1082643,1,13,6,13,0,13,61
980910,2,13,6,12,0,12,57
980916,2,13,6,16,4,20,62
980922,2,13,6,7,0,7,42
980942,2,13,6,20,5,25,72
980954,2,13,6,9,1,10,72
980960,2,13,6,2,0,2,36
980980,2,13,6,10,0,10,46
980992,2,13,6,2,2,4,41
981006,2,13,6,9,1,10,55
981012,2,13,6,19,0,19,70
1082603,2,13,6,15,0,15,61
1082610,2,13,6,9,0,9,57
1082613,2,13,6,8,2,10,72
1082616,2,13,6,7,0,7,50
1082621,2,13,6,11,0,11,49
1082637,2,13,6,9,0,9,58
335987,1,1,7,7,0,7,68
335998,1,1,7,1,1,2,63
336002,1,1,7,3,4,7,47
336015,1,1,7,4,0,4,45
336019,1,1,7,5,0,5,48
336022,1,1,7,10,3,13,48
336026,1,1,7,2,0,2,29
336030,1,1,7,5,0,5,40
336032,1,1,7,8,0,8,40
392189,1,1,7,2,0,2,23
392204,1,1,7,3,0,3,48
392212,1,1,7,2,0,2,30
392216,1,1,7,4,0,4,58
392224,1,1,7,6,0,6,43
392226,1,1,7,8,0,8,46
392233,1,1,7,3,0,3,34
419111,1,1,7,8,0,8,46
419127,1,1,7,4,1,5,46
419132,1,1,7,5,0,5,55
419140,1,1,7,12,1,13,59
419144,1,1,7,2,0,2,55
419149,1,1,7,15,0,15,65
419153,1,1,7,5,6,11,72
419158,1,1,7,4,4,8,30
501208,1,1,7,3,0,3,49
501227,1,1,7,9,0,9,59
501235,1,1,7,7,1,8,50
501244,1,1,7,4,0,4,45
501260,1,1,7,5,1,6,39
501272,1,1,7,6,0,6,52
501274,1,1,7,5,0,5,30
548312,1,1,7,10,0,10,56
548320,1,1,7,3,0,3,63
548349,1,1,7,9,0,9,55
548358,1,1,7,7,0,7,75
548373,1,1,7,7,0,7,57
548375,1,1,7,5,1,6,38
548380,1,1,7,5,0,5,32
548383,1,1,7,3,0,3,51
598013,1,1,7,3,0,3,47
598018,1,1,7,9,0,9,57
598027,1,1,7,2,0,2,49
598034,1,1,7,4,0,4,65
598045,1,1,7,5,0,5,42
598058,1,1,7,1,1,2,52
598074,1,1,7,9,0,9,42
729284,1,1,7,6,0,6,37
729294,1,1,7,11,2,13,44
729304,1,1,7,15,0,15,57
734032,1,1,7,11,0,11,56
734048,1,1,7,3,0,3,58
829718,1,1,7,5,0,5,58
829766,1,1,7,1,0,1,51
829776,1,1,7,12,0,12,73
829786,1,1,7,5,0,5,60
980914,1,1,7,12,0,12,52
980952,1,1,7,8,0,8,67
980968,1,1,7,3,0,3,43
980980,1,1,7,5,0,5,33
981000,1,1,7,16,0,16,67
981006,1,1,7,2,1,3,47
981014,1,1,7,5,1,6,54
1082597,1,1,7,6,0,6,65
1082604,1,1,7,7,0,7,47
1082613,1,1,7,6,0,6,71
1082617,1,1,7,3,0,3,68
1082631,1,1,7,3,0,3,44
1082649,1,1,7,6,0,6,31
335991,2,1,7,2,5,7,33
336005,2,1,7,3,0,3,54
336008,2,1,7,4,0,4,35
336040,2,1,7,3,0,3,54
392191,2,1,7,6,0,6,66
392195,2,1,7,4,1,5,43
392202,2,1,7,2,0,2,49
392208,2,1,7,11,2,13,39
392236,2,1,7,4,0,4,60
392238,2,1,7,1,0,1,30
419114,2,1,7,4,2,6,67
419118,2,1,7,4,0,4,49
419123,2,1,7,5,0,5,43
419136,2,1,7,8,1,9,45
419163,2,1,7,5,0,5,47
419166,2,1,7,9,0,9,53
501203,2,1,7,4,0,4,56
501214,2,1,7,5,0,5,67
501219,2,1,7,5,0,5,31
501224,2,1,7,5,0,5,42
501239,2,1,7,6,3,9,54
501247,2,1,7,7,0,7,50
501250,2,1,7,6,0,6,39
501267,2,1,7,6,0,6,50
548317,2,1,7,7,0,7,34
548325,2,1,7,7,2,9,45
548328,2,1,7,6,0,6,54
548333,2,1,7,2,1,3,56
548340,2,1,7,2,0,2,44
548352,2,1,7,10,0,10,47
548362,2,1,7,8,0,8,68
548368,2,1,7,7,1,8,40
548386,2,1,7,10,3,13,69
598003,2,1,7,6,0,6,52
598010,2,1,7,3,0,3,43
598021,2,1,7,14,0,14,59
598036,2,1,7,7,0,7,52
598039,2,1,7,3,1,4,67
598048,2,1,7,5,2,7,55
598055,2,1,7,8,0,8,46
598062,2,1,7,6,1,7,38
598066,2,1,7,12,0,12,45
729312,2,1,7,3,1,4,28
729320,2,1,7,5,0,5,38
733976,2,1,7,10,0,10,49
733984,2,1,7,11,0,11,61
733990,2,1,7,11,0,11,63
734002,2,1,7,12,1,13,68
734014,2,1,7,5,0,5,50
734020,2,1,7,5,1,6,36
734028,2,1,7,12,0,12,64
734042,2,1,7,4,0,4,53
734054,2,1,7,8,0,8,67
829710,2,1,7,11,0,11,49
829728,2,1,7,4,2,6,44
829738,2,1,7,7,0,7,60
829744,2,1,7,4,0,4,52
829748,2,1,7,11,0,11,60
829770,2,1,7,7,0,7,61
829796,2,1,7,3,1,4,61
829810,2,1,7,4,0,4,54
829816,2,1,7,13,0,13,66
980908,2,1,7,2,0,2,49
980920,2,1,7,6,0,6,42
980930,2,1,7,7,0,7,72
980944,2,1,7,3,0,3,62
980956,2,1,7,7,1,8,51
980964,2,1,7,15,0,15,52
981020,2,1,7,7,0,7,53
1082593,2,1,7,23,0,23,96
1082601,2,1,7,13,0,13,89
1082608,2,1,7,3,0,3,52
1082620,2,1,7,11,0,11,56
1082622,2,1,7,14,0,14,61
1082627,2,1,7,8,0,8,52
1082636,2,1,7,0,0,0,105
1082639,2,1,7,3,0,3,64
1082644,2,1,7,10,0,10,63
335997,1,2,7,5,2,7,64
336011,1,2,7,5,1,6,32
336017,1,2,7,3,0,3,39
336021,1,2,7,3,0,3,53
336031,1,2,7,2,0,2,43
336034,1,2,7,4,0,4,27
336039,1,2,7,5,0,5,51
392187,1,2,7,10,0,10,39
392196,1,2,7,4,0,4,53
392199,1,2,7,4,0,4,49
392209,1,2,7,6,0,6,44
392218,1,2,7,8,1,9,38
392241,1,2,7,6,0,6,39
419114,1,2,7,11,0,11,35
419128,1,2,7,10,4,14,52
419138,1,2,7,3,0,3,55
419150,1,2,7,8,0,8,54
501210,1,2,7,5,0,5,29
501237,1,2,7,1,0,1,58
501249,1,2,7,6,1,7,55
501273,1,2,7,5,2,7,51
501275,1,2,7,8,0,8,76
548315,1,2,7,9,0,9,55
548323,1,2,7,6,0,6,62
548341,1,2,7,3,0,3,40
548355,1,2,7,4,0,4,37
548367,1,2,7,2,1,3,69
548372,1,2,7,8,0,8,48
548377,1,2,7,9,0,9,51
598004,1,2,7,1,4,5,36
598009,1,2,7,2,0,2,42
598017,1,2,7,2,0,2,35
598032,1,2,7,17,1,18,80
598041,1,2,7,6,0,6,61
598047,1,2,7,10,0,10,40
598050,1,2,7,6,0,6,37
598059,1,2,7,8,0,8,48
598062,1,2,7,6,0,6,28
598069,1,2,7,7,2,9,67
598073,1,2,7,13,1,14,90
729310,1,2,7,4,0,4,26
729318,1,2,7,6,0,6,50
734004,1,2,7,2,0,2,33
734010,1,2,7,3,0,3,37
734026,1,2,7,4,0,4,29
734040,1,2,7,4,1,5,39
829724,1,2,7,4,6,10,57
829768,1,2,7,15,0,15,67
829790,1,2,7,3,0,3,71
829800,1,2,7,7,0,7,46
829824,1,2,7,3,0,3,44
829826,1,2,7,7,0,7,36
980912,1,2,7,3,0,3,52
980926,1,2,7,9,0,9,72
980932,1,2,7,6,1,7,56
980936,1,2,7,5,0,5,53
980942,1,2,7,5,0,5,55
980964,1,2,7,11,0,11,51
980982,1,2,7,5,0,5,61
980986,1,2,7,8,0,8,33
980992,1,2,7,8,0,8,46
981004,1,2,7,18,1,19,82
1082595,1,2,7,4,0,4,45
1082598,1,2,7,8,0,8,31
1082602,1,2,7,7,2,9,50
1082610,1,2,7,9,0,9,54
1082621,1,2,7,10,0,10,45
1082628,1,2,7,4,0,4,56
1082636,1,2,7,9,0,9,49
1082646,1,2,7,4,0,4,41
335987,2,2,7,5,2,7,33
335990,2,2,7,6,0,6,46
336001,2,2,7,9,2,11,56
336003,2,2,7,4,0,4,59
336007,2,2,7,3,0,3,46
336015,2,2,7,2,1,3,38
336028,2,2,7,3,1,4,27
392190,2,2,7,2,0,2,48
392193,2,2,7,7,0,7,38
392204,2,2,7,3,0,3,49
392213,2,2,7,2,1,3,54
392223,2,2,7,4,0,4,43
392226,2,2,7,4,1,5,51
392229,2,2,7,5,0,5,38
392237,2,2,7,6,0,6,33
392243,2,2,7,4,0,4,63
392244,2,2,7,6,0,6,42
419117,2,2,7,5,1,6,67
419120,2,2,7,3,0,3,62
419124,2,2,7,9,0,9,64
419133,2,2,7,8,1,9,55
419141,2,2,7,3,0,3,54
419145,2,2,7,4,0,4,42
419153,2,2,7,3,0,3,51
419156,2,2,7,8,0,8,46
419159,2,2,7,9,1,10,69
419162,2,2,7,3,1,4,38
419167,2,2,7,10,2,12,56
419169,2,2,7,2,0,2,35
501205,2,2,7,11,0,11,59
501213,2,2,7,3,0,3,31
501216,2,2,7,5,0,5,38
501227,2,2,7,3,0,3,60
501232,2,2,7,12,1,13,78
501252,2,2,7,5,0,5,84
501257,2,2,7,3,0,3,65
501260,2,2,7,5,0,5,70
501265,2,2,7,9,0,9,43
501271,2,2,7,4,0,4,48
501276,2,2,7,3,0,3,50
548320,2,2,7,3,0,3,23
548329,2,2,7,4,1,5,59
548332,2,2,7,5,0,5,47
548336,2,2,7,3,0,3,39
548349,2,2,7,3,0,3,38
548361,2,2,7,10,0,10,56
548365,2,2,7,4,0,4,39
548381,2,2,7,4,0,4,44
598013,2,2,7,7,0,7,50
598022,2,2,7,4,0,4,52
598028,2,2,7,5,0,5,53
598038,2,2,7,3,0,3,38
598053,2,2,7,1,0,1,48
729286,2,2,7,5,0,5,55
729292,2,2,7,6,0,6,36
729304,2,2,7,8,4,12,61
733982,2,2,7,2,0,2,38
733988,2,2,7,2,1,3,67
733996,2,2,7,5,0,5,39
734018,2,2,7,9,7,16,33
734032,2,2,7,10,0,10,46
829718,2,2,7,6,0,6,47
829742,2,2,7,4,0,4,37
829750,2,2,7,6,0,6,44
829754,2,2,7,11,0,11,60
829762,2,2,7,11,0,11,61
829776,2,2,7,18,0,18,80
829784,2,2,7,7,0,7,49
829808,2,2,7,6,2,8,69
980958,2,2,7,7,0,7,52
980974,2,2,7,4,0,4,50
981000,2,2,7,2,0,2,65
981016,2,2,7,5,0,5,54
981018,2,2,7,10,0,10,41
981024,2,2,7,10,0,10,69
1082591,2,2,7,7,0,7,61
1082607,2,2,7,7,0,7,49
1082617,2,2,7,0,1,1,40
1082624,2,2,7,4,0,4,43
1082633,2,2,7,4,0,4,50
335988,1,3,7,9,0,9,62
335994,1,3,7,5,1,6,59
336001,1,3,7,7,0,7,43
336006,1,3,7,6,1,7,54
336010,1,3,7,3,0,3,41
336012,1,3,7,9,0,9,43
336018,1,3,7,10,1,11,64
336023,1,3,7,8,0,8,36
336045,1,3,7,9,0,9,51
392190,1,3,7,9,0,9,77
392201,1,3,7,3,0,3,65
392207,1,3,7,7,0,7,47
392211,1,3,7,5,0,5,58
392214,1,3,7,8,0,8,61
392219,1,3,7,5,0,5,62
392229,1,3,7,2,0,2,54
392236,1,3,7,8,5,13,67
392239,1,3,7,4,0,4,54
392243,1,3,7,9,0,9,61
419118,1,3,7,10,0,10,41
419130,1,3,7,4,0,4,55
419142,1,3,7,11,0,11,77
419147,1,3,7,6,5,11,53
419152,1,3,7,6,0,6,61
419160,1,3,7,5,0,5,44
419168,1,3,7,4,0,4,43
419170,1,3,7,3,0,3,43
501203,1,3,7,12,0,12,57
501211,1,3,7,8,0,8,39
501216,1,3,7,9,0,9,54
501220,1,3,7,5,0,5,47
501231,1,3,7,3,0,3,48
501241,1,3,7,3,0,3,37
501250,1,3,7,5,0,5,20
501254,1,3,7,11,0,11,66
501258,1,3,7,1,0,1,43
501266,1,3,7,6,0,6,47
501271,1,3,7,3,1,4,27
501276,1,3,7,5,0,5,61
548311,1,3,7,4,2,6,48
548316,1,3,7,11,0,11,55
548321,1,3,7,6,0,6,47
548327,1,3,7,6,0,6,49
548335,1,3,7,1,0,1,43
548352,1,3,7,7,0,7,50
548357,1,3,7,2,0,2,58
548360,1,3,7,4,1,5,57
548376,1,3,7,2,1,3,28
548384,1,3,7,6,0,6,36
548385,1,3,7,12,0,12,64
548386,1,3,7,9,0,9,63
598025,1,3,7,9,0,9,48
598039,1,3,7,5,0,5,72
598043,1,3,7,5,0,5,34
598046,1,3,7,8,0,8,44
598056,1,3,7,5,0,5,55
598063,1,3,7,7,0,7,44
598067,1,3,7,9,5,14,61
598075,1,3,7,5,0,5,52
729288,1,3,7,4,2,6,76
729298,1,3,7,9,0,9,43
729302,1,3,7,2,0,2,53
733976,1,3,7,7,1,8,51
734018,1,3,7,5,1,6,45
734028,1,3,7,6,0,6,41
734034,1,3,7,8,0,8,68
829712,1,3,7,6,0,6,65
829716,1,3,7,15,1,16,65
829728,1,3,7,3,1,4,73
829740,1,3,7,1,0,1,40
829750,1,3,7,2,0,2,47
829758,1,3,7,14,6,20,74
829770,1,3,7,2,0,2,55
829784,1,3,7,6,1,7,44
829794,1,3,7,5,0,5,49
829802,1,3,7,7,0,7,43
829806,1,3,7,8,0,8,24
335998,2,3,7,10,0,10,55
336014,2,3,7,9,0,9,71
336030,2,3,7,4,0,4,47
336034,2,3,7,9,0,9,53
336038,2,3,7,6,1,7,72
336042,2,3,7,9,0,9,53
336044,2,3,7,8,1,9,44
392186,2,3,7,15,0,15,55
392194,2,3,7,19,5,24,85
392207,2,3,7,0,0,0,38
392222,2,3,7,0,3,3,40
392232,2,3,7,4,0,4,39
419115,2,3,7,15,1,16,50
419121,2,3,7,6,2,8,64
419126,2,3,7,9,0,9,51
419128,2,3,7,4,0,4,33
419134,2,3,7,9,1,10,68
419138,2,3,7,6,0,6,62
419158,2,3,7,9,0,9,76
419164,2,3,7,11,0,11,60
501226,2,3,7,9,0,9,53
501233,2,3,7,5,0,5,33
501245,2,3,7,9,1,10,53
501273,2,3,7,3,0,3,28
548323,2,3,7,5,0,5,57
548337,2,3,7,8,0,8,53
548348,2,3,7,9,0,9,57
548366,2,3,7,4,0,4,40
548369,2,3,7,10,0,10,55
548373,2,3,7,7,0,7,58
598007,2,3,7,3,1,4,40
598012,2,3,7,4,1,5,43
598017,2,3,7,6,0,6,37
598020,2,3,7,7,0,7,45
598027,2,3,7,3,0,3,30
598031,2,3,7,3,0,3,61
598035,2,3,7,2,0,2,60
598051,2,3,7,2,0,2,34
598073,2,3,7,11,1,12,68
598078,2,3,7,3,0,3,38
729308,2,3,7,9,0,9,60
729316,2,3,7,6,0,6,53
733986,2,3,7,3,0,3,52
733992,2,3,7,7,0,7,53
734000,2,3,7,4,0,4,42
734008,2,3,7,3,1,4,52
734040,2,3,7,5,0,5,69
734050,2,3,7,2,2,4,64
734052,2,3,7,3,0,3,103
829734,2,3,7,14,3,17,107
829778,2,3,7,10,0,10,64
829814,2,3,7,6,2,8,55
829822,2,3,7,5,2,7,61
829826,2,3,7,5,2,7,41
829828,2,3,7,6,1,7,38
335992,1,4,7,5,0,5,59
335996,1,4,7,9,1,10,70
336008,1,4,7,8,0,8,57
336024,1,4,7,17,0,17,68
336033,1,4,7,9,1,10,53
336040,1,4,7,11,0,11,58
336044,1,4,7,0,0,0,35
392188,1,4,7,1,0,1,68
392191,1,4,7,2,0,2,48
392200,1,4,7,4,0,4,42
392205,1,4,7,6,0,6,32
392227,1,4,7,5,5,10,61
392234,1,4,7,7,0,7,46
419113,1,4,7,5,0,5,49
419117,1,4,7,5,0,5,55
419126,1,4,7,3,0,3,41
419137,1,4,7,7,0,7,55
419141,1,4,7,5,0,5,46
419148,1,4,7,6,0,6,58
419161,1,4,7,7,0,7,50
419164,1,4,7,9,0,9,58
501207,1,4,7,4,1,5,41
501225,1,4,7,8,0,8,85
501239,1,4,7,1,0,1,41
501253,1,4,7,10,1,11,45
501256,1,4,7,10,5,15,54
501262,1,4,7,1,0,1,40
501265,1,4,7,10,1,11,41
548328,1,4,7,5,0,5,31
548333,1,4,7,5,0,5,50
548336,1,4,7,10,0,10,51
548344,1,4,7,0,0,0,44
548348,1,4,7,8,0,8,51
548364,1,4,7,5,0,5,56
548374,1,4,7,7,0,7,54
548379,1,4,7,6,1,7,27
598012,1,4,7,7,0,7,50
598019,1,4,7,5,0,5,39
598021,1,4,7,9,0,9,44
598026,1,4,7,2,4,6,42
598033,1,4,7,1,2,3,56
598036,1,4,7,5,0,5,50
598057,1,4,7,14,0,14,51
598071,1,4,7,8,0,8,43
729300,1,4,7,9,0,9,52
729312,1,4,7,5,0,5,56
733978,1,4,7,5,1,6,42
733992,1,4,7,7,0,7,45
733996,1,4,7,5,0,5,69
734002,1,4,7,4,0,4,53
734030,1,4,7,11,0,11,59
734038,1,4,7,3,0,3,56
734052,1,4,7,10,1,11,81
734054,1,4,7,4,0,4,36
829722,1,4,7,5,0,5,62
829730,1,4,7,3,1,4,45
829738,1,4,7,2,0,2,50
829772,1,4,7,4,0,4,31
829796,1,4,7,3,0,3,48
829808,1,4,7,13,0,13,85
829814,1,4,7,2,0,2,43
980910,1,4,7,3,2,5,57
980918,1,4,7,8,0,8,45
980930,1,4,7,3,0,3,44
980940,1,4,7,4,0,4,39
980960,1,4,7,7,1,8,67
980976,1,4,7,3,0,3,48
980996,1,4,7,4,0,4,51
981010,1,4,7,4,0,4,56
1082601,1,4,7,4,1,5,62
1082612,1,4,7,6,0,6,52
1082616,1,4,7,2,1,3,53
1082633,1,4,7,4,0,4,39
1082637,1,4,7,10,0,10,54
1082639,1,4,7,4,0,4,45
1082641,1,4,7,14,0,14,85
1082645,1,4,7,1,1,2,34
335988,2,4,7,5,1,6,69
336000,2,4,7,7,0,7,62
336004,2,4,7,4,1,5,46
336011,2,4,7,3,0,3,55
336018,2,4,7,10,0,10,45
336021,2,4,7,3,0,3,45
336027,2,4,7,11,1,12,85
336036,2,4,7,4,0,4,78
392196,2,4,7,13,0,13,57
392209,2,4,7,11,0,11,46
392212,2,4,7,6,2,8,59
392215,2,4,7,2,0,2,31
392219,2,4,7,4,0,4,57
392221,2,4,7,11,0,11,56
392231,2,4,7,2,0,2,35
392239,2,4,7,3,0,3,32
419122,2,4,7,12,0,12,39
419129,2,4,7,4,1,5,81
419132,2,4,7,9,1,10,52
419144,2,4,7,5,1,6,75
419151,2,4,7,4,0,4,60
419154,2,4,7,3,0,3,42
501211,2,4,7,7,0,7,72
501217,2,4,7,12,1,13,75
501228,2,4,7,13,0,13,59
501242,2,4,7,9,0,9,33
501249,2,4,7,11,0,11,49
501259,2,4,7,5,0,5,54
501269,2,4,7,7,1,8,53
548314,2,4,7,8,1,9,54
548318,2,4,7,3,1,4,23
548324,2,4,7,7,0,7,45
548339,2,4,7,4,0,4,52
548355,2,4,7,8,0,8,61
548359,2,4,7,18,0,18,51
548371,2,4,7,11,0,11,55
548376,2,4,7,8,0,8,51
598008,2,4,7,7,0,7,63
598030,2,4,7,4,0,4,59
598042,2,4,7,5,0,5,60
598046,2,4,7,7,0,7,43
598050,2,4,7,4,1,5,51
598061,2,4,7,3,1,4,45
598064,2,4,7,3,0,3,59
598069,2,4,7,4,0,4,45
729288,2,4,7,8,0,8,72
729296,2,4,7,17,0,17,56
729318,2,4,7,7,0,7,40
734012,2,4,7,9,0,9,95
734024,2,4,7,8,1,9,75
734044,2,4,7,7,5,12,60
734048,2,4,7,7,0,7,53
829714,2,4,7,2,0,2,53
829746,2,4,7,7,0,7,47
829758,2,4,7,2,1,3,42
829764,2,4,7,6,0,6,42
829780,2,4,7,4,1,5,50
829790,2,4,7,5,0,5,39
829804,2,4,7,8,0,8,55
980924,2,4,7,4,0,4,54
980946,2,4,7,9,1,10,50
980968,2,4,7,4,2,6,43
980982,2,4,7,7,0,7,57
980990,2,4,7,6,4,10,42
981004,2,4,7,16,1,17,76
1082594,2,4,7,3,0,3,59
1082598,2,4,7,5,0,5,67
1082605,2,4,7,6,1,7,47
1082609,2,4,7,2,0,2,53
1082623,2,4,7,8,0,8,67
1082626,2,4,7,9,0,9,59
335989,1,5,7,4,0,4,40
336005,1,5,7,8,0,8,53
336013,1,5,7,4,4,8,56
336028,1,5,7,7,5,12,63
336038,1,5,7,8,2,10,77
336043,1,5,7,7,0,7,65
392195,1,5,7,6,1,7,61
392215,1,5,7,6,0,6,63
392222,1,5,7,6,1,7,41
392230,1,5,7,3,0,3,45
392238,1,5,7,1,0,1,47
419116,1,5,7,2,0,2,49
419120,1,5,7,2,0,2,33
419123,1,5,7,1,2,3,59
419129,1,5,7,7,0,7,60
419134,1,5,7,10,0,10,68
419146,1,5,7,5,0,5,53
419159,1,5,7,1,0,1,31
419163,1,5,7,11,0,11,57
501214,1,5,7,5,1,6,37
501219,1,5,7,3,0,3,39
501245,1,5,7,5,0,5,52
501257,1,5,7,7,0,7,50
501263,1,5,7,5,1,6,38
548314,1,5,7,3,1,4,61
548317,1,5,7,9,0,9,46
548325,1,5,7,2,0,2,47
548329,1,5,7,4,0,4,47
548337,1,5,7,2,0,2,43
548354,1,5,7,5,1,6,62
548359,1,5,7,4,0,4,68
548366,1,5,7,4,2,6,34
548370,1,5,7,6,0,6,51
548378,1,5,7,4,0,4,45
548382,1,5,7,9,0,9,40
598006,1,5,7,5,0,5,50
598010,1,5,7,6,1,7,42
598014,1,5,7,5,0,5,49
598024,1,5,7,3,0,3,61
598028,1,5,7,3,0,3,34
598031,1,5,7,16,0,16,71
598048,1,5,7,5,0,5,39
598077,1,5,7,2,0,2,44
729296,1,5,7,8,0,8,62
729320,1,5,7,4,0,4,49
733984,1,5,7,8,0,8,58
734008,1,5,7,8,0,8,50
734016,1,5,7,4,3,7,59
734046,1,5,7,3,0,3,38
829714,1,5,7,9,1,10,45
829746,1,5,7,5,2,7,50
829754,1,5,7,6,0,6,54
829782,1,5,7,10,0,10,53
829816,1,5,7,13,1,14,80
335992,2,5,7,7,0,7,60
335995,2,5,7,9,0,9,82
335997,2,5,7,7,0,7,52
336010,2,5,7,2,12,14,58
336016,2,5,7,6,1,7,57
336020,2,5,7,11,1,12,33
336024,2,5,7,7,1,8,46
336032,2,5,7,4,0,4,46
336041,2,5,7,11,0,11,47
336045,2,5,7,3,0,3,44
392187,2,5,7,2,1,3,17
392200,2,5,7,6,0,6,38
392203,2,5,7,3,0,3,36
392207,2,5,7,3,1,4,42
392210,2,5,7,5,0,5,35
392218,2,5,7,4,0,4,35
392225,2,5,7,5,0,5,35
392235,2,5,7,1,1,2,26
419112,2,5,7,4,0,4,43
419131,2,5,7,9,2,11,65
419139,2,5,7,15,0,15,54
419142,2,5,7,5,1,6,68
419148,2,5,7,12,0,12,82
419155,2,5,7,5,1,6,40
501204,2,5,7,7,0,7,38
501209,2,5,7,2,0,2,59
501225,2,5,7,3,0,3,48
501230,2,5,7,8,0,8,42
501236,2,5,7,4,0,4,22
501240,2,5,7,9,0,9,43
501254,2,5,7,6,0,6,54
501268,2,5,7,14,0,14,66
548322,2,5,7,9,1,10,54
548331,2,5,7,8,0,8,70
548341,2,5,7,8,0,8,56
548350,2,5,7,7,0,7,47
548363,2,5,7,5,0,5,54
598019,2,5,7,9,1,10,58
598037,2,5,7,10,0,10,40
598041,2,5,7,2,1,3,48
598052,2,5,7,10,0,10,63
598054,2,5,7,5,1,6,55
598057,2,5,7,9,0,9,47
598063,2,5,7,7,0,7,31
598068,2,5,7,2,1,3,32
598070,2,5,7,4,0,4,37
598076,2,5,7,6,0,6,50
729290,2,5,7,6,0,6,36
729302,2,5,7,6,0,6,44
729310,2,5,7,4,0,4,40
733980,2,5,7,9,0,9,47
733994,2,5,7,5,0,5,42
734004,2,5,7,9,0,9,54
734022,2,5,7,11,0,11,58
734038,2,5,7,10,0,10,54
829720,2,5,7,8,0,8,50
829726,2,5,7,7,0,7,49
829732,2,5,7,11,1,12,48
829740,2,5,7,4,0,4,51
829774,2,5,7,4,3,7,62
829792,2,5,7,5,1,6,42
829802,2,5,7,7,0,7,47
829824,2,5,7,10,0,10,50
336000,1,6,7,7,2,9,54
336003,1,6,7,13,0,13,71
336014,1,6,7,7,2,9,59
336020,1,6,7,5,0,5,52
336025,1,6,7,8,0,8,56
336027,1,6,7,6,1,7,75
392194,1,6,7,8,0,8,67
392203,1,6,7,6,0,6,48
392228,1,6,7,4,0,4,60
392231,1,6,7,7,0,7,45
392235,1,6,7,2,1,3,38
392237,1,6,7,8,0,8,45
392242,1,6,7,11,0,11,60
419121,1,6,7,14,1,15,67
419133,1,6,7,11,0,11,75
419136,1,6,7,4,0,4,66
419139,1,6,7,6,0,6,58
419145,1,6,7,3,0,3,57
419154,1,6,7,2,6,8,53
501206,1,6,7,2,0,2,40
501209,1,6,7,6,0,6,36
501228,1,6,7,9,0,9,79
501232,1,6,7,4,0,4,46
501238,1,6,7,2,0,2,36
501243,1,6,7,5,1,6,48
501270,1,6,7,5,0,5,38
548347,1,6,7,8,1,9,63
548350,1,6,7,10,1,11,53
548362,1,6,7,7,5,12,62
548369,1,6,7,4,1,5,32
598003,1,6,7,2,0,2,47
598015,1,6,7,3,0,3,32
598022,1,6,7,6,0,6,49
598040,1,6,7,9,0,9,46
598049,1,6,7,5,1,6,32
598054,1,6,7,4,0,4,46
598064,1,6,7,3,2,5,45
729286,1,6,7,2,3,5,35
733980,1,6,7,4,0,4,50
733986,1,6,7,3,0,3,49
733990,1,6,7,8,2,10,39
733998,1,6,7,8,0,8,60
734024,1,6,7,11,0,11,66
734044,1,6,7,6,0,6,50
829720,1,6,7,3,0,3,54
829736,1,6,7,6,0,6,46
829744,1,6,7,3,6,9,43
829752,1,6,7,4,0,4,49
829762,1,6,7,1,1,2,40
829788,1,6,7,8,0,8,52
829818,1,6,7,3,0,3,57
980908,1,6,7,7,0,7,42
980938,1,6,7,7,0,7,48
980956,1,6,7,6,0,6,43
980970,1,6,7,6,0,6,54
981002,1,6,7,2,0,2,30
981016,1,6,7,5,0,5,48
1082599,1,6,7,3,1,4,66
1082605,1,6,7,5,1,6,55
1082608,1,6,7,6,0,6,59
1082622,1,6,7,7,0,7,60
1082626,1,6,7,3,1,4,29
1082642,1,6,7,9,0,9,63
335989,2,6,7,4,0,4,59
335993,2,6,7,7,0,7,55
336006,2,6,7,18,1,19,83
336009,2,6,7,4,1,5,42
336022,2,6,7,4,0,4,41
336031,2,6,7,19,0,19,90
336037,2,6,7,11,0,11,67
336043,2,6,7,9,0,9,37
392199,2,6,7,7,0,7,50
392206,2,6,7,9,0,9,50
392211,2,6,7,4,1,5,54
392216,2,6,7,3,0,3,60
392220,2,6,7,2,0,2,38
392224,2,6,7,7,1,8,55
392240,2,6,7,3,0,3,63
419113,2,6,7,4,0,4,43
419116,2,6,7,18,0,18,78
419119,2,6,7,5,0,5,61
419125,2,6,7,12,0,12,60
419149,2,6,7,14,0,14,58
419157,2,6,7,4,0,4,73
419160,2,6,7,5,0,5,38
419165,2,6,7,6,0,6,45
501218,2,6,7,8,0,8,75
501221,2,6,7,3,0,3,41
501235,2,6,7,3,0,3,44
501248,2,6,7,2,1,3,32
501251,2,6,7,10,0,10,33
501258,2,6,7,2,0,2,54
501262,2,6,7,7,0,7,49
548312,2,6,7,8,0,8,56
548315,2,6,7,7,0,7,53
548321,2,6,7,3,0,3,53
548326,2,6,7,8,0,8,42
548330,2,6,7,3,0,3,44
548334,2,6,7,2,8,10,74
548338,2,6,7,7,0,7,56
548342,2,6,7,12,0,12,73
548354,2,6,7,12,0,12,73
548374,2,6,7,2,0,2,39
548377,2,6,7,9,0,9,60
548379,2,6,7,23,0,23,67
548383,2,6,7,6,2,8,57
548385,2,6,7,16,0,16,62
598006,2,6,7,7,0,7,46
598011,2,6,7,11,0,11,57
598025,2,6,7,3,0,3,35
598029,2,6,7,10,0,10,70
598033,2,6,7,6,1,7,28
598045,2,6,7,4,0,4,38
598059,2,6,7,12,0,12,61
598067,2,6,7,1,1,2,51
598072,2,6,7,8,0,8,55
729294,2,6,7,11,0,11,60
729298,2,6,7,13,0,13,37
729306,2,6,7,13,0,13,57
729314,2,6,7,5,0,5,31
734010,2,6,7,8,0,8,54
734016,2,6,7,11,0,11,45
734036,2,6,7,7,0,7,54
829712,2,6,7,7,0,7,47
829730,2,6,7,5,0,5,52
829766,2,6,7,2,0,2,38
829772,2,6,7,9,0,9,50
829782,2,6,7,3,0,3,58
829798,2,6,7,7,0,7,56
829806,2,6,7,20,0,20,48
980918,2,6,7,5,5,10,38
980926,2,6,7,11,0,11,62
980950,2,6,7,6,0,6,28
980966,2,6,7,2,0,2,63
980976,2,6,7,10,1,11,62
980988,2,6,7,7,0,7,57
980998,2,6,7,7,0,7,56
981008,2,6,7,8,0,8,45
1082595,2,6,7,10,0,10,53
1082611,2,6,7,5,0,5,61
1082614,2,6,7,4,1,5,28
1082630,2,6,7,7,1,8,70
1082632,2,6,7,10,0,10,73
1082635,2,6,7,2,0,2,37
1082640,2,6,7,7,0,7,71
1082646,2,6,7,5,0,5,47
335990,1,7,7,7,0,7,54
335999,1,7,7,8,0,8,35
336009,1,7,7,4,0,4,54
336029,1,7,7,3,4,7,64
336037,1,7,7,6,4,10,70
336041,1,7,7,13,0,13,42
392186,1,7,7,5,0,5,45
392202,1,7,7,11,0,11,72
392208,1,7,7,2,0,2,42
392213,1,7,7,3,0,3,28
392220,1,7,7,2,0,2,32
392223,1,7,7,5,0,5,51
392232,1,7,7,2,0,2,51
392240,1,7,7,12,1,13,43
419112,1,7,7,6,0,6,75
419119,1,7,7,13,0,13,80
419124,1,7,7,12,0,12,57
419135,1,7,7,10,1,11,63
419143,1,7,7,1,0,1,54
419151,1,7,7,6,0,6,57
419155,1,7,7,5,1,6,53
419157,1,7,7,10,0,10,53
419162,1,7,7,3,1,4,38
419166,1,7,7,5,0,5,47
419167,1,7,7,8,0,8,62
501215,1,7,7,2,2,4,48
501226,1,7,7,8,0,8,48
501229,1,7,7,7,1,8,65
501236,1,7,7,4,0,4,35
501242,1,7,7,5,0,5,40
501246,1,7,7,7,0,7,56
501251,1,7,7,4,0,4,54
501268,1,7,7,5,0,5,31
548322,1,7,7,7,0,7,61
548330,1,7,7,7,0,7,30
548339,1,7,7,3,0,3,42
548356,1,7,7,7,0,7,49
548365,1,7,7,4,0,4,29
548368,1,7,7,4,1,5,54
598007,1,7,7,7,1,8,49
598011,1,7,7,9,4,13,51
598016,1,7,7,6,0,6,54
598029,1,7,7,11,0,11,31
598038,1,7,7,7,0,7,59
598042,1,7,7,3,0,3,39
598044,1,7,7,1,0,1,42
598051,1,7,7,9,0,9,41
598055,1,7,7,8,1,9,50
598068,1,7,7,11,0,11,60
598078,1,7,7,6,0,6,40
729292,1,7,7,3,1,4,53
729308,1,7,7,6,0,6,37
729314,1,7,7,4,0,4,41
733988,1,7,7,7,1,8,58
734000,1,7,7,4,0,4,46
734014,1,7,7,6,0,6,43
734022,1,7,7,12,0,12,54
734036,1,7,7,6,0,6,71
734050,1,7,7,4,0,4,57
829710,1,7,7,5,0,5,42
829726,1,7,7,4,0,4,35
829734,1,7,7,5,0,5,36
829742,1,7,7,11,0,11,59
829756,1,7,7,3,0,3,49
829774,1,7,7,5,0,5,52
829780,1,7,7,9,0,9,60
829810,1,7,7,2,0,2,48
829822,1,7,7,5,0,5,53
829828,1,7,7,8,0,8,69
980906,1,7,7,2,1,3,40
980922,1,7,7,2,0,2,33
980928,1,7,7,3,0,3,43
980946,1,7,7,9,1,10,49
980990,1,7,7,3,2,5,26
980998,1,7,7,6,0,6,51
981012,1,7,7,4,1,5,54
1082592,1,7,7,2,0,2,63
1082614,1,7,7,8,0,8,56
1082635,1,7,7,4,1,5,65
1082638,1,7,7,6,0,6,42
1082644,1,7,7,6,0,6,57
1082650,1,7,7,9,0,9,41
335994,2,7,7,5,0,5,57
335996,2,7,7,6,1,7,46
336002,2,7,7,1,4,5,43
336013,2,7,7,7,0,7,41
336017,2,7,7,2,3,5,44
336023,2,7,7,1,2,3,81
336033,2,7,7,6,0,6,74
392197,2,7,7,6,1,7,57
392202,2,7,7,1,0,1,50
392205,2,7,7,1,2,3,26
392217,2,7,7,9,0,9,50
392227,2,7,7,2,0,2,44
392230,2,7,7,4,0,4,30
419119,2,7,7,0,1,1,62
419127,2,7,7,4,0,4,61
419130,2,7,7,10,1,11,74
419137,2,7,7,13,0,13,58
419147,2,7,7,2,1,3,49
419170,2,7,7,1,4,5,38
501206,2,7,7,2,1,3,34
501210,2,7,7,5,0,5,45
501223,2,7,7,7,2,9,41
501256,2,7,7,6,0,6,39
501261,2,7,7,2,0,2,28
501272,2,7,7,7,2,9,63
501274,2,7,7,9,0,9,71
501275,2,7,7,8,0,8,60
548311,2,7,7,8,0,8,61
548313,2,7,7,7,0,7,34
548319,2,7,7,2,1,3,32
548344,2,7,7,5,0,5,45
548347,2,7,7,8,0,8,57
548351,2,7,7,3,1,4,35
548360,2,7,7,10,0,10,56
548372,2,7,7,8,0,8,40
548375,2,7,7,9,0,9,35
548382,2,7,7,5,8,13,57
548384,2,7,7,6,0,6,60
598004,2,7,7,11,0,11,49
598024,2,7,7,0,0,0,26
598034,2,7,7,9,0,9,51
598060,2,7,7,1,0,1,38
598065,2,7,7,9,2,11,50
598071,2,7,7,5,0,5,56
598075,2,7,7,16,0,16,72
598077,2,7,7,3,0,3,48
729284,2,7,7,6,0,6,38
729322,2,7,7,5,1,6,38
733978,2,7,7,12,0,12,61
734006,2,7,7,10,0,10,48
734030,2,7,7,6,0,6,68
734046,2,7,7,3,1,4,75
829722,2,7,7,6,0,6,23
829752,2,7,7,9,2,11,59
829788,2,7,7,5,0,5,46
829794,2,7,7,6,0,6,67
829800,2,7,7,13,0,13,58
829820,2,7,7,6,3,9,47
980914,2,7,7,5,0,5,58
980932,2,7,7,9,0,9,60
980938,2,7,7,5,0,5,57
980952,2,7,7,4,0,4,68
980962,2,7,7,4,0,4,51
980978,2,7,7,4,2,6,38
980986,2,7,7,4,0,4,43
1082597,2,7,7,9,0,9,58
1082600,2,7,7,3,0,3,64
1082602,2,7,7,10,0,10,31
1082606,2,7,7,7,0,7,63
1082612,2,7,7,4,1,5,87
1082618,2,7,7,6,0,6,50
1082625,2,7,7,7,0,7,68
1082628,2,7,7,3,0,3,58
1082641,2,7,7,14,0,14,82
1082647,2,7,7,6,0,6,48
1082649,2,7,7,8,0,8,44
335991,1,8,7,6,0,6,45
335993,1,8,7,9,0,9,34
335995,1,8,7,3,0,3,61
336004,1,8,7,4,0,4,54
336007,1,8,7,10,0,10,51
336016,1,8,7,4,0,4,54
336036,1,8,7,3,0,3,45
336042,1,8,7,7,4,11,37
392193,1,8,7,4,0,4,66
392197,1,8,7,12,0,12,67
392206,1,8,7,4,0,4,41
392210,1,8,7,1,0,1,40
392217,1,8,7,9,0,9,46
392221,1,8,7,3,0,3,55
392225,1,8,7,12,0,12,54
392244,1,8,7,14,0,14,45
419115,1,8,7,6,0,6,63
419122,1,8,7,9,0,9,65
419125,1,8,7,10,0,10,57
419131,1,8,7,5,0,5,60
419156,1,8,7,8,0,8,43
419165,1,8,7,13,1,14,52
419169,1,8,7,0,0,0,27
501204,1,8,7,3,4,7,51
501213,1,8,7,10,1,11,52
501217,1,8,7,4,0,4,52
501221,1,8,7,7,0,7,50
501234,1,8,7,0,0,0,20
501248,1,8,7,4,1,5,48
501255,1,8,7,4,0,4,54
501261,1,8,7,5,0,5,37
501269,1,8,7,7,2,9,67
548319,1,8,7,1,0,1,46
548326,1,8,7,8,1,9,59
548331,1,8,7,6,0,6,63
548334,1,8,7,9,0,9,42
548340,1,8,7,9,0,9,48
548346,1,8,7,3,0,3,53
548351,1,8,7,2,0,2,40
548353,1,8,7,3,0,3,36
548361,1,8,7,2,0,2,48
548371,1,8,7,2,0,2,49
548381,1,8,7,7,0,7,30
335999,2,8,7,23,0,23,83
336012,2,8,7,8,0,8,58
336019,2,8,7,3,0,3,58
336025,2,8,7,2,0,2,73
336029,2,8,7,10,0,10,42
336039,2,8,7,10,0,10,43
392189,2,8,7,1,0,1,38
392201,2,8,7,4,0,4,73
392214,2,8,7,10,0,10,62
392228,2,8,7,5,0,5,55
392233,2,8,7,3,0,3,53
392234,2,8,7,3,0,3,49
392241,2,8,7,5,0,5,69
392242,2,8,7,3,0,3,87
419111,2,8,7,4,1,5,67
419135,2,8,7,7,0,7,57
419140,2,8,7,9,1,10,69
419143,2,8,7,4,0,4,44
419146,2,8,7,4,1,5,57
419150,2,8,7,11,0,11,43
419152,2,8,7,1,0,1,38
419161,2,8,7,9,5,14,59
419168,2,8,7,6,1,7,30
501208,2,8,7,9,0,9,39
501229,2,8,7,3,0,3,44
501241,2,8,7,8,0,8,72
501244,2,8,7,5,0,5,46
501264,2,8,7,4,0,4,61
548316,2,8,7,4,0,4,49
548357,2,8,7,6,0,6,53
548364,2,8,7,11,0,11,51
548378,2,8,7,2,0,2,60
501205,1,9,7,7,0,7,68
501212,1,9,7,5,0,5,42
501224,1,9,7,4,0,4,49
501230,1,9,7,7,1,8,40
501247,1,9,7,3,0,3,38
501252,1,9,7,8,1,9,58
501259,1,9,7,14,0,14,76
501215,2,9,7,7,0,7,57
501220,2,9,7,7,0,7,56
501234,2,9,7,3,0,3,32
501238,2,9,7,1,0,1,38
501243,2,9,7,4,0,4,71
501263,2,9,7,9,1,10,97
501266,2,9,7,5,2,7,47
501218,1,10,7,3,0,3,66
501223,1,10,7,2,0,2,35
501233,1,10,7,4,0,4,41
501240,1,10,7,6,0,6,55
501264,1,10,7,6,0,6,45
501267,1,10,7,3,0,3,32
548313,1,10,7,4,0,4,34
548318,1,10,7,3,2,5,43
548324,1,10,7,2,1,3,32
548332,1,10,7,4,1,5,63
548338,1,10,7,4,0,4,56
548342,1,10,7,11,0,11,39
548363,1,10,7,3,0,3,38
598008,1,10,7,3,0,3,27
598020,1,10,7,4,1,5,53
598030,1,10,7,9,0,9,57
598052,1,10,7,5,0,5,66
598060,1,10,7,10,0,10,46
598066,1,10,7,3,0,3,45
598072,1,10,7,7,1,8,48
501207,2,10,7,10,0,10,54
501212,2,10,7,7,0,7,51
501231,2,10,7,3,0,3,43
501237,2,10,7,3,0,3,45
501246,2,10,7,7,0,7,38
501253,2,10,7,5,0,5,45
501255,2,10,7,3,0,3,55
548327,2,10,7,5,0,5,61
548335,2,10,7,2,0,2,55
548346,2,10,7,9,0,9,53
548353,2,10,7,4,2,6,54
548356,2,10,7,3,0,3,40
548358,2,10,7,5,0,5,50
548367,2,10,7,6,0,6,56
548370,2,10,7,4,0,4,37
548380,2,10,7,4,2,6,46
598005,2,10,7,8,1,9,36
598014,2,10,7,3,0,3,67
598016,2,10,7,6,0,6,46
598023,2,10,7,8,0,8,49
598032,2,10,7,3,0,3,46
598040,2,10,7,15,0,15,58
598043,2,10,7,3,1,4,50
598047,2,10,7,7,0,7,46
598058,2,10,7,3,2,5,39
598005,1,11,7,8,0,8,46
598023,1,11,7,4,1,5,30
598035,1,11,7,9,0,9,49
598037,1,11,7,6,3,9,38
598053,1,11,7,5,0,5,45
598061,1,11,7,11,0,11,48
598065,1,11,7,11,0,11,63
598070,1,11,7,9,0,9,30
598076,1,11,7,4,0,4,31
729290,1,11,7,3,0,3,44
729306,1,11,7,2,0,2,57
729316,1,11,7,10,0,10,47
729322,1,11,7,4,0,4,48
733982,1,11,7,6,0,6,53
733994,1,11,7,7,0,7,57
734006,1,11,7,6,0,6,49
734012,1,11,7,2,0,2,57
734020,1,11,7,8,1,9,50
734042,1,11,7,12,1,13,62
829732,1,11,7,5,0,5,40
829748,1,11,7,7,0,7,50
829764,1,11,7,5,0,5,61
829778,1,11,7,3,1,4,80
829792,1,11,7,2,0,2,58
829798,1,11,7,6,0,6,47
829804,1,11,7,1,1,2,58
829812,1,11,7,20,1,21,89
829820,1,11,7,3,0,3,32
980920,1,11,7,5,0,5,41
980948,1,11,7,2,0,2,29
980958,1,11,7,8,0,8,57
980978,1,11,7,10,0,10,61
980984,1,11,7,4,2,6,40
980988,1,11,7,3,0,3,54
981008,1,11,7,4,0,4,50
981020,1,11,7,4,0,4,47
981024,1,11,7,6,0,6,65
1082591,1,11,7,5,0,5,64
1082600,1,11,7,15,0,15,49
1082609,1,11,7,11,0,11,40
1082611,1,11,7,15,1,16,55
1082615,1,11,7,8,0,8,53
1082623,1,11,7,12,0,12,72
1082627,1,11,7,8,0,8,87
1082630,1,11,7,1,0,1,67
1082648,1,11,7,7,0,7,37
598009,2,11,7,5,1,6,43
598015,2,11,7,5,0,5,43
598018,2,11,7,4,2,6,45
598026,2,11,7,10,0,10,43
598044,2,11,7,7,0,7,43
598049,2,11,7,2,0,2,43
598056,2,11,7,3,0,3,52
598074,2,11,7,4,0,4,49
729300,2,11,7,4,0,4,49
734026,2,11,7,3,1,4,55
734034,2,11,7,7,0,7,71
829716,2,11,7,7,5,12,58
829724,2,11,7,8,0,8,73
829736,2,11,7,3,0,3,53
829756,2,11,7,5,0,5,57
829786,2,11,7,19,0,19,52
980912,2,11,7,7,1,8,64
980928,2,11,7,3,1,4,37
980934,2,11,7,7,0,7,70
980940,2,11,7,9,1,10,75
980972,2,11,7,1,0,1,39
980996,2,11,7,6,0,6,61
981014,2,11,7,3,0,3,51
981022,2,11,7,3,0,3,49
1082596,2,11,7,7,1,8,67
1082604,2,11,7,2,0,2,47
1082634,2,11,7,2,0,2,49
1082638,2,11,7,8,1,9,52
1082643,2,11,7,5,0,5,52
980916,1,12,7,9,0,9,66
980924,1,12,7,4,0,4,53
980944,1,12,7,12,0,12,43
980954,1,12,7,5,2,7,55
980962,1,12,7,19,1,20,74
980974,1,12,7,7,0,7,67
980994,1,12,7,8,0,8,45
1082594,1,12,7,7,0,7,42
1082603,1,12,7,9,0,9,73
1082607,1,12,7,5,1,6,61
1082618,1,12,7,7,0,7,55
1082620,1,12,7,5,0,5,62
1082624,1,12,7,8,0,8,51
1082634,1,12,7,5,0,5,40
1082647,1,12,7,9,0,9,42
980906,2,12,7,2,2,4,61
980936,2,12,7,4,1,5,41
980948,2,12,7,17,0,17,63
980970,2,12,7,3,0,3,53
980984,2,12,7,5,0,5,30
981002,2,12,7,2,0,2,46
981010,2,12,7,3,0,3,47
1082592,2,12,7,4,0,4,63
1082599,2,12,7,2,0,2,52
1082615,2,12,7,3,0,3,58
1082629,2,12,7,4,0,4,47
1082631,2,12,7,3,0,3,77
1082642,2,12,7,8,1,9,62
1082645,2,12,7,6,0,6,49
1082650,2,12,7,4,1,5,43
980934,1,13,7,5,0,5,55
980950,1,13,7,11,0,11,82
980966,1,13,7,4,0,4,39
980972,1,13,7,4,2,6,32
981018,1,13,7,8,2,10,33
981022,1,13,7,8,0,8,46
1082593,1,13,7,12,0,12,64
1082596,1,13,7,6,0,6,46
1082606,1,13,7,3,0,3,49
1082625,1,13,7,2,1,3,51
1082629,1,13,7,10,1,11,66
1082632,1,13,7,6,0,6,64
1082640,1,13,7,12,0,12,62
1082643,1,13,7,10,2,12,73
980910,2,13,7,11,0,11,68
980916,2,13,7,13,0,13,75
980922,2,13,7,9,2,11,53
980942,2,13,7,5,1,6,78
980954,2,13,7,12,0,12,84
980960,2,13,7,2,1,3,39
980980,2,13,7,17,0,17,63
980992,2,13,7,3,0,3,44
981006,2,13,7,9,7,16,71
981012,2,13,7,10,0,10,80
1082603,2,13,7,10,0,10,71
1082610,2,13,7,7,3,10,67
1082613,2,13,7,7,0,7,79
1082616,2,13,7,8,0,8,58
1082621,2,13,7,2,0,2,51
1082637,2,13,7,11,0,11,69
335987,1,1,8,5,0,5,73
335998,1,1,8,2,0,2,65
336002,1,1,8,2,0,2,49
336015,1,1,8,4,0,4,49
336019,1,1,8,9,1,10,58
336022,1,1,8,6,0,6,54
336026,1,1,8,0,0,0,29
336030,1,1,8,6,0,6,46
336032,1,1,8,6,0,6,46
392189,1,1,8,1,1,2,25
392204,1,1,8,5,0,5,53
392212,1,1,8,6,0,6,36
392216,1,1,8,3,0,3,61
392224,1,1,8,3,0,3,46
392226,1,1,8,1,0,1,47
392233,1,1,8,5,1,6,40
419111,1,1,8,3,0,3,49
419127,1,1,8,10,0,10,56
419132,1,1,8,1,0,1,56
419140,1,1,8,9,0,9,68
419144,1,1,8,3,0,3,58
419149,1,1,8,8,0,8,73
419153,1,1,8,4,0,4,76
419158,1,1,8,4,5,9,39
501208,1,1,8,2,0,2,51
501227,1,1,8,4,0,4,63
501235,1,1,8,5,0,5,55
501244,1,1,8,9,0,9,54
501260,1,1,8,2,0,2,41
501272,1,1,8,8,0,8,60
501274,1,1,8,10,0,10,40
548312,1,1,8,6,0,6,62
548320,1,1,8,13,0,13,76
548349,1,1,8,10,0,10,65
548358,1,1,8,6,1,7,82
548373,1,1,8,15,0,15,72
548375,1,1,8,5,1,6,44
548380,1,1,8,5,1,6,38
548383,1,1,8,4,0,4,55
598013,1,1,8,7,0,7,54
598018,1,1,8,5,0,5,62
598027,1,1,8,6,0,6,55
598034,1,1,8,3,0,3,68
598045,1,1,8,7,0,7,49
598058,1,1,8,2,0,2,54
598074,1,1,8,5,0,5,47
729284,1,1,8,7,0,7,44
729294,1,1,8,6,0,6,50
729304,1,1,8,9,0,9,66
734032,1,1,8,7,0,7,63
734048,1,1,8,9,0,9,67
829718,1,1,8,4,0,4,62
829766,1,1,8,11,0,11,62
829776,1,1,8,13,0,13,86
829786,1,1,8,8,0,8,68
980914,1,1,8,6,0,6,58
980952,1,1,8,4,0,4,71
980968,1,1,8,8,0,8,51
980980,1,1,8,7,1,8,41
981000,1,1,8,7,0,7,74
981006,1,1,8,2,0,2,49
981014,1,1,8,9,0,9,63
1082597,1,1,8,2,0,2,67
1082604,1,1,8,6,0,6,53
1082613,1,1,8,5,1,6,77
1082617,1,1,8,5,0,5,73
1082631,1,1,8,8,0,8,52
1082649,1,1,8,5,0,5,36
335991,2,1,8,1,0,1,34
336005,2,1,8,15,1,16,70
336008,2,1,8,7,0,7,42
336040,2,1,8,5,0,5,59
392191,2,1,8,10,0,10,76
392195,2,1,8,13,4,17,60
392202,2,1,8,3,0,3,53
392208,2,1,8,5,0,5,44
392236,2,1,8,4,0,4,64
392238,2,1,8,5,0,5,35
419114,2,1,8,2,0,2,69
419118,2,1,8,3,2,5,54
419123,2,1,8,7,0,7,50
419136,2,1,8,5,0,5,50
419163,2,1,8,8,1,9,56
419166,2,1,8,7,0,7,60
501203,2,1,8,4,0,4,60
501214,2,1,8,9,0,9,76
501219,2,1,8,4,1,5,36
501224,2,1,8,7,0,7,49
501239,2,1,8,4,0,4,58
501247,2,1,8,5,0,5,55
501250,2,1,8,5,0,5,44
501267,2,1,8,9,1,10,60
548317,2,1,8,7,1,8,42
548325,2,1,8,3,4,7,52
548328,2,1,8,7,0,7,61
548333,2,1,8,4,0,4,60
548340,2,1,8,6,2,8,52
548352,2,1,8,9,2,11,58
548362,2,1,8,3,1,4,72
548368,2,1,8,9,0,9,49
548386,2,1,8,8,0,8,77
598003,2,1,8,6,0,6,58
598010,2,1,8,2,1,3,46
598021,2,1,8,6,0,6,65
598036,2,1,8,3,0,3,55
598039,2,1,8,5,0,5,72
598048,2,1,8,10,0,10,65
598055,2,1,8,6,0,6,52
598062,2,1,8,8,0,8,46
598066,2,1,8,9,0,9,54
729312,2,1,8,3,0,3,31
729320,2,1,8,8,0,8,46
733976,2,1,8,8,2,10,59
733984,2,1,8,5,0,5,66
733990,2,1,8,8,1,9,72
734002,2,1,8,4,0,4,72
734014,2,1,8,2,1,3,53
734020,2,1,8,9,0,9,45
734028,2,1,8,4,1,5,69
734042,2,1,8,4,0,4,57
734054,2,1,8,6,0,6,73
829710,2,1,8,13,0,13,62
829728,2,1,8,9,0,9,53
829738,2,1,8,0,0,0,60
829744,2,1,8,10,0,10,62
829748,2,1,8,14,0,14,74
829770,2,1,8,3,0,3,64
829796,2,1,8,5,0,5,66
829810,2,1,8,2,2,4,58
829816,2,1,8,11,0,11,77
980908,2,1,8,4,0,4,53
980920,2,1,8,8,0,8,50
980930,2,1,8,7,1,8,80
980944,2,1,8,6,0,6,68
980956,2,1,8,8,0,8,59
980964,2,1,8,5,2,7,59
981020,2,1,8,3,0,3,56
1082593,2,1,8,7,0,7,103
1082601,2,1,8,10,0,10,99
1082608,2,1,8,9,0,9,61
1082620,2,1,8,20,0,20,76
1082622,2,1,8,19,0,19,80
1082627,2,1,8,6,0,6,58
1082636,2,1,8,5,0,5,110
1082639,2,1,8,3,1,4,68
1082644,2,1,8,17,0,17,80
335997,1,2,8,4,0,4,68
336011,1,2,8,8,0,8,40
336017,1,2,8,1,0,1,40
336021,1,2,8,6,0,6,59
336031,1,2,8,18,0,18,61
336034,1,2,8,4,2,6,33
336039,1,2,8,6,0,6,57
392187,1,2,8,7,0,7,46
392196,1,2,8,9,0,9,62
392199,1,2,8,13,0,13,62
392209,1,2,8,8,0,8,52
392218,1,2,8,2,0,2,40
392241,1,2,8,12,0,12,51
419114,1,2,8,7,2,9,44
419128,1,2,8,5,2,7,59
419138,1,2,8,4,0,4,59
419150,1,2,8,4,0,4,58
501210,1,2,8,6,0,6,35
501237,1,2,8,9,0,9,67
501249,1,2,8,22,0,22,77
501273,1,2,8,8,1,9,60
501275,1,2,8,14,0,14,90
548315,1,2,8,4,0,4,59
548323,1,2,8,5,2,7,69
548341,1,2,8,10,0,10,50
548355,1,2,8,7,0,7,44
548367,1,2,8,8,0,8,77
548372,1,2,8,4,0,4,52
548377,1,2,8,13,0,13,64
598004,1,2,8,7,1,8,44
598009,1,2,8,1,0,1,43
598017,1,2,8,11,0,11,46
598032,1,2,8,29,0,29,109
598041,1,2,8,5,0,5,66
598047,1,2,8,6,0,6,46
598050,1,2,8,3,0,3,40
598059,1,2,8,7,0,7,55
598062,1,2,8,14,0,14,42
598069,1,2,8,5,1,6,73
598073,1,2,8,16,0,16,106
729310,1,2,8,0,1,1,27
729318,1,2,8,6,0,6,56
734004,1,2,8,7,0,7,40
734010,1,2,8,6,1,7,44
734026,1,2,8,7,0,7,36
734040,1,2,8,2,0,2,41
829724,1,2,8,2,0,2,59
829768,1,2,8,2,0,2,69
829790,1,2,8,8,0,8,79
829800,1,2,8,15,0,15,61
829824,1,2,8,2,0,2,46
829826,1,2,8,2,0,2,38
980912,1,2,8,9,0,9,61
980926,1,2,8,7,0,7,79
980932,1,2,8,7,3,10,66
980936,1,2,8,4,0,4,57
980942,1,2,8,5,0,5,60
980964,1,2,8,9,0,9,60
980982,1,2,8,3,0,3,64
980986,1,2,8,4,0,4,37
980992,1,2,8,9,0,9,55
981004,1,2,8,11,0,11,93
1082595,1,2,8,8,0,8,53
1082598,1,2,8,3,0,3,34
1082602,1,2,8,3,0,3,53
1082610,1,2,8,21,0,21,75
1082621,1,2,8,11,0,11,56
1082628,1,2,8,6,1,7,63
1082636,1,2,8,5,0,5,54
1082646,1,2,8,7,0,7,48
335987,2,2,8,4,1,5,38
335990,2,2,8,8,0,8,54
336001,2,2,8,13,0,13,69
336003,2,2,8,5,1,6,65
336007,2,2,8,7,0,7,53
336015,2,2,8,2,1,3,41
336028,2,2,8,4,0,4,31
392190,2,2,8,3,0,3,51
392193,2,2,8,4,1,5,43
392204,2,2,8,3,1,4,53
392213,2,2,8,8,0,8,62
392223,2,2,8,2,2,4,47
392226,2,2,8,7,0,7,58
392229,2,2,8,8,0,8,46
392237,2,2,8,10,0,10,43
392243,2,2,8,5,0,5,68
392244,2,2,8,11,0,11,53
419117,2,2,8,7,0,7,74
419120,2,2,8,5,0,5,67
419124,2,2,8,4,0,4,68
419133,2,2,8,4,0,4,59
419141,2,2,8,11,0,11,65
419145,2,2,8,3,0,3,45
419153,2,2,8,10,0,10,61
419156,2,2,8,13,2,15,61
419159,2,2,8,3,0,3,72
419162,2,2,8,10,0,10,48
419167,2,2,8,6,0,6,62
419169,2,2,8,7,0,7,42
501205,2,2,8,6,0,6,65
501213,2,2,8,8,0,8,39
501216,2,2,8,14,0,14,52
501227,2,2,8,14,0,14,74
501232,2,2,8,10,0,10,88
501252,2,2,8,10,0,10,94
501257,2,2,8,8,1,9,74
501260,2,2,8,5,0,5,75
501265,2,2,8,12,0,12,55
501271,2,2,8,4,1,5,53
501276,2,2,8,10,0,10,60
548320,2,2,8,5,0,5,28
548329,2,2,8,4,0,4,63
548332,2,2,8,3,0,3,50
548336,2,2,8,9,0,9,48
548349,2,2,8,6,2,8,46
548361,2,2,8,10,0,10,66
548365,2,2,8,8,0,8,47
548381,2,2,8,2,0,2,46
598013,2,2,8,6,0,6,56
598022,2,2,8,12,0,12,64
598028,2,2,8,4,1,5,58
598038,2,2,8,3,3,6,44
598053,2,2,8,2,0,2,50
729286,2,2,8,4,1,5,60
729292,2,2,8,4,1,5,41
729304,2,2,8,6,0,6,67
733982,2,2,8,6,1,7,45
733988,2,2,8,4,1,5,72
733996,2,2,8,1,0,1,40
734018,2,2,8,3,0,3,36
734032,2,2,8,4,0,4,50
829718,2,2,8,7,2,9,56
829742,2,2,8,10,1,11,48
829750,2,2,8,16,1,17,61
829754,2,2,8,6,0,6,66
829762,2,2,8,12,0,12,73
829776,2,2,8,6,1,7,87
829784,2,2,8,7,0,7,56
829808,2,2,8,3,2,5,74
980958,2,2,8,12,0,12,64
980974,2,2,8,8,1,9,59
981000,2,2,8,7,0,7,72
981016,2,2,8,14,0,14,68
981018,2,2,8,6,0,6,47
981024,2,2,8,9,1,10,79
1082591,2,2,8,13,0,13,74
1082607,2,2,8,3,1,4,53
1082617,2,2,8,3,0,3,43
1082624,2,2,8,2,0,2,45
1082633,2,2,8,2,0,2,52
335988,1,3,8,8,0,8,70
335994,1,3,8,5,0,5,64
336001,1,3,8,7,0,7,50
336006,1,3,8,9,2,11,65
336010,1,3,8,5,0,5,46
336012,1,3,8,7,0,7,50
336018,1,3,8,4,0,4,68
336023,1,3,8,5,1,6,42
336045,1,3,8,5,1,6,57
392190,1,3,8,3,5,8,85
392201,1,3,8,4,0,4,69
392207,1,3,8,8,0,8,55
392211,1,3,8,2,0,2,60
392214,1,3,8,3,4,7,68
392219,1,3,8,8,0,8,70
392229,1,3,8,4,1,5,59
392236,1,3,8,7,0,7,74
392239,1,3,8,6,1,7,61
392243,1,3,8,7,0,7,68
419118,1,3,8,5,2,7,48
419130,1,3,8,5,1,6,61
419142,1,3,8,5,0,5,82
419147,1,3,8,6,1,7,60
419152,1,3,8,4,0,4,65
419160,1,3,8,8,0,8,52
419168,1,3,8,6,1,7,50
419170,1,3,8,1,0,1,44
501203,1,3,8,6,0,6,63
501211,1,3,8,8,0,8,47
501216,1,3,8,11,1,12,66
501220,1,3,8,7,0,7,54
501231,1,3,8,10,0,10,58
501241,1,3,8,9,0,9,46
501250,1,3,8,5,0,5,25
501254,1,3,8,4,0,4,70
501258,1,3,8,4,0,4,47
501266,1,3,8,4,0,4,51
501271,1,3,8,5,0,5,32
501276,1,3,8,12,0,12,73
548311,1,3,8,14,0,14,62
548316,1,3,8,8,0,8,63
548321,1,3,8,6,0,6,53
548327,1,3,8,4,2,6,55
548335,1,3,8,12,0,12,55
548352,1,3,8,10,0,10,60
548357,1,3,8,11,0,11,69
548360,1,3,8,2,1,3,60
548376,1,3,8,14,0,14,42
548384,1,3,8,4,1,5,41
548385,1,3,8,4,0,4,68
548386,1,3,8,4,2,6,69
598025,1,3,8,1,1,2,50
598039,1,3,8,14,0,14,86
598043,1,3,8,7,0,7,41
598046,1,3,8,4,1,5,49
598056,1,3,8,10,0,10,65
598063,1,3,8,15,0,15,59
598067,1,3,8,2,0,2,63
598075,1,3,8,3,0,3,55
729288,1,3,8,13,0,13,89
729298,1,3,8,3,0,3,46
729302,1,3,8,10,0,10,63
733976,1,3,8,8,0,8,59
734018,1,3,8,3,0,3,48
734028,1,3,8,9,0,9,50
734034,1,3,8,4,0,4,72
829712,1,3,8,6,0,6,71
829716,1,3,8,9,1,10,75
829728,1,3,8,6,1,7,80
829740,1,3,8,9,0,9,49
829750,1,3,8,17,0,17,64
829758,1,3,8,7,0,7,81
829770,1,3,8,6,0,6,61
829784,1,3,8,3,1,4,48
829794,1,3,8,10,0,10,59
829802,1,3,8,5,0,5,48
829806,1,3,8,10,0,10,34
335998,2,3,8,10,1,11,66
336014,2,3,8,11,2,13,84
336030,2,3,8,7,1,8,55
336034,2,3,8,3,0,3,56
336038,2,3,8,8,1,9,81
336042,2,3,8,3,3,6,59
336044,2,3,8,9,0,9,53
392186,2,3,8,2,0,2,57
392194,2,3,8,4,1,5,90
392207,2,3,8,1,0,1,43
392222,2,3,8,9,0,9,49
392232,2,3,8,4,0,4,43
419115,2,3,8,4,0,4,54
419121,2,3,8,21,0,21,85
419126,2,3,8,9,0,9,60
419128,2,3,8,13,0,13,46
419134,2,3,8,5,0,5,73
419138,2,3,8,9,0,9,71
419158,2,3,8,6,1,7,83
419164,2,3,8,13,1,14,74
501226,2,3,8,8,0,8,61
501233,2,3,8,5,1,6,39
501245,2,3,8,4,0,4,57
501273,2,3,8,8,0,8,36
548323,2,3,8,8,0,8,65
548337,2,3,8,4,0,4,57
548348,2,3,8,6,0,6,63
548366,2,3,8,2,0,2,42
548369,2,3,8,8,0,8,63
548373,2,3,8,13,4,17,75
598007,2,3,8,4,0,4,44
598012,2,3,8,3,0,3,46
598017,2,3,8,9,0,9,46
598020,2,3,8,9,0,9,54
598027,2,3,8,7,0,7,37
598031,2,3,8,9,0,9,70
598035,2,3,8,8,0,8,68
598051,2,3,8,2,0,2,36
598073,2,3,8,14,0,14,82
598078,2,3,8,3,0,3,41
729308,2,3,8,2,0,2,62
729316,2,3,8,12,0,12,65
733986,2,3,8,2,4,6,58
733992,2,3,8,7,1,8,61
734000,2,3,8,12,2,14,56
734008,2,3,8,11,1,12,64
734040,2,3,8,7,0,7,76
734050,2,3,8,6,2,8,72
734052,2,3,8,4,0,4,107
829734,2,3,8,8,0,8,115
829778,2,3,8,6,1,7,71
829814,2,3,8,7,1,8,63
829822,2,3,8,5,0,5,66
829826,2,3,8,6,0,6,47
829828,2,3,8,12,0,12,50
335992,1,4,8,8,3,11,70
335996,1,4,8,11,0,11,81
336008,1,4,8,11,0,11,68
336024,1,4,8,7,0,7,75
336033,1,4,8,11,0,11,64
336040,1,4,8,3,0,3,61
336044,1,4,8,2,0,2,37
392188,1,4,8,3,0,3,71
392191,1,4,8,8,0,8,56
392200,1,4,8,4,0,4,46
392205,1,4,8,8,0,8,40
392227,1,4,8,2,0,2,63
392234,1,4,8,3,0,3,49
419113,1,4,8,6,0,6,55
419117,1,4,8,4,1,5,60
419126,1,4,8,13,0,13,54
419137,1,4,8,8,0,8,63
419141,1,4,8,9,5,14,60
419148,1,4,8,5,0,5,63
419161,1,4,8,8,0,8,58
419164,1,4,8,4,0,4,62
501207,1,4,8,4,0,4,45
501225,1,4,8,6,0,6,91
501239,1,4,8,3,0,3,44
501253,1,4,8,6,0,6,51
501256,1,4,8,6,0,6,60
501262,1,4,8,11,1,12,52
501265,1,4,8,21,0,21,62
548328,1,4,8,10,0,10,41
548333,1,4,8,4,0,4,54
548336,1,4,8,6,0,6,57
548344,1,4,8,2,0,2,46
548348,1,4,8,17,0,17,68
548364,1,4,8,9,3,12,68
548374,1,4,8,2,0,2,56
548379,1,4,8,8,0,8,35
598012,1,4,8,8,2,10,60
598019,1,4,8,4,0,4,43
598021,1,4,8,9,1,10,54
598026,1,4,8,3,0,3,45
598033,1,4,8,6,1,7,63
598036,1,4,8,10,0,10,60
598057,1,4,8,7,0,7,58
598071,1,4,8,19,1,20,63
729300,1,4,8,3,2,5,57
729312,1,4,8,3,0,3,59
733978,1,4,8,9,0,9,51
733992,1,4,8,5,1,6,51
733996,1,4,8,18,1,19,88
734002,1,4,8,9,0,9,62
734030,1,4,8,7,5,12,71
734038,1,4,8,11,0,11,67
734052,1,4,8,10,1,11,92
734054,1,4,8,14,0,14,50
829722,1,4,8,10,0,10,72
829730,1,4,8,6,1,7,52
829738,1,4,8,4,0,4,54
829772,1,4,8,6,0,6,37
829796,1,4,8,11,0,11,59
829808,1,4,8,5,0,5,90
829814,1,4,8,5,0,5,48
980910,1,4,8,14,0,14,71
980918,1,4,8,6,1,7,52
980930,1,4,8,4,0,4,48
980940,1,4,8,12,0,12,51
980960,1,4,8,3,0,3,70
980976,1,4,8,8,0,8,56
980996,1,4,8,10,0,10,61
981010,1,4,8,7,0,7,63
1082601,1,4,8,5,0,5,67
1082612,1,4,8,6,0,6,58
1082616,1,4,8,14,0,14,67
1082633,1,4,8,3,0,3,42
1082637,1,4,8,9,0,9,63
1082639,1,4,8,9,0,9,54
1082641,1,4,8,15,0,15,100
1082645,1,4,8,5,0,5,39
335988,2,4,8,15,0,15,84
336000,2,4,8,6,2,8,70
336004,2,4,8,9,0,9,55
336011,2,4,8,4,4,8,63
336018,2,4,8,8,0,8,53
336021,2,4,8,9,4,13,58
336027,2,4,8,8,1,9,94
336036,2,4,8,6,2,8,86
392196,2,4,8,4,0,4,61
392209,2,4,8,7,0,7,53
392212,2,4,8,9,0,9,68
392215,2,4,8,7,7,14,45
392219,2,4,8,11,0,11,68
392221,2,4,8,4,0,4,60
392231,2,4,8,3,0,3,38
392239,2,4,8,3,1,4,36
419122,2,4,8,9,0,9,48
419129,2,4,8,6,0,6,87
419132,2,4,8,6,0,6,58
419144,2,4,8,11,0,11,86
419151,2,4,8,7,1,8,68
419154,2,4,8,6,0,6,48
501211,2,4,8,5,0,5,77
501217,2,4,8,5,0,5,80
501228,2,4,8,16,0,16,75
501242,2,4,8,6,4,10,43
501249,2,4,8,3,0,3,52
501259,2,4,8,7,0,7,61
501269,2,4,8,13,0,13,66
548314,2,4,8,7,0,7,61
548318,2,4,8,7,0,7,30
548324,2,4,8,5,0,5,50
548339,2,4,8,7,0,7,59
548355,2,4,8,9,0,9,70
548359,2,4,8,6,0,6,57
548371,2,4,8,3,0,3,58
548376,2,4,8,4,0,4,55
598008,2,4,8,4,0,4,67
598030,2,4,8,6,0,6,65
598042,2,4,8,7,0,7,67
598046,2,4,8,10,0,10,53
598050,2,4,8,9,1,10,61
598061,2,4,8,5,0,5,50
598064,2,4,8,3,0,3,62
598069,2,4,8,7,0,7,52
729288,2,4,8,11,0,11,83
729296,2,4,8,4,0,4,60
729318,2,4,8,6,5,11,51
734012,2,4,8,18,0,18,113
734024,2,4,8,10,0,10,85
734044,2,4,8,6,0,6,66
734048,2,4,8,1,1,2,55
829714,2,4,8,8,0,8,61
829746,2,4,8,6,1,7,54
829758,2,4,8,2,4,6,48
829764,2,4,8,6,0,6,48
829780,2,4,8,8,0,8,58
829790,2,4,8,9,0,9,48
829804,2,4,8,6,1,7,62
980924,2,4,8,4,0,4,58
980946,2,4,8,7,0,7,57
980968,2,4,8,5,0,5,48
980982,2,4,8,8,0,8,65
980990,2,4,8,5,0,5,47
981004,2,4,8,2,0,2,78
1082594,2,4,8,3,0,3,62
1082598,2,4,8,10,1,11,78
1082605,2,4,8,1,1,2,49
1082609,2,4,8,4,0,4,57
1082623,2,4,8,1,2,3,70
1082626,2,4,8,9,0,9,68
335989,1,5,8,3,1,4,44
336005,1,5,8,7,0,7,60
336013,1,5,8,12,0,12,68
336028,1,5,8,16,1,17,80
336038,1,5,8,13,0,13,90
336043,1,5,8,6,0,6,71
392195,1,5,8,9,0,9,70
392215,1,5,8,9,0,9,72
392222,1,5,8,5,1,6,47
392230,1,5,8,10,0,10,55
392238,1,5,8,4,1,5,52
419116,1,5,8,0,1,1,50
419120,1,5,8,6,0,6,39
419123,1,5,8,8,0,8,67
419129,1,5,8,3,0,3,63
419134,1,5,8,5,0,5,73
419146,1,5,8,12,0,12,65
419159,1,5,8,11,2,13,44
419163,1,5,8,6,1,7,64
501214,1,5,8,8,0,8,45
501219,1,5,8,4,0,4,43
501245,1,5,8,12,0,12,64
501257,1,5,8,13,0,13,63
501263,1,5,8,18,0,18,56
548314,1,5,8,2,1,3,64
548317,1,5,8,10,1,11,57
548325,1,5,8,1,0,1,48
548329,1,5,8,5,0,5,52
548337,1,5,8,7,0,7,50
548354,1,5,8,8,0,8,70
548359,1,5,8,10,0,10,78
548366,1,5,8,4,0,4,38
548370,1,5,8,5,0,5,56
548378,1,5,8,7,1,8,53
548382,1,5,8,8,0,8,48
598006,1,5,8,5,0,5,55
598010,1,5,8,4,0,4,46
598014,1,5,8,5,0,5,54
598024,1,5,8,7,1,8,69
598028,1,5,8,13,0,13,47
598031,1,5,8,3,0,3,74
598048,1,5,8,8,0,8,47
598077,1,5,8,10,0,10,54
729296,1,5,8,5,0,5,67
729320,1,5,8,4,0,4,53
733984,1,5,8,4,1,5,63
734008,1,5,8,8,3,11,61
734016,1,5,8,8,0,8,67
734046,1,5,8,5,0,5,43
829714,1,5,8,8,0,8,53
829746,1,5,8,8,1,9,59
829754,1,5,8,9,0,9,63
829782,1,5,8,8,0,8,61
829816,1,5,8,4,0,4,84
335992,2,5,8,4,1,5,65
335995,2,5,8,16,0,16,98
335997,2,5,8,9,0,9,61
336010,2,5,8,3,5,8,66
336016,2,5,8,8,0,8,65
336020,2,5,8,10,0,10,43
336024,2,5,8,3,0,3,49
336032,2,5,8,3,1,4,50
336041,2,5,8,1,2,3,50
336045,2,5,8,7,0,7,51
392187,2,5,8,9,0,9,26
392200,2,5,8,3,0,3,41
392203,2,5,8,9,2,11,47
392207,2,5,8,3,0,3,46
392210,2,5,8,9,1,10,45
392218,2,5,8,8,0,8,43
392225,2,5,8,8,0,8,43
392235,2,5,8,11,0,11,37
419112,2,5,8,15,0,15,58
419131,2,5,8,4,0,4,69
419139,2,5,8,11,0,11,65
419142,2,5,8,12,0,12,80
419148,2,5,8,9,0,9,91
419155,2,5,8,7,0,7,47
501204,2,5,8,8,0,8,46
501209,2,5,8,7,0,7,66
501225,2,5,8,1,0,1,49
501230,2,5,8,2,0,2,44
501236,2,5,8,4,0,4,26
501240,2,5,8,3,0,3,46
501254,2,5,8,7,1,8,62
501268,2,5,8,14,1,15,81
548322,2,5,8,11,0,11,65
548331,2,5,8,4,0,4,74
548341,2,5,8,1,0,1,57
548350,2,5,8,8,0,8,55
548363,2,5,8,3,0,3,57
598019,2,5,8,0,0,0,58
598037,2,5,8,2,0,2,42
598041,2,5,8,15,0,15,63
598052,2,5,8,9,0,9,72
598054,2,5,8,6,0,6,61
598057,2,5,8,8,0,8,55
598063,2,5,8,4,0,4,35
598068,2,5,8,15,0,15,47
598070,2,5,8,2,0,2,39
598076,2,5,8,5,0,5,55
729290,2,5,8,6,1,7,43
729302,2,5,8,3,0,3,47
729310,2,5,8,6,0,6,46
733980,2,5,8,5,0,5,52
733994,2,5,8,3,0,3,45
734004,2,5,8,6,0,6,60
734022,2,5,8,2,1,3,61
734038,2,5,8,2,0,2,56
829720,2,5,8,7,0,7,57
829726,2,5,8,8,0,8,57
829732,2,5,8,3,0,3,51
829740,2,5,8,6,0,6,57
829774,2,5,8,8,1,9,71
829792,2,5,8,4,1,5,47
829802,2,5,8,2,0,2,49
829824,2,5,8,5,0,5,55
336000,1,6,8,4,0,4,58
336003,1,6,8,4,0,4,75
336014,1,6,8,8,0,8,67
336020,1,6,8,7,0,7,59
336025,1,6,8,3,0,3,59
336027,1,6,8,13,0,13,88
392194,1,6,8,9,0,9,76
392203,1,6,8,8,0,8,56
392228,1,6,8,8,0,8,68
392231,1,6,8,3,0,3,48
392235,1,6,8,8,0,8,46
392237,1,6,8,5,0,5,50
392242,1,6,8,8,0,8,68
419121,1,6,8,10,2,12,79
419133,1,6,8,4,0,4,79
419136,1,6,8,9,0,9,75
419139,1,6,8,7,1,8,66
419145,1,6,8,8,0,8,65
419154,1,6,8,3,0,3,56
501206,1,6,8,1,0,1,41
501209,1,6,8,2,0,2,38
501228,1,6,8,12,0,12,91
501232,1,6,8,11,0,11,57
501238,1,6,8,2,1,3,39
501243,1,6,8,2,0,2,50
501270,1,6,8,4,0,4,42
548347,1,6,8,7,0,7,70
548350,1,6,8,5,0,5,58
548362,1,6,8,2,0,2,64
548369,1,6,8,5,0,5,37
598003,1,6,8,6,0,6,53
598015,1,6,8,3,0,3,35
598022,1,6,8,3,0,3,52
598040,1,6,8,14,2,16,62
598049,1,6,8,2,0,2,34
598054,1,6,8,2,0,2,48
598064,1,6,8,5,0,5,50
729286,1,6,8,1,0,1,36
733980,1,6,8,7,0,7,57
733986,1,6,8,4,0,4,53
733990,1,6,8,13,1,14,53
733998,1,6,8,7,0,7,67
734024,1,6,8,5,0,5,71
734044,1,6,8,8,0,8,58
829720,1,6,8,3,1,4,58
829736,1,6,8,11,0,11,57
829744,1,6,8,11,0,11,54
829752,1,6,8,7,0,7,56
829762,1,6,8,3,0,3,43
829788,1,6,8,5,0,5,57
829818,1,6,8,4,0,4,61
980908,1,6,8,7,0,7,49
980938,1,6,8,6,0,6,54
980956,1,6,8,7,4,11,54
980970,1,6,8,5,0,5,59
981002,1,6,8,2,0,2,32
981016,1,6,8,14,0,14,62
1082599,1,6,8,5,0,5,71
1082605,1,6,8,6,3,9,64
1082608,1,6,8,4,0,4,63
1082622,1,6,8,6,0,6,66
1082626,1,6,8,2,0,2,31
1082642,1,6,8,10,0,10,73
335989,2,6,8,11,1,12,71
335993,2,6,8,5,0,5,60
336006,2,6,8,9,1,10,93
336009,2,6,8,11,0,11,53
336022,2,6,8,10,1,11,52
336031,2,6,8,5,0,5,95
336037,2,6,8,5,0,5,72
336043,2,6,8,3,0,3,40
392199,2,6,8,8,0,8,58
392206,2,6,8,6,2,8,58
392211,2,6,8,7,0,7,61
392216,2,6,8,2,0,2,62
392220,2,6,8,4,0,4,42
392224,2,6,8,5,0,5,60
392240,2,6,8,9,0,9,72
419113,2,6,8,4,0,4,47
419116,2,6,8,4,0,4,82
419119,2,6,8,9,0,9,71
419125,2,6,8,8,0,8,68
419149,2,6,8,9,1,10,68
419157,2,6,8,5,0,5,78
419160,2,6,8,6,0,6,44
419165,2,6,8,6,0,6,51
501218,2,6,8,10,0,10,85
501221,2,6,8,11,5,16,57
501235,2,6,8,4,0,4,48
501248,2,6,8,23,0,23,55
501251,2,6,8,6,0,6,39
501258,2,6,8,2,0,2,56
501262,2,6,8,3,0,3,52
548312,2,6,8,3,0,3,59
548315,2,6,8,5,0,5,58
548321,2,6,8,11,0,11,64
548326,2,6,8,16,1,17,59
548330,2,6,8,7,1,8,52
548334,2,6,8,12,1,13,87
548338,2,6,8,18,0,18,74
548342,2,6,8,4,0,4,77
548354,2,6,8,11,0,11,84
548374,2,6,8,2,1,3,42
548377,2,6,8,9,0,9,69
548379,2,6,8,11,0,11,78
548383,2,6,8,5,0,5,62
548385,2,6,8,7,1,8,70
598006,2,6,8,7,0,7,53
598011,2,6,8,4,0,4,61
598025,2,6,8,8,0,8,43
598029,2,6,8,9,1,10,80
598033,2,6,8,5,5,10,38
598045,2,6,8,11,0,11,49
598059,2,6,8,3,0,3,64
598067,2,6,8,5,0,5,56
598072,2,6,8,2,0,2,57
729294,2,6,8,4,2,6,66
729298,2,6,8,5,0,5,42
729306,2,6,8,12,0,12,69
729314,2,6,8,9,0,9,40
734010,2,6,8,11,0,11,65
734016,2,6,8,3,1,4,49
734036,2,6,8,3,0,3,57
829712,2,6,8,4,0,4,51
829730,2,6,8,3,1,4,56
829766,2,6,8,13,0,13,51
829772,2,6,8,5,0,5,55
829782,2,6,8,1,0,1,59
829798,2,6,8,4,0,4,60
829806,2,6,8,4,0,4,52
980918,2,6,8,12,0,12,50
980926,2,6,8,4,1,5,67
980950,2,6,8,9,1,10,38
980966,2,6,8,6,0,6,69
980976,2,6,8,9,0,9,71
980988,2,6,8,12,0,12,69
980998,2,6,8,4,0,4,60
981008,2,6,8,7,0,7,52
1082595,2,6,8,10,2,12,65
1082611,2,6,8,13,1,14,75
1082614,2,6,8,6,0,6,34
1082630,2,6,8,2,1,3,73
1082632,2,6,8,10,0,10,83
1082635,2,6,8,3,0,3,40
1082640,2,6,8,2,0,2,73
1082646,2,6,8,4,0,4,51
335990,1,7,8,6,0,6,60
335999,1,7,8,7,0,7,42
336009,1,7,8,4,0,4,58
336029,1,7,8,7,0,7,71
336037,1,7,8,3,0,3,73
336041,1,7,8,4,0,4,46
392186,1,7,8,3,0,3,48
392202,1,7,8,14,0,14,86
392208,1,7,8,11,1,12,54
392213,1,7,8,14,0,14,42
392220,1,7,8,3,1,4,36
392223,1,7,8,2,0,2,53
392232,1,7,8,3,1,4,55
392240,1,7,8,9,1,10,53
419112,1,7,8,7,2,9,84
419119,1,7,8,8,0,8,88
419124,1,7,8,4,1,5,62
419135,1,7,8,5,0,5,68
419143,1,7,8,2,0,2,56
419151,1,7,8,3,0,3,60
419155,1,7,8,9,1,10,63
419157,1,7,8,3,0,3,56
419162,1,7,8,7,1,8,46
419166,1,7,8,7,0,7,54
419167,1,7,8,4,0,4,66
501215,1,7,8,8,1,9,57
501226,1,7,8,7,1,8,56
501229,1,7,8,4,0,4,69
501236,1,7,8,4,1,5,40
501242,1,7,8,4,2,6,46
501246,1,7,8,2,0,2,58
501251,1,7,8,8,0,8,62
501268,1,7,8,9,0,9,40
548322,1,7,8,6,0,6,67
548330,1,7,8,6,1,7,37
548339,1,7,8,8,0,8,50
548356,1,7,8,3,0,3,52
548365,1,7,8,6,2,8,37
548368,1,7,8,6,0,6,60
598007,1,7,8,6,0,6,55
598011,1,7,8,8,0,8,59
598016,1,7,8,2,0,2,56
598029,1,7,8,8,0,8,39
598038,1,7,8,8,0,8,67
598042,1,7,8,5,0,5,44
598044,1,7,8,7,0,7,49
598051,1,7,8,2,0,2,43
598055,1,7,8,9,0,9,59
598068,1,7,8,5,1,6,66
598078,1,7,8,5,0,5,45
729292,1,7,8,5,0,5,58
729308,1,7,8,7,0,7,44
729314,1,7,8,1,0,1,42
733988,1,7,8,7,6,13,71
734000,1,7,8,3,0,3,49
734014,1,7,8,3,0,3,46
734022,1,7,8,10,0,10,64
734036,1,7,8,15,1,16,87
734050,1,7,8,6,0,6,63
829710,1,7,8,6,0,6,48
829726,1,7,8,3,0,3,38
829734,1,7,8,8,0,8,44
829742,1,7,8,3,2,5,64
829756,1,7,8,7,0,7,56
829774,1,7,8,8,0,8,60
829780,1,7,8,12,0,12,72
829810,1,7,8,1,1,2,50
829822,1,7,8,9,0,9,62
829828,1,7,8,9,0,9,78
980906,1,7,8,0,0,0,40
980922,1,7,8,7,1,8,41
980928,1,7,8,4,0,4,47
980946,1,7,8,11,0,11,60
980990,1,7,8,7,1,8,34
980998,1,7,8,10,0,10,61
981012,1,7,8,5,0,5,59
1082592,1,7,8,3,0,3,66
1082614,1,7,8,4,0,4,60
1082635,1,7,8,11,0,11,76
1082638,1,7,8,3,0,3,45
1082644,1,7,8,7,4,11,68
1082650,1,7,8,4,1,5,46
335994,2,7,8,10,1,11,68
335996,2,7,8,14,1,15,61
336002,2,7,8,3,1,4,47
336013,2,7,8,5,0,5,46
336017,2,7,8,16,0,16,60
336023,2,7,8,2,1,3,84
336033,2,7,8,6,1,7,81
392197,2,7,8,8,2,10,67
392202,2,7,8,4,0,4,57
392205,2,7,8,5,0,5,31
392217,2,7,8,9,0,9,59
392227,2,7,8,6,0,6,50
392230,2,7,8,7,1,8,38
419119,2,7,8,3,1,4,75
419127,2,7,8,7,1,8,69
419130,2,7,8,7,1,8,82
419137,2,7,8,3,2,5,63
419147,2,7,8,7,0,7,56
419170,2,7,8,2,0,2,40
501206,2,7,8,8,0,8,42
501210,2,7,8,16,1,17,62
501223,2,7,8,8,2,10,51
501256,2,7,8,6,2,8,47
501261,2,7,8,3,2,5,33
501272,2,7,8,7,0,7,70
501274,2,7,8,11,0,11,82
501275,2,7,8,8,0,8,68
548311,2,7,8,6,2,8,69
548313,2,7,8,7,0,7,41
548319,2,7,8,5,0,5,37
548344,2,7,8,7,0,7,52
548347,2,7,8,4,0,4,61
548351,2,7,8,9,0,9,44
548360,2,7,8,5,0,5,61
548372,2,7,8,5,0,5,45
548375,2,7,8,4,0,4,39
548382,2,7,8,9,0,9,66
548384,2,7,8,8,0,8,68
598004,2,7,8,5,0,5,54
598024,2,7,8,9,0,9,35
598034,2,7,8,14,0,14,65
598060,2,7,8,2,0,2,40
598065,2,7,8,9,0,9,59
598071,2,7,8,3,0,3,59
598075,2,7,8,14,0,14,86
598077,2,7,8,12,1,13,61
729284,2,7,8,3,0,3,41
729322,2,7,8,5,0,5,43
733978,2,7,8,4,0,4,65
734006,2,7,8,3,0,3,51
734030,2,7,8,8,0,8,76
734046,2,7,8,13,1,14,89
829722,2,7,8,2,1,3,26
829752,2,7,8,3,2,5,64
829788,2,7,8,4,0,4,50
829794,2,7,8,6,0,6,73
829800,2,7,8,5,0,5,63
829820,2,7,8,9,0,9,56
980914,2,7,8,5,0,5,63
980932,2,7,8,5,0,5,65
980938,2,7,8,3,0,3,60
980952,2,7,8,7,0,7,75
980962,2,7,8,10,0,10,61
980978,2,7,8,10,0,10,48
980986,2,7,8,8,1,9,52
1082597,2,7,8,13,0,13,71
1082600,2,7,8,9,0,9,73
1082602,2,7,8,2,0,2,33
1082606,2,7,8,6,1,7,70
1082612,2,7,8,14,0,14,101
1082618,2,7,8,6,0,6,56
1082625,2,7,8,3,1,4,72
1082628,2,7,8,4,0,4,62
1082641,2,7,8,4,1,5,87
1082647,2,7,8,3,0,3,51
1082649,2,7,8,6,0,6,50
335991,1,8,8,1,1,2,47
335993,1,8,8,2,0,2,36
335995,1,8,8,11,0,11,72
336004,1,8,8,5,0,5,59
336007,1,8,8,14,0,14,65
336016,1,8,8,7,0,7,61
336036,1,8,8,12,0,12,57
336042,1,8,8,6,1,7,44
392193,1,8,8,5,1,6,72
392197,1,8,8,5,0,5,72
392206,1,8,8,3,4,7,48
392210,1,8,8,2,1,3,43
392217,1,8,8,10,0,10,56
392221,1,8,8,3,0,3,58
392225,1,8,8,5,0,5,59
392244,1,8,8,9,0,9,54
419115,1,8,8,2,1,3,66
419122,1,8,8,12,0,12,77
419125,1,8,8,4,0,4,61
419131,1,8,8,10,0,10,70
419156,1,8,8,4,0,4,47
419165,1,8,8,8,0,8,60
419169,1,8,8,7,0,7,34
501204,1,8,8,3,0,3,54
501213,1,8,8,8,0,8,60
501217,1,8,8,9,0,9,61
501221,1,8,8,16,0,16,66
501234,1,8,8,9,0,9,29
501248,1,8,8,5,0,5,53
501255,1,8,8,5,0,5,59
501261,1,8,8,4,1,5,42
501269,1,8,8,4,5,9,76
548319,1,8,8,4,0,4,50
548326,1,8,8,11,0,11,70
548331,1,8,8,7,0,7,70
548334,1,8,8,8,0,8,50
548340,1,8,8,5,0,5,53
548346,1,8,8,5,0,5,58
548351,1,8,8,3,0,3,43
548353,1,8,8,6,0,6,42
548361,1,8,8,17,0,17,65
548371,1,8,8,9,0,9,58
548381,1,8,8,7,0,7,37
335999,2,8,8,13,1,14,97
336012,2,8,8,11,2,13,71
336019,2,8,8,1,4,5,63
336025,2,8,8,1,0,1,74
336029,2,8,8,5,1,6,48
336039,2,8,8,11,0,11,54
392189,2,8,8,8,0,8,46
392201,2,8,8,2,0,2,75
392214,2,8,8,6,1,7,69
392228,2,8,8,11,0,11,66
392233,2,8,8,9,0,9,62
392234,2,8,8,4,1,5,54
392241,2,8,8,4,1,5,74
392242,2,8,8,4,0,4,91
419111,2,8,8,3,1,4,71
419135,2,8,8,4,0,4,61
419140,2,8,8,6,0,6,75
419143,2,8,8,8,0,8,52
419146,2,8,8,6,0,6,63
419150,2,8,8,15,0,15,58
419152,2,8,8,7,0,7,45
419161,2,8,8,6,0,6,65
419168,2,8,8,7,0,7,37
501208,2,8,8,7,1,8,47
501229,2,8,8,7,6,13,57
501241,2,8,8,3,0,3,75
501244,2,8,8,9,1,10,56
501264,2,8,8,6,0,6,67
548316,2,8,8,8,0,8,57
548357,2,8,8,5,0,5,58
548364,2,8,8,13,0,13,64
548378,2,8,8,2,0,2,62
501205,1,9,8,6,0,6,74
501212,1,9,8,5,2,7,49
501224,1,9,8,2,0,2,51
501230,1,9,8,2,0,2,42
501247,1,9,8,12,1,13,51
501252,1,9,8,6,0,6,64
501259,1,9,8,4,6,10,86
501215,2,9,8,5,0,5,62
501220,2,9,8,10,0,10,66
501234,2,9,8,9,0,9,41
501238,2,9,8,7,0,7,45
501243,2,9,8,4,3,7,78
501263,2,9,8,1,0,1,98
501266,2,9,8,1,0,1,48
501218,1,10,8,9,1,10,76
501223,1,10,8,12,1,13,48
501233,1,10,8,3,0,3,44
501240,1,10,8,11,0,11,66
501264,1,10,8,0,0,0,45
501267,1,10,8,10,0,10,42
548313,1,10,8,6,0,6,40
548318,1,10,8,10,0,10,53
548324,1,10,8,12,0,12,44
548332,1,10,8,10,1,11,74
548338,1,10,8,9,0,9,65
548342,1,10,8,3,0,3,42
548363,1,10,8,6,1,7,45
598008,1,10,8,3,0,3,30
598020,1,10,8,10,0,10,63
598030,1,10,8,4,0,4,61
598052,1,10,8,7,1,8,74
598060,1,10,8,3,1,4,50
598066,1,10,8,5,0,5,50
598072,1,10,8,6,0,6,54
501207,2,10,8,6,0,6,60
501212,2,10,8,4,0,4,55
501231,2,10,8,5,0,5,48
501237,2,10,8,8,0,8,53
501246,2,10,8,7,0,7,45
501253,2,10,8,8,2,10,55
501255,2,10,8,14,0,14,69
548327,2,10,8,2,0,2,63
548335,2,10,8,3,1,4,59
548346,2,10,8,5,0,5,58
548353,2,10,8,4,0,4,58
548356,2,10,8,4,0,4,44
548358,2,10,8,5,0,5,55
548367,2,10,8,15,0,15,71
548370,2,10,8,9,1,10,47
548380,2,10,8,5,1,6,52
598005,2,10,8,2,0,2,38
598014,2,10,8,11,1,12,79
598016,2,10,8,10,1,11,57
598023,2,10,8,6,0,6,55
598032,2,10,8,15,0,15,61
598040,2,10,8,7,0,7,65
598043,2,10,8,5,0,5,55
598047,2,10,8,2,1,3,49
598058,2,10,8,2,0,2,41
598005,1,11,8,4,0,4,50
598023,1,11,8,3,0,3,33
598035,1,11,8,4,0,4,53
598037,1,11,8,6,2,8,46
598053,1,11,8,5,0,5,50
598061,1,11,8,2,1,3,51
598065,1,11,8,7,0,7,70
598070,1,11,8,3,1,4,34
598076,1,11,8,7,0,7,38
729290,1,11,8,6,0,6,50
729306,1,11,8,10,0,10,67
729316,1,11,8,8,0,8,55
729322,1,11,8,10,5,15,63
733982,1,11,8,6,0,6,59
733994,1,11,8,4,0,4,61
734006,1,11,8,11,0,11,60
734012,1,11,8,8,0,8,65
734020,1,11,8,8,0,8,58
734042,1,11,8,7,0,7,69
829732,1,11,8,2,1,3,43
829748,1,11,8,6,0,6,56
829764,1,11,8,4,0,4,65
829778,1,11,8,6,0,6,86
829792,1,11,8,8,1,9,67
829798,1,11,8,7,0,7,54
829804,1,11,8,11,0,11,69
829812,1,11,8,11,0,11,100
829820,1,11,8,7,0,7,39
980920,1,11,8,2,0,2,43
980948,1,11,8,2,1,3,32
980958,1,11,8,6,0,6,63
980978,1,11,8,6,0,6,67
980984,1,11,8,5,0,5,45
980988,1,11,8,7,0,7,61
981008,1,11,8,2,1,3,53
981020,1,11,8,5,1,6,53
981024,1,11,8,10,0,10,75
1082591,1,11,8,11,0,11,75
1082600,1,11,8,2,1,3,52
1082609,1,11,8,2,0,2,42
1082611,1,11,8,9,0,9,64
1082615,1,11,8,2,0,2,55
1082623,1,11,8,11,0,11,83
1082627,1,11,8,7,0,7,94
1082630,1,11,8,8,0,8,75
1082648,1,11,8,2,0,2,39
598009,2,11,8,4,0,4,47
598015,2,11,8,3,0,3,46
598018,2,11,8,10,0,10,55
598026,2,11,8,5,0,5,48
598044,2,11,8,10,0,10,53
598049,2,11,8,3,0,3,46
598056,2,11,8,4,0,4,56
598074,2,11,8,13,0,13,62
729300,2,11,8,3,2,5,54
734026,2,11,8,4,0,4,59
734034,2,11,8,5,0,5,76
829716,2,11,8,4,0,4,62
829724,2,11,8,10,0,10,83
829736,2,11,8,2,0,2,55
829756,2,11,8,6,1,7,64
829786,2,11,8,3,0,3,55
980912,2,11,8,19,0,19,83
980928,2,11,8,11,1,12,49
980934,2,11,8,5,1,6,76
980940,2,11,8,2,1,3,78
980972,2,11,8,4,0,4,43
980996,2,11,8,6,1,7,68
981014,2,11,8,8,0,8,59
981022,2,11,8,12,0,12,61
1082596,2,11,8,5,0,5,72
1082604,2,11,8,1,0,1,48
1082634,2,11,8,10,0,10,59
1082638,2,11,8,13,0,13,65
1082643,2,11,8,6,0,6,58
980916,1,12,8,10,0,10,76
980924,1,12,8,7,5,12,65
980944,1,12,8,4,0,4,47
980954,1,12,8,8,0,8,63
980962,1,12,8,9,1,10,84
980974,1,12,8,8,0,8,75
980994,1,12,8,8,0,8,53
1082594,1,12,8,6,0,6,48
1082603,1,12,8,3,0,3,76
1082607,1,12,8,7,0,7,68
1082618,1,12,8,14,0,14,69
1082620,1,12,8,3,0,3,65
1082624,1,12,8,6,0,6,57
1082634,1,12,8,3,0,3,43
1082647,1,12,8,1,0,1,43
980906,2,12,8,5,0,5,66
980936,2,12,8,12,0,12,53
980948,2,12,8,8,0,8,71
980970,2,12,8,6,0,6,59
980984,2,12,8,10,0,10,40
981002,2,12,8,7,0,7,53
981010,2,12,8,5,0,5,52
1082592,2,12,8,10,0,10,73
1082599,2,12,8,3,0,3,55
1082615,2,12,8,3,0,3,61
1082629,2,12,8,4,0,4,51
1082631,2,12,8,11,0,11,88
1082642,2,12,8,3,0,3,65
1082645,2,12,8,6,0,6,55
1082650,2,12,8,5,0,5,48
980934,1,13,8,7,0,7,62
980950,1,13,8,9,0,9,91
980966,1,13,8,12,1,13,52
980972,1,13,8,7,0,7,39
981018,1,13,8,5,0,5,38
981022,1,13,8,6,0,6,52
1082593,1,13,8,7,1,8,72
1082596,1,13,8,8,0,8,54
1082606,1,13,8,9,0,9,58
1082625,1,13,8,4,0,4,55
1082629,1,13,8,5,0,5,71
1082632,1,13,8,13,0,13,77
1082640,1,13,8,8,0,8,70
1082643,1,13,8,3,0,3,76
980910,2,13,8,15,0,15,83
980916,2,13,8,10,0,10,85
980922,2,13,8,10,0,10,63
980942,2,13,8,5,0,5,83
980954,2,13,8,9,0,9,93
980960,2,13,8,3,0,3,42
980980,2,13,8,4,0,4,67
980992,2,13,8,3,0,3,47
981006,2,13,8,12,0,12,83
981012,2,13,8,10,0,10,90
1082603,2,13,8,20,0,20,91
1082610,2,13,8,11,0,11,78
1082613,2,13,8,4,0,4,83
1082616,2,13,8,5,0,5,63
1082621,2,13,8,11,0,11,62
1082637,2,13,8,12,0,12,81
335987,1,1,9,4,0,4,77
335998,1,1,9,3,1,4,69
336002,1,1,9,6,0,6,55
336015,1,1,9,14,1,15,64
336019,1,1,9,4,1,5,63
336022,1,1,9,10,0,10,64
336026,1,1,9,5,1,6,35
336030,1,1,9,7,3,10,56
336032,1,1,9,1,1,2,48
392189,1,1,9,2,0,2,27
392204,1,1,9,3,0,3,56
392212,1,1,9,7,0,7,43
392216,1,1,9,4,0,4,65
392224,1,1,9,5,0,5,51
392226,1,1,9,10,0,10,57
392233,1,1,9,7,0,7,47
419111,1,1,9,6,0,6,55
419127,1,1,9,4,0,4,60
419132,1,1,9,8,2,10,66
419140,1,1,9,2,0,2,70
419144,1,1,9,4,0,4,62
419149,1,1,9,4,0,4,77
419153,1,1,9,6,0,6,82
419158,1,1,9,7,0,7,46
501208,1,1,9,4,0,4,55
501227,1,1,9,5,1,6,69
501235,1,1,9,3,0,3,58
501244,1,1,9,10,0,10,64
501260,1,1,9,7,1,8,49
501272,1,1,9,8,0,8,68
501274,1,1,9,3,0,3,43
548312,1,1,9,13,0,13,75
548320,1,1,9,8,0,8,84
548349,1,1,9,8,0,8,73
548358,1,1,9,7,0,7,89
548373,1,1,9,6,0,6,78
548375,1,1,9,3,1,4,48
548380,1,1,9,2,0,2,40
548383,1,1,9,6,0,6,61
598013,1,1,9,14,0,14,68
598018,1,1,9,6,0,6,68
598027,1,1,9,2,0,2,57
598034,1,1,9,6,0,6,74
598045,1,1,9,1,0,1,50
598058,1,1,9,6,0,6,60
598074,1,1,9,5,0,5,52
729284,1,1,9,10,0,10,54
729294,1,1,9,6,0,6,56
729304,1,1,9,10,0,10,76
734032,1,1,9,10,0,10,73
734048,1,1,9,0,0,0,67
829718,1,1,9,7,1,8,70
829766,1,1,9,1,0,1,63
829776,1,1,9,16,0,16,102
829786,1,1,9,5,0,5,73
980914,1,1,9,11,2,13,71
980952,1,1,9,7,0,7,78
980968,1,1,9,11,0,11,62
980980,1,1,9,2,0,2,43
981000,1,1,9,6,2,8,82
981006,1,1,9,4,1,5,54
981014,1,1,9,14,0,14,77
1082597,1,1,9,5,0,5,72
1082604,1,1,9,9,5,14,67
1082613,1,1,9,10,1,11,88
1082617,1,1,9,6,0,6,79
1082631,1,1,9,3,0,3,55
1082649,1,1,9,3,0,3,39
335991,2,1,9,0,1,1,35
336005,2,1,9,4,0,4,74
336008,2,1,9,3,0,3,45
336040,2,1,9,7,0,7,66
392191,2,1,9,2,0,2,78
392195,2,1,9,3,0,3,63
392202,2,1,9,6,0,6,63
392208,2,1,9,10,0,10,54
392236,2,1,9,10,4,14,78
392238,2,1,9,2,0,2,37
419114,2,1,9,9,1,10,79
419118,2,1,9,6,1,7,61
419123,2,1,9,9,0,9,59
419136,2,1,9,2,0,2,52
419163,2,1,9,7,1,8,64
419166,2,1,9,3,0,3,63
501203,2,1,9,4,0,4,64
501214,2,1,9,8,0,8,84
501219,2,1,9,2,3,5,41
501224,2,1,9,3,0,3,52
501239,2,1,9,4,0,4,62
501247,2,1,9,7,0,7,62
501250,2,1,9,8,0,8,52
501267,2,1,9,9,0,9,69
548317,2,1,9,10,0,10,52
548325,2,1,9,9,0,9,61
548328,2,1,9,5,0,5,66
548333,2,1,9,11,1,12,72
548340,2,1,9,6,0,6,58
548352,2,1,9,5,1,6,64
548362,2,1,9,4,0,4,76
548368,2,1,9,3,0,3,52
548386,2,1,9,14,0,14,91
598003,2,1,9,9,1,10,68
598010,2,1,9,4,0,4,50
598021,2,1,9,9,0,9,74
598036,2,1,9,7,4,11,66
598039,2,1,9,4,0,4,76
598048,2,1,9,10,0,10,75
598055,2,1,9,3,0,3,55
598062,2,1,9,5,0,5,51
598066,2,1,9,12,0,12,66
729312,2,1,9,6,2,8,39
729320,2,1,9,4,0,4,50
733976,2,1,9,5,0,5,64
733984,2,1,9,9,0,9,75
733990,2,1,9,5,0,5,77
734002,2,1,9,7,0,7,79
734014,2,1,9,8,0,8,61
734020,2,1,9,8,0,8,53
734028,2,1,9,9,0,9,78
734042,2,1,9,14,0,14,71
734054,2,1,9,14,0,14,87
829710,2,1,9,12,0,12,74
829728,2,1,9,4,0,4,57
829738,2,1,9,3,0,3,63
829744,2,1,9,9,0,9,71
829748,2,1,9,7,0,7,81
829770,2,1,9,3,0,3,67
829796,2,1,9,3,0,3,69
829810,2,1,9,9,0,9,67
829816,2,1,9,10,0,10,87
980908,2,1,9,6,3,9,62
980920,2,1,9,10,1,11,61
980930,2,1,9,3,0,3,83
980944,2,1,9,4,0,4,72
980956,2,1,9,7,0,7,66
980964,2,1,9,6,1,7,66
981020,2,1,9,5,2,7,63
1082593,2,1,9,6,0,6,109
1082601,2,1,9,7,1,8,107
1082608,2,1,9,13,1,14,75
1082620,2,1,9,11,0,11,87
1082622,2,1,9,13,0,13,93
1082627,2,1,9,14,0,14,72
1082636,2,1,9,5,0,5,115
1082639,2,1,9,7,1,8,76
1082644,2,1,9,4,3,7,87
335997,1,2,9,8,0,8,76
336011,1,2,9,5,0,5,45
336017,1,2,9,4,1,5,45
336021,1,2,9,5,0,5,64
336031,1,2,9,3,0,3,64
336034,1,2,9,5,0,5,38
336039,1,2,9,14,0,14,71
392187,1,2,9,6,0,6,52
392196,1,2,9,3,0,3,65
392199,1,2,9,4,2,6,68
392209,1,2,9,2,2,4,56
392218,1,2,9,4,0,4,44
392241,1,2,9,9,1,10,61
419114,1,2,9,9,0,9,53
419128,1,2,9,1,1,2,61
419138,1,2,9,8,0,8,67
419150,1,2,9,3,0,3,61
501210,1,2,9,6,0,6,41
501237,1,2,9,6,1,7,74
501249,1,2,9,12,0,12,89
501273,1,2,9,4,1,5,65
501275,1,2,9,9,1,10,100
548315,1,2,9,4,0,4,63
548323,1,2,9,20,1,21,90
548341,1,2,9,6,1,7,57
548355,1,2,9,4,0,4,48
548367,1,2,9,8,0,8,85
548372,1,2,9,9,0,9,61
548377,1,2,9,2,0,2,66
598004,1,2,9,12,0,12,56
598009,1,2,9,4,0,4,47
598017,1,2,9,8,1,9,55
598032,1,2,9,14,1,15,124
598041,1,2,9,4,0,4,70
598047,1,2,9,13,0,13,59
598050,1,2,9,9,0,9,49
598059,1,2,9,9,1,10,65
598062,1,2,9,5,0,5,47
598069,1,2,9,3,1,4,77
729310,1,2,9,6,0,6,33
729318,1,2,9,10,0,10,66
734004,1,2,9,6,0,6,46
734010,1,2,9,5,1,6,50
734026,1,2,9,7,0,7,43
734040,1,2,9,5,0,5,46
829724,1,2,9,6,0,6,65
829768,1,2,9,7,0,7,76
829790,1,2,9,9,1,10,89
829800,1,2,9,12,0,12,73
829824,1,2,9,1,0,1,47
829826,1,2,9,3,0,3,41
980912,1,2,9,12,0,12,73
980926,1,2,9,8,0,8,87
980932,1,2,9,12,1,13,79
980936,1,2,9,11,1,12,69
980942,1,2,9,8,0,8,68
980964,1,2,9,4,0,4,64
980982,1,2,9,3,0,3,67
980986,1,2,9,12,0,12,49
980992,1,2,9,4,0,4,59
981004,1,2,9,15,3,18,111
1082595,1,2,9,2,0,2,55
1082598,1,2,9,12,1,13,47
1082602,1,2,9,9,0,9,62
1082610,1,2,9,7,1,8,83
1082621,1,2,9,1,1,2,58
1082628,1,2,9,12,1,13,76
1082636,1,2,9,5,0,5,59
1082646,1,2,9,11,0,11,59
335987,2,2,9,3,2,5,43
335990,2,2,9,14,1,15,69
336001,2,2,9,12,1,13,82
336003,2,2,9,6,0,6,71
336007,2,2,9,5,0,5,58
336015,2,2,9,9,1,10,51
336028,2,2,9,2,0,2,33
392190,2,2,9,2,0,2,53
392193,2,2,9,6,1,7,50
392204,2,2,9,4,0,4,57
392213,2,2,9,4,2,6,68
392223,2,2,9,7,0,7,54
392226,2,2,9,4,1,5,63
392229,2,2,9,6,0,6,52
392237,2,2,9,5,0,5,48
392243,2,2,9,11,0,11,79
392244,2,2,9,6,0,6,59
419117,2,2,9,4,0,4,78
419120,2,2,9,17,1,18,85
419124,2,2,9,9,0,9,77
419133,2,2,9,12,0,12,71
419141,2,2,9,3,0,3,68
419145,2,2,9,6,0,6,51
419153,2,2,9,2,6,8,69
419156,2,2,9,8,0,8,69
419159,2,2,9,13,0,13,85
419162,2,2,9,10,0,10,58
419167,2,2,9,18,0,18,80
419169,2,2,9,4,0,4,46
501205,2,2,9,13,2,15,80
501213,2,2,9,5,1,6,45
501216,2,2,9,5,0,5,57
501227,2,2,9,14,0,14,88
501232,2,2,9,8,0,8,96
501252,2,2,9,7,1,8,102
501257,2,2,9,8,0,8,82
501260,2,2,9,10,0,10,85
501265,2,2,9,7,0,7,62
501271,2,2,9,15,3,18,71
501276,2,2,9,6,1,7,67
548320,2,2,9,5,0,5,33
548329,2,2,9,6,2,8,71
548332,2,2,9,6,0,6,56
548336,2,2,9,12,0,12,60
548349,2,2,9,1,0,1,47
548361,2,2,9,7,1,8,74
548365,2,2,9,3,0,3,50
548381,2,2,9,2,0,2,48
598013,2,2,9,18,1,19,75
598022,2,2,9,10,0,10,74
598028,2,2,9,6,0,6,64
598038,2,2,9,12,0,12,56
598053,2,2,9,11,0,11,61
729286,2,2,9,3,0,3,63
729292,2,2,9,6,0,6,47
729304,2,2,9,4,1,5,72
733982,2,2,9,5,0,5,50
733988,2,2,9,10,0,10,82
733996,2,2,9,8,0,8,48
734018,2,2,9,3,0,3,39
734032,2,2,9,16,1,17,67
829718,2,2,9,10,0,10,66
829742,2,2,9,8,0,8,56
829750,2,2,9,1,0,1,62
829754,2,2,9,10,0,10,76
829762,2,2,9,13,1,14,87
829776,2,2,9,13,0,13,100
829784,2,2,9,9,0,9,65
829808,2,2,9,5,0,5,79
980958,2,2,9,13,0,13,77
980974,2,2,9,10,1,11,70
981000,2,2,9,10,0,10,82
981016,2,2,9,7,0,7,75
981018,2,2,9,17,1,18,65
981024,2,2,9,21,0,21,100
1082591,2,2,9,10,1,11,85
1082607,2,2,9,10,0,10,63
1082617,2,2,9,5,0,5,48
1082624,2,2,9,3,0,3,48
1082633,2,2,9,3,0,3,55
335988,1,3,9,13,0,13,83
335994,1,3,9,7,1,8,72
336001,1,3,9,10,0,10,60
336006,1,3,9,5,0,5,70
336010,1,3,9,5,0,5,51
336012,1,3,9,10,0,10,60
336018,1,3,9,10,0,10,78
336023,1,3,9,4,0,4,46
336045,1,3,9,7,0,7,64
392190,1,3,9,8,4,12,97
392201,1,3,9,8,0,8,77
392207,1,3,9,14,0,14,69
392211,1,3,9,4,0,4,64
392214,1,3,9,10,0,10,78
392219,1,3,9,6,0,6,76
392229,1,3,9,6,2,8,67
392236,1,3,9,4,0,4,78
392239,1,3,9,3,1,4,65
392243,1,3,9,2,0,2,70
419118,1,3,9,7,0,7,55
419130,1,3,9,10,0,10,71
419142,1,3,9,4,3,7,89
419147,1,3,9,9,1,10,70
419152,1,3,9,4,0,4,69
419160,1,3,9,1,0,1,53
419168,1,3,9,5,0,5,55
419170,1,3,9,5,0,5,49
501203,1,3,9,8,1,9,72
501211,1,3,9,8,0,8,55
501216,1,3,9,5,0,5,71
501220,1,3,9,11,0,11,65
501231,1,3,9,5,0,5,63
501241,1,3,9,7,0,7,53
501250,1,3,9,5,0,5,30
501254,1,3,9,7,0,7,77
501258,1,3,9,8,0,8,55
501266,1,3,9,10,0,10,61
501271,1,3,9,3,0,3,35
501276,1,3,9,11,0,11,84
548311,1,3,9,7,0,7,69
548316,1,3,9,7,1,8,71
548321,1,3,9,10,0,10,63
548327,1,3,9,12,0,12,67
548335,1,3,9,9,0,9,64
548352,1,3,9,6,1,7,67
548357,1,3,9,5,1,6,75
548360,1,3,9,7,1,8,68
548376,1,3,9,2,0,2,44
548384,1,3,9,6,0,6,47
548385,1,3,9,9,0,9,77
548386,1,3,9,13,0,13,82
598025,1,3,9,5,1,6,56
598039,1,3,9,10,0,10,96
598043,1,3,9,5,0,5,46
598046,1,3,9,6,0,6,55
598056,1,3,9,13,1,14,79
598063,1,3,9,7,0,7,66
598067,1,3,9,5,1,6,69
598075,1,3,9,8,0,8,63
729288,1,3,9,7,0,7,96
729298,1,3,9,7,2,9,55
729302,1,3,9,3,0,3,66
733976,1,3,9,13,0,13,72
734018,1,3,9,4,0,4,52
734028,1,3,9,5,0,5,55
734034,1,3,9,1,4,5,77
829712,1,3,9,7,0,7,78
829716,1,3,9,3,0,3,78
829728,1,3,9,1,0,1,81
829740,1,3,9,16,0,16,65
829750,1,3,9,10,0,10,74
829758,1,3,9,3,1,4,85
829770,1,3,9,4,0,4,65
829784,1,3,9,15,0,15,63
829794,1,3,9,6,0,6,65
829802,1,3,9,2,0,2,50
829806,1,3,9,11,0,11,45
335998,2,3,9,6,0,6,72
336014,2,3,9,11,0,11,95
336034,2,3,9,4,0,4,60
336038,2,3,9,3,0,3,84
336042,2,3,9,9,0,9,68
336044,2,3,9,7,0,7,60
392186,2,3,9,9,0,9,66
392194,2,3,9,7,0,7,97
392207,2,3,9,2,1,3,49
392222,2,3,9,11,1,12,61
392232,2,3,9,3,4,7,50
419115,2,3,9,5,0,5,59
419121,2,3,9,4,0,4,89
419126,2,3,9,7,0,7,67
419128,2,3,9,3,4,7,53
419134,2,3,9,3,0,3,76
419138,2,3,9,10,0,10,81
419158,2,3,9,5,0,5,88
419164,2,3,9,12,0,12,86
501226,2,3,9,15,0,15,76
501233,2,3,9,16,0,16,55
501245,2,3,9,10,0,10,67
501273,2,3,9,15,1,16,52
548323,2,3,9,6,0,6,71
548337,2,3,9,8,1,9,66
548348,2,3,9,3,0,3,66
548366,2,3,9,7,0,7,49
548369,2,3,9,7,0,7,70
548373,2,3,9,13,0,13,88
598007,2,3,9,5,0,5,49
598012,2,3,9,13,0,13,59
598017,2,3,9,7,1,8,54
598020,2,3,9,3,0,3,57
598027,2,3,9,3,0,3,40
598031,2,3,9,10,1,11,81
598035,2,3,9,6,1,7,75
598051,2,3,9,4,0,4,40
598078,2,3,9,9,0,9,50
729308,2,3,9,3,0,3,65
729316,2,3,9,7,0,7,72
733986,2,3,9,9,0,9,67
733992,2,3,9,11,0,11,72
734000,2,3,9,4,0,4,60
734008,2,3,9,10,0,10,74
734040,2,3,9,8,0,8,84
734050,2,3,9,8,0,8,80
734052,2,3,9,10,0,10,117
829734,2,3,9,6,0,6,121
829778,2,3,9,9,1,10,81
829814,2,3,9,4,0,4,67
829822,2,3,9,13,0,13,79
829826,2,3,9,11,0,11,58
829828,2,3,9,6,1,7,57
335992,1,4,9,3,0,3,73
335996,1,4,9,5,0,5,86
336008,1,4,9,14,0,14,82
336024,1,4,9,4,0,4,79
336033,1,4,9,10,0,10,74
336040,1,4,9,9,1,10,71
336044,1,4,9,7,0,7,44
392188,1,4,9,7,0,7,78
392191,1,4,9,2,0,2,58
392200,1,4,9,6,0,6,52
392205,1,4,9,2,0,2,42
392227,1,4,9,4,0,4,67
392234,1,4,9,3,0,3,52
419113,1,4,9,10,1,11,66
419117,1,4,9,13,0,13,73
419126,1,4,9,1,0,1,55
419137,1,4,9,11,2,13,76
419141,1,4,9,6,0,6,66
419148,1,4,9,14,2,16,79
419161,1,4,9,5,0,5,63
419164,1,4,9,12,0,12,74
501207,1,4,9,0,0,0,45
501225,1,4,9,7,0,7,98
501239,1,4,9,9,0,9,53
501253,1,4,9,9,0,9,60
501256,1,4,9,8,0,8,68
501262,1,4,9,8,0,8,60
501265,1,4,9,14,1,15,77
548328,1,4,9,8,0,8,49
548333,1,4,9,7,0,7,61
548336,1,4,9,5,2,7,64
548344,1,4,9,6,1,7,53
548348,1,4,9,4,0,4,72
548364,1,4,9,9,0,9,77
548374,1,4,9,6,0,6,62
548379,1,4,9,1,0,1,36
598012,1,4,9,3,1,4,64
598019,1,4,9,3,0,3,46
598021,1,4,9,9,0,9,63
598026,1,4,9,3,0,3,48
598033,1,4,9,4,1,5,68
598036,1,4,9,2,2,4,64
598057,1,4,9,7,0,7,65
598071,1,4,9,5,0,5,68
729300,1,4,9,5,0,5,62
729312,1,4,9,12,0,12,71
733978,1,4,9,12,0,12,63
733992,1,4,9,9,0,9,60
733996,1,4,9,5,0,5,93
734002,1,4,9,11,0,11,73
734030,1,4,9,14,0,14,85
734038,1,4,9,8,0,8,75
734052,1,4,9,5,1,6,98
734054,1,4,9,4,0,4,54
829722,1,4,9,5,0,5,77
829730,1,4,9,18,0,18,70
829738,1,4,9,6,4,10,64
829772,1,4,9,6,0,6,43
829796,1,4,9,2,3,5,64
829808,1,4,9,9,1,10,100
829814,1,4,9,5,1,6,54
980910,1,4,9,10,1,11,82
980918,1,4,9,1,1,2,54
980930,1,4,9,3,1,4,52
980940,1,4,9,12,0,12,63
980960,1,4,9,4,0,4,74
980976,1,4,9,13,0,13,69
980996,1,4,9,5,0,5,66
981010,1,4,9,4,0,4,67
1082601,1,4,9,11,0,11,78
1082612,1,4,9,4,1,5,63
1082616,1,4,9,13,0,13,80
1082633,1,4,9,11,0,11,53
1082637,1,4,9,8,1,9,72
1082639,1,4,9,2,1,3,57
1082641,1,4,9,21,0,21,121
1082645,1,4,9,11,0,11,50
335988,2,4,9,12,1,13,97
336000,2,4,9,5,0,5,75
336004,2,4,9,12,0,12,67
336011,2,4,9,4,0,4,67
336018,2,4,9,15,0,15,68
336021,2,4,9,8,0,8,66
336036,2,4,9,11,0,11,97
392196,2,4,9,6,0,6,67
392209,2,4,9,10,0,10,63
392212,2,4,9,9,0,9,77
392215,2,4,9,4,0,4,49
392219,2,4,9,16,0,16,84
392221,2,4,9,19,1,20,80
392231,2,4,9,7,0,7,45
392239,2,4,9,2,0,2,38
419122,2,4,9,3,0,3,51
419129,2,4,9,4,1,5,92
419132,2,4,9,7,0,7,65
419144,2,4,9,7,0,7,93
419151,2,4,9,13,0,13,81
419154,2,4,9,4,0,4,52
501211,2,4,9,9,0,9,86
501217,2,4,9,16,0,16,96
501228,2,4,9,16,0,16,91
501242,2,4,9,12,0,12,55
501249,2,4,9,6,0,6,58
501259,2,4,9,11,0,11,72
501269,2,4,9,6,0,6,72
548314,2,4,9,7,0,7,68
548318,2,4,9,13,2,15,45
548324,2,4,9,5,0,5,55
548339,2,4,9,2,0,2,61
548355,2,4,9,3,0,3,73
548359,2,4,9,1,2,3,60
548371,2,4,9,7,0,7,65
548376,2,4,9,1,0,1,56
598008,2,4,9,8,0,8,75
598030,2,4,9,7,0,7,72
598042,2,4,9,10,0,10,77
598046,2,4,9,4,0,4,57
598050,2,4,9,14,1,15,76
598061,2,4,9,1,0,1,51
598064,2,4,9,4,0,4,66
598069,2,4,9,6,0,6,58
729288,2,4,9,7,0,7,90
729296,2,4,9,4,1,5,65
729318,2,4,9,5,0,5,56
734012,2,4,9,11,1,12,125
734024,2,4,9,5,2,7,92
734044,2,4,9,3,0,3,69
734048,2,4,9,4,1,5,60
829714,2,4,9,2,2,4,65
829746,2,4,9,7,0,7,61
829758,2,4,9,7,0,7,55
829764,2,4,9,8,0,8,56
829780,2,4,9,10,1,11,69
829790,2,4,9,2,1,3,51
829804,2,4,9,3,0,3,65
980924,2,4,9,6,0,6,64
980946,2,4,9,11,0,11,68
980968,2,4,9,5,0,5,53
980982,2,4,9,9,0,9,74
980990,2,4,9,5,1,6,53
981004,2,4,9,6,0,6,84
1082594,2,4,9,4,0,4,66
1082598,2,4,9,7,0,7,85
1082605,2,4,9,4,0,4,53
1082609,2,4,9,4,0,4,61
1082623,2,4,9,5,0,5,75
335989,1,5,9,2,1,3,47
336005,1,5,9,15,0,15,75
336013,1,5,9,4,2,6,74
336028,1,5,9,4,2,6,86
336038,1,5,9,5,0,5,95
336043,1,5,9,6,0,6,77
392195,1,5,9,3,0,3,73
392215,1,5,9,7,0,7,79
392222,1,5,9,8,0,8,55
392230,1,5,9,6,1,7,62
392238,1,5,9,6,0,6,58
419116,1,5,9,3,1,4,54
419120,1,5,9,4,0,4,43
419123,1,5,9,13,0,13,80
419129,1,5,9,12,2,14,77
419134,1,5,9,13,0,13,86
419146,1,5,9,10,0,10,75
419159,1,5,9,4,0,4,48
419163,1,5,9,5,0,5,69
501214,1,5,9,12,0,12,57
501219,1,5,9,12,1,13,56
501245,1,5,9,8,0,8,72
501257,1,5,9,5,0,5,68
501263,1,5,9,8,0,8,64
548314,1,5,9,9,0,9,73
548317,1,5,9,5,0,5,62
548325,1,5,9,3,0,3,51
548329,1,5,9,5,0,5,57
548337,1,5,9,6,0,6,56
548354,1,5,9,2,0,2,72
548359,1,5,9,9,0,9,87
548366,1,5,9,4,1,5,43
548370,1,5,9,5,0,5,61
548378,1,5,9,1,1,2,55
548382,1,5,9,4,0,4,52
598006,1,5,9,10,0,10,65
598010,1,5,9,7,0,7,53
598014,1,5,9,7,0,7,61
598024,1,5,9,3,0,3,72
598028,1,5,9,13,0,13,60
598031,1,5,9,7,1,8,82
598048,1,5,9,15,0,15,62
598077,1,5,9,7,0,7,61
729296,1,5,9,10,0,10,77
729320,1,5,9,4,0,4,57
733984,1,5,9,8,0,8,71
734008,1,5,9,4,0,4,65
734016,1,5,9,10,0,10,77
734046,1,5,9,10,0,10,53
829714,1,5,9,0,8,8,61
829746,1,5,9,19,0,19,78
829754,1,5,9,5,0,5,68
829782,1,5,9,2,1,3,64
829816,1,5,9,11,0,11,95
335992,2,5,9,11,0,11,76
335995,2,5,9,12,0,12,110
335997,2,5,9,7,0,7,68
336010,2,5,9,8,0,8,74
336016,2,5,9,4,0,4,69
336020,2,5,9,18,4,22,65
336024,2,5,9,5,0,5,54
336032,2,5,9,10,2,12,62
336041,2,5,9,4,0,4,54
336045,2,5,9,7,3,10,61
392187,2,5,9,2,0,2,28
392200,2,5,9,2,0,2,43
392203,2,5,9,9,0,9,56
392207,2,5,9,5,0,5,54
392210,2,5,9,8,1,9,54
392218,2,5,9,8,0,8,51
392225,2,5,9,8,0,8,51
392235,2,5,9,11,2,13,50
419112,2,5,9,7,0,7,65
419131,2,5,9,15,0,15,84
419139,2,5,9,2,0,2,67
419142,2,5,9,10,0,10,90
419148,2,5,9,17,0,17,108
419155,2,5,9,4,0,4,51
501204,2,5,9,10,0,10,56
501209,2,5,9,8,0,8,74
501225,2,5,9,6,0,6,55
501230,2,5,9,9,0,9,53
501236,2,5,9,11,0,11,37
501240,2,5,9,4,1,5,51
501254,2,5,9,5,1,6,68
501268,2,5,9,7,0,7,88
548322,2,5,9,7,0,7,72
548331,2,5,9,4,0,4,78
548341,2,5,9,2,0,2,59
548350,2,5,9,6,0,6,61
548363,2,5,9,16,0,16,73
598019,2,5,9,4,0,4,62
598037,2,5,9,3,0,3,45
598041,2,5,9,10,0,10,73
598052,2,5,9,3,1,4,76
598054,2,5,9,6,1,7,68
598057,2,5,9,10,0,10,65
598063,2,5,9,8,0,8,43
598068,2,5,9,6,5,11,58
598070,2,5,9,3,0,3,42
598076,2,5,9,0,0,0,55
729290,2,5,9,5,1,6,49
729302,2,5,9,6,0,6,53
729310,2,5,9,0,0,0,46
733980,2,5,9,8,0,8,60
733994,2,5,9,3,1,4,49
734004,2,5,9,3,0,3,63
734022,2,5,9,6,1,7,68
734038,2,5,9,2,0,2,58
829720,2,5,9,5,1,6,63
829726,2,5,9,8,0,8,65
829732,2,5,9,6,0,6,57
829740,2,5,9,16,0,16,73
829774,2,5,9,10,1,11,82
829792,2,5,9,6,0,6,53
829802,2,5,9,10,0,10,59
829824,2,5,9,5,1,6,61
336000,1,6,9,2,0,2,60
336003,1,6,9,4,0,4,79
336014,1,6,9,7,0,7,74
336020,1,6,9,5,0,5,64
336025,1,6,9,7,0,7,66
336027,1,6,9,14,2,16,104
392194,1,6,9,6,0,6,82
392203,1,6,9,4,1,5,61
392228,1,6,9,9,0,9,77
392231,1,6,9,3,0,3,51
392235,1,6,9,9,0,9,55
392237,1,6,9,8,0,8,58
392242,1,6,9,7,0,7,75
419121,1,6,9,4,1,5,84
419133,1,6,9,9,0,9,88
419136,1,6,9,7,0,7,82
419139,1,6,9,4,0,4,70
419145,1,6,9,14,0,14,79
419154,1,6,9,2,0,2,58
501206,1,6,9,4,0,4,45
501209,1,6,9,3,0,3,41
501228,1,6,9,13,0,13,104
501232,1,6,9,7,0,7,64
501238,1,6,9,3,0,3,42
501243,1,6,9,3,2,5,55
501270,1,6,9,5,0,5,47
548347,1,6,9,12,0,12,82
548350,1,6,9,4,0,4,62
548362,1,6,9,11,0,11,75
548369,1,6,9,11,0,11,48
598003,1,6,9,7,0,7,60
598015,1,6,9,9,0,9,44
598022,1,6,9,11,0,11,63
598040,1,6,9,5,0,5,67
598049,1,6,9,4,0,4,38
598054,1,6,9,5,0,5,53
598064,1,6,9,1,0,1,51
729286,1,6,9,4,0,4,40
733980,1,6,9,11,0,11,68
733986,1,6,9,13,0,13,66
733990,1,6,9,8,0,8,61
733998,1,6,9,6,0,6,73
734024,1,6,9,7,0,7,78
734044,1,6,9,7,0,7,65
829720,1,6,9,12,1,13,71
829736,1,6,9,8,1,9,66
829744,1,6,9,6,0,6,60
829752,1,6,9,4,0,4,60
829762,1,6,9,2,0,2,45
829788,1,6,9,9,0,9,66
829818,1,6,9,18,0,18,79
980908,1,6,9,4,0,4,53
980938,1,6,9,6,0,6,60
980956,1,6,9,7,0,7,61
980970,1,6,9,4,0,4,63
981002,1,6,9,10,0,10,42
981016,1,6,9,5,0,5,67
1082599,1,6,9,5,0,5,76
1082605,1,6,9,7,0,7,71
1082608,1,6,9,8,0,8,71
1082622,1,6,9,5,0,5,71
1082626,1,6,9,2,0,2,33
1082642,1,6,9,10,0,10,83
335989,2,6,9,7,0,7,78
335993,2,6,9,22,1,23,83
336006,2,6,9,8,0,8,101
336009,2,6,9,12,0,12,65
336022,2,6,9,7,0,7,59
336031,2,6,9,5,0,5,100
336037,2,6,9,6,1,7,79
336043,2,6,9,8,0,8,48
392199,2,6,9,3,0,3,61
392206,2,6,9,3,1,4,62
392211,2,6,9,8,0,8,69
392216,2,6,9,10,1,11,73
392220,2,6,9,4,0,4,46
392224,2,6,9,8,1,9,69
392240,2,6,9,5,0,5,77
419113,2,6,9,7,0,7,54
419116,2,6,9,8,0,8,90
419119,2,6,9,2,1,3,78
419125,2,6,9,13,0,13,81
419149,2,6,9,11,1,12,80
419157,2,6,9,4,0,4,82
419160,2,6,9,6,0,6,50
419165,2,6,9,4,0,4,55
501218,2,6,9,5,0,5,90
501221,2,6,9,10,4,14,71
501235,2,6,9,5,0,5,53
501248,2,6,9,13,0,13,68
501251,2,6,9,5,2,7,46
501258,2,6,9,4,0,4,60
501262,2,6,9,9,0,9,61
548312,2,6,9,11,0,11,70
548315,2,6,9,7,1,8,66
548321,2,6,9,5,0,5,69
548326,2,6,9,4,0,4,63
548330,2,6,9,1,0,1,53
548334,2,6,9,14,1,15,102
548338,2,6,9,13,0,13,87
548342,2,6,9,9,4,13,90
548354,2,6,9,3,1,4,88
548374,2,6,9,11,0,11,53
548377,2,6,9,13,0,13,82
548379,2,6,9,3,1,4,82
548383,2,6,9,11,0,11,73
548385,2,6,9,9,3,12,82
598006,2,6,9,12,0,12,65
598011,2,6,9,8,0,8,69
598025,2,6,9,6,0,6,49
598029,2,6,9,8,0,8,88
598033,2,6,9,4,0,4,42
598045,2,6,9,1,0,1,50
598059,2,6,9,19,1,20,84
598067,2,6,9,4,0,4,60
598072,2,6,9,5,0,5,62
729294,2,6,9,4,1,5,71
729298,2,6,9,3,1,4,46
729306,2,6,9,3,0,3,72
729314,2,6,9,4,0,4,44
734010,2,6,9,8,0,8,73
734016,2,6,9,6,2,8,57
734036,2,6,9,2,0,2,59
829712,2,6,9,7,0,7,58
829730,2,6,9,7,1,8,64
829766,2,6,9,3,0,3,54
829772,2,6,9,7,2,9,64
829782,2,6,9,7,0,7,66
829798,2,6,9,2,0,2,62
829806,2,6,9,8,0,8,60
980918,2,6,9,10,0,10,60
980926,2,6,9,14,0,14,81
980950,2,6,9,5,0,5,43
980966,2,6,9,16,0,16,85
980976,2,6,9,5,0,5,76
980988,2,6,9,5,0,5,74
980998,2,6,9,10,0,10,70
981008,2,6,9,10,0,10,62
1082595,2,6,9,4,1,5,70
1082611,2,6,9,5,0,5,80
1082614,2,6,9,9,1,10,44
1082630,2,6,9,7,0,7,80
1082632,2,6,9,14,0,14,97
1082635,2,6,9,7,0,7,47
1082640,2,6,9,9,0,9,82
1082646,2,6,9,16,0,16,67
335990,1,7,9,11,1,12,72
335999,1,7,9,5,0,5,47
336009,1,7,9,3,1,4,62
336029,1,7,9,1,2,3,74
336037,1,7,9,4,2,6,79
336041,1,7,9,4,1,5,51
392186,1,7,9,7,0,7,55
392202,1,7,9,17,0,17,103
392208,1,7,9,2,0,2,56
392213,1,7,9,6,0,6,48
392220,1,7,9,2,1,3,39
392223,1,7,9,9,0,9,62
392232,1,7,9,10,0,10,65
392240,1,7,9,11,2,13,66
419112,1,7,9,5,0,5,89
419119,1,7,9,10,0,10,98
419124,1,7,9,7,0,7,69
419135,1,7,9,4,0,4,72
419143,1,7,9,6,0,6,62
419151,1,7,9,6,0,6,66
419155,1,7,9,5,0,5,68
419157,1,7,9,7,0,7,63
419162,1,7,9,17,5,22,68
419166,1,7,9,12,0,12,66
419167,1,7,9,8,0,8,74
501215,1,7,9,8,0,8,65
501226,1,7,9,3,0,3,59
501229,1,7,9,1,0,1,70
501236,1,7,9,8,0,8,48
501242,1,7,9,11,0,11,57
501246,1,7,9,4,0,4,62
501251,1,7,9,4,1,5,67
501268,1,7,9,11,0,11,51
548322,1,7,9,8,0,8,75
548330,1,7,9,3,0,3,40
548339,1,7,9,6,0,6,56
548356,1,7,9,3,1,4,56
548365,1,7,9,5,0,5,42
548368,1,7,9,9,0,9,69
598007,1,7,9,12,0,12,67
598011,1,7,9,15,1,16,75
598016,1,7,9,8,0,8,64
598029,1,7,9,10,0,10,49
598038,1,7,9,18,1,19,86
598042,1,7,9,4,0,4,48
598044,1,7,9,4,0,4,53
598051,1,7,9,2,0,2,45
598055,1,7,9,4,0,4,63
598068,1,7,9,7,0,7,73
598078,1,7,9,5,0,5,50
729292,1,7,9,2,0,2,60
729308,1,7,9,3,0,3,47
729314,1,7,9,4,0,4,46
733988,1,7,9,2,4,6,77
734000,1,7,9,5,0,5,54
734014,1,7,9,10,0,10,56
734022,1,7,9,6,0,6,70
734036,1,7,9,3,0,3,90
734050,1,7,9,9,0,9,72
829710,1,7,9,6,0,6,54
829726,1,7,9,0,1,1,39
829734,1,7,9,9,0,9,53
829742,1,7,9,9,0,9,73
829756,1,7,9,6,0,6,62
829774,1,7,9,13,0,13,73
829780,1,7,9,12,0,12,84
829810,1,7,9,9,0,9,59
829822,1,7,9,16,0,16,78
829828,1,7,9,10,0,10,88
980906,1,7,9,7,0,7,47
980922,1,7,9,9,1,10,51
980928,1,7,9,7,0,7,54
980946,1,7,9,9,0,9,69
980990,1,7,9,3,0,3,37
980998,1,7,9,13,0,13,74
981012,1,7,9,8,0,8,67
1082592,1,7,9,10,0,10,76
1082614,1,7,9,0,1,1,61
1082635,1,7,9,3,0,3,79
1082638,1,7,9,8,0,8,53
1082644,1,7,9,2,2,4,72
1082650,1,7,9,3,1,4,50
335994,2,7,9,7,0,7,75
335996,2,7,9,4,0,4,65
336002,2,7,9,11,5,16,63
336013,2,7,9,4,1,5,51
336017,2,7,9,11,0,11,71
336023,2,7,9,5,1,6,90
336033,2,7,9,2,0,2,83
392197,2,7,9,9,0,9,76
392202,2,7,9,2,0,2,65
392205,2,7,9,13,0,13,44
392217,2,7,9,2,0,2,61
392227,2,7,9,12,0,12,62
392230,2,7,9,5,6,11,49
419119,2,7,9,2,0,2,80
419127,2,7,9,2,0,2,71
419130,2,7,9,12,0,12,94
419137,2,7,9,11,0,11,74
419147,2,7,9,5,1,6,62
419170,2,7,9,3,0,3,43
501206,2,7,9,2,0,2,44
501210,2,7,9,4,0,4,66
501223,2,7,9,6,0,6,57
501256,2,7,9,7,1,8,55
501261,2,7,9,7,1,8,41
501272,2,7,9,5,0,5,75
501274,2,7,9,1,0,1,83
501275,2,7,9,4,0,4,72
548311,2,7,9,3,0,3,72
548313,2,7,9,2,1,3,44
548319,2,7,9,7,0,7,44
548344,2,7,9,7,0,7,59
548347,2,7,9,17,0,17,78
548351,2,7,9,1,2,3,47
548360,2,7,9,8,1,9,70
548372,2,7,9,6,0,6,51
548375,2,7,9,13,0,13,52
548382,2,7,9,6,0,6,72
548384,2,7,9,3,1,4,72
598004,2,7,9,3,1,4,58
598024,2,7,9,3,1,4,39
598034,2,7,9,10,0,10,75
598060,2,7,9,5,0,5,45
598065,2,7,9,7,1,8,67
598071,2,7,9,3,0,3,62
598075,2,7,9,3,0,3,89
598077,2,7,9,9,0,9,70
729284,2,7,9,6,0,6,47
729322,2,7,9,5,0,5,48
733978,2,7,9,3,1,4,69
734006,2,7,9,11,0,11,62
734030,2,7,9,9,0,9,85
734046,2,7,9,15,0,15,104
829722,2,7,9,1,0,1,27
829752,2,7,9,8,0,8,72
829788,2,7,9,7,0,7,57
829794,2,7,9,2,0,2,75
829800,2,7,9,3,0,3,66
829820,2,7,9,8,1,9,65
980914,2,7,9,9,0,9,72
980932,2,7,9,5,0,5,70
980938,2,7,9,10,0,10,70
980952,2,7,9,3,0,3,78
980962,2,7,9,11,0,11,72
980978,2,7,9,2,0,2,50
980986,2,7,9,6,0,6,58
1082597,2,7,9,1,0,1,72
1082600,2,7,9,3,0,3,76
1082602,2,7,9,3,1,4,37
1082606,2,7,9,15,0,15,85
1082612,2,7,9,15,1,16,117
1082618,2,7,9,4,0,4,60
1082625,2,7,9,4,0,4,76
1082628,2,7,9,8,0,8,70
1082641,2,7,9,17,0,17,104
1082647,2,7,9,11,0,11,62
1082649,2,7,9,11,0,11,61
335991,1,8,9,1,0,1,48
335993,1,8,9,7,0,7,43
335995,1,8,9,6,0,6,78
336004,1,8,9,8,0,8,67
336007,1,8,9,11,0,11,76
336016,1,8,9,5,0,5,66
336036,1,8,9,9,0,9,66
336042,1,8,9,5,2,7,51
392193,1,8,9,5,0,5,77
392197,1,8,9,4,0,4,76
392206,1,8,9,4,0,4,52
392210,1,8,9,9,2,11,54
392217,1,8,9,3,0,3,59
392221,1,8,9,12,0,12,70
392225,1,8,9,10,0,10,69
392244,1,8,9,3,2,5,59
419115,1,8,9,3,0,3,69
419122,1,8,9,7,0,7,84
419125,1,8,9,10,0,10,71
419131,1,8,9,2,0,2,72
419156,1,8,9,11,1,12,59
419165,1,8,9,6,0,6,66
419169,1,8,9,7,0,7,41
501204,1,8,9,10,0,10,64
501213,1,8,9,10,0,10,70
501217,1,8,9,9,1,10,71
501221,1,8,9,11,0,11,77
501234,1,8,9,4,0,4,33
501248,1,8,9,5,0,5,58
501255,1,8,9,6,0,6,65
501261,1,8,9,10,0,10,52
501269,1,8,9,6,0,6,82
548319,1,8,9,5,0,5,55
548326,1,8,9,10,1,11,81
548331,1,8,9,7,0,7,77
548334,1,8,9,10,0,10,60
548340,1,8,9,7,1,8,61
548346,1,8,9,6,0,6,64
548351,1,8,9,3,2,5,48
548353,1,8,9,4,2,6,48
548361,1,8,9,4,0,4,69
548371,1,8,9,7,0,7,65
548381,1,8,9,4,0,4,41
335999,2,8,9,7,4,11,108
336012,2,8,9,6,0,6,77
336019,2,8,9,7,0,7,70
336025,2,8,9,4,0,4,78
336029,2,8,9,8,0,8,56
336039,2,8,9,2,1,3,57
392189,2,8,9,6,0,6,52
392201,2,8,9,4,1,5,80
392214,2,8,9,6,0,6,75
392228,2,8,9,14,0,14,80
392233,2,8,9,6,0,6,68
392234,2,8,9,7,0,7,61
392241,2,8,9,3,1,4,78
392242,2,8,9,7,0,7,98
419111,2,8,9,5,1,6,77
419135,2,8,9,6,2,8,69
419140,2,8,9,3,0,3,78
419143,2,8,9,7,2,9,61
419146,2,8,9,12,2,14,77
419150,2,8,9,9,1,10,68
419152,2,8,9,7,0,7,52
419161,2,8,9,9,0,9,74
419168,2,8,9,3,0,3,40
501208,2,8,9,6,0,6,53
501229,2,8,9,8,0,8,65
501241,2,8,9,6,0,6,81
501244,2,8,9,8,0,8,64
501264,2,8,9,4,0,4,71
548316,2,8,9,6,0,6,63
548357,2,8,9,11,0,11,69
548364,2,8,9,4,0,4,68
548378,2,8,9,3,0,3,65
501205,1,9,9,6,0,6,80
501212,1,9,9,4,0,4,53
501224,1,9,9,4,0,4,55
501230,1,9,9,5,0,5,47
501247,1,9,9,9,0,9,60
501252,1,9,9,1,3,4,68
501259,1,9,9,8,0,8,94
501215,2,9,9,11,1,12,74
501220,2,9,9,14,1,15,81
501234,2,9,9,1,1,2,43
501238,2,9,9,3,0,3,48
501243,2,9,9,4,0,4,82
501266,2,9,9,11,1,12,60
501218,1,10,9,8,0,8,84
501223,1,10,9,6,0,6,54
501233,1,10,9,6,0,6,50
501240,1,10,9,6,0,6,72
501264,1,10,9,8,0,8,53
501267,1,10,9,4,0,4,46
548313,1,10,9,8,0,8,48
548318,1,10,9,5,0,5,58
548324,1,10,9,11,0,11,55
548332,1,10,9,10,0,10,84
548338,1,10,9,14,3,17,82
548342,1,10,9,4,0,4,46
548363,1,10,9,5,0,5,50
598008,1,10,9,3,0,3,33
598020,1,10,9,7,0,7,70
598030,1,10,9,7,0,7,68
598052,1,10,9,6,0,6,80
598060,1,10,9,4,0,4,54
598066,1,10,9,7,0,7,57
598072,1,10,9,17,0,17,71
501207,2,10,9,11,0,11,71
501212,2,10,9,3,1,4,59
501231,2,10,9,4,0,4,52
501237,2,10,9,7,0,7,60
501246,2,10,9,2,0,2,47
501253,2,10,9,6,4,10,65
501255,2,10,9,4,0,4,73
548327,2,10,9,3,0,3,66
548335,2,10,9,2,0,2,61
548346,2,10,9,11,2,13,71
548353,2,10,9,10,1,11,69
548356,2,10,9,1,0,1,45
548358,2,10,9,0,0,0,55
548367,2,10,9,2,0,2,73
548370,2,10,9,4,1,5,52
548380,2,10,9,2,1,3,55
598005,2,10,9,6,0,6,44
598014,2,10,9,3,0,3,82
598016,2,10,9,11,0,11,68
598023,2,10,9,4,0,4,59
598032,2,10,9,7,0,7,68
598040,2,10,9,5,1,6,71
598043,2,10,9,6,0,6,61
598047,2,10,9,19,0,19,68
598058,2,10,9,3,0,3,44
598005,1,11,9,8,0,8,58
598023,1,11,9,8,0,8,41
598035,1,11,9,4,0,4,57
598037,1,11,9,9,2,11,57
598053,1,11,9,6,0,6,56
598061,1,11,9,1,0,1,52
598065,1,11,9,7,0,7,77
598070,1,11,9,6,0,6,40
598076,1,11,9,4,0,4,42
729290,1,11,9,12,0,12,62
729306,1,11,9,5,0,5,72
729316,1,11,9,7,0,7,62
729322,1,11,9,2,0,2,65
733982,1,11,9,2,0,2,61
733994,1,11,9,6,0,6,67
734006,1,11,9,8,0,8,68
734012,1,11,9,2,0,2,67
734020,1,11,9,7,0,7,65
734042,1,11,9,3,1,4,73
829732,1,11,9,7,1,8,51
829748,1,11,9,11,0,11,67
829764,1,11,9,5,0,5,70
829778,1,11,9,13,0,13,99
829792,1,11,9,9,0,9,76
829798,1,11,9,3,0,3,57
829804,1,11,9,4,0,4,73
829812,1,11,9,17,0,17,117
829820,1,11,9,9,2,11,50
980920,1,11,9,5,0,5,48
980948,1,11,9,4,0,4,36
980958,1,11,9,10,1,11,74
980978,1,11,9,8,1,9,76
980984,1,11,9,6,0,6,51
980988,1,11,9,7,0,7,68
981008,1,11,9,10,0,10,63
981020,1,11,9,9,0,9,62
981024,1,11,9,12,1,13,88
1082591,1,11,9,9,0,9,84
1082600,1,11,9,10,0,10,62
1082609,1,11,9,8,0,8,50
1082611,1,11,9,9,0,9,73
1082615,1,11,9,2,0,2,57
1082623,1,11,9,16,0,16,99
1082627,1,11,9,9,2,11,105
1082630,1,11,9,3,0,3,78
1082648,1,11,9,9,0,9,48
598009,2,11,9,2,3,5,52
598015,2,11,9,3,0,3,49
598018,2,11,9,2,0,2,57
598026,2,11,9,2,0,2,50
598044,2,11,9,3,0,3,56
598049,2,11,9,6,0,6,52
598056,2,11,9,8,0,8,64
598074,2,11,9,12,0,12,74
729300,2,11,9,9,1,10,64
734026,2,11,9,9,0,9,68
734034,2,11,9,13,3,16,92
829716,2,11,9,7,0,7,69
829724,2,11,9,3,4,7,90
829736,2,11,9,4,0,4,59
829756,2,11,9,4,0,4,68
829786,2,11,9,3,1,4,59
980912,2,11,9,3,0,3,86
980928,2,11,9,7,0,7,56
980934,2,11,9,9,1,10,86
980940,2,11,9,8,1,9,87
980972,2,11,9,9,2,11,54
980996,2,11,9,6,0,6,74
981014,2,11,9,10,1,11,70
981022,2,11,9,1,0,1,62
1082596,2,11,9,4,0,4,76
1082604,2,11,9,5,0,5,53
1082634,2,11,9,10,0,10,69
1082638,2,11,9,11,0,11,76
1082643,2,11,9,13,0,13,71
980916,1,12,9,6,0,6,82
980924,1,12,9,8,0,8,73
980944,1,12,9,8,0,8,55
980954,1,12,9,7,0,7,70
980962,1,12,9,6,1,7,91
980974,1,12,9,7,0,7,82
980994,1,12,9,10,0,10,63
1082594,1,12,9,3,2,5,53
1082603,1,12,9,11,0,11,87
1082607,1,12,9,1,0,1,69
1082618,1,12,9,5,0,5,74
1082620,1,12,9,9,0,9,74
1082624,1,12,9,6,0,6,63
1082634,1,12,9,4,1,5,48
1082647,1,12,9,15,0,15,58
980906,2,12,9,9,1,10,76
980936,2,12,9,12,0,12,65
980948,2,12,9,6,3,9,80
980970,2,12,9,6,0,6,65
980984,2,12,9,7,0,7,47
981002,2,12,9,7,0,7,60
981010,2,12,9,7,0,7,59
1082592,2,12,9,9,0,9,82
1082599,2,12,9,3,0,3,58
1082615,2,12,9,7,0,7,68
1082629,2,12,9,1,0,1,52
1082631,2,12,9,1,0,1,89
1082642,2,12,9,9,0,9,74
1082645,2,12,9,3,0,3,58
1082650,2,12,9,2,0,2,50
980934,1,13,9,4,1,5,67
980950,1,13,9,8,1,9,100
980966,1,13,9,5,0,5,57
980972,1,13,9,5,1,6,45
981018,1,13,9,4,0,4,42
981022,1,13,9,11,0,11,63
1082593,1,13,9,4,0,4,76
1082596,1,13,9,3,0,3,57
1082606,1,13,9,9,0,9,67
1082625,1,13,9,6,1,7,62
1082629,1,13,9,14,1,15,86
1082632,1,13,9,6,0,6,83
1082640,1,13,9,15,0,15,85
1082643,1,13,9,17,0,17,93
980910,2,13,9,5,1,6,89
980916,2,13,9,2,0,2,87
980922,2,13,9,3,0,3,66
980942,2,13,9,4,0,4,87
980954,2,13,9,7,0,7,100
980960,2,13,9,7,0,7,49
980980,2,13,9,14,0,14,81
980992,2,13,9,3,1,4,51
981006,2,13,9,3,1,4,87
981012,2,13,9,5,1,6,96
1082603,2,13,9,2,1,3,94
1082610,2,13,9,15,2,17,95
1082613,2,13,9,13,0,13,96
1082616,2,13,9,7,0,7,70
1082621,2,13,9,17,2,19,81
1082637,2,13,9,10,0,10,91
335987,1,1,10,10,0,10,87
335998,1,1,10,3,0,3,72
336002,1,1,10,5,0,5,60
336015,1,1,10,12,0,12,76
336019,1,1,10,10,0,10,73
336022,1,1,10,4,1,5,69
336026,1,1,10,9,0,9,44
336030,1,1,10,5,0,5,61
336032,1,1,10,11,0,11,59
392189,1,1,10,4,0,4,31
392204,1,1,10,5,0,5,61
392212,1,1,10,9,0,9,52
392216,1,1,10,4,0,4,69
392224,1,1,10,1,0,1,52
392226,1,1,10,12,0,12,69
392233,1,1,10,3,0,3,50
419111,1,1,10,2,0,2,57
419127,1,1,10,7,0,7,67
419132,1,1,10,9,0,9,75
419140,1,1,10,10,0,10,80
419144,1,1,10,7,0,7,69
419149,1,1,10,10,1,11,88
419153,1,1,10,1,0,1,83
419158,1,1,10,5,0,5,51
501208,1,1,10,6,4,10,65
501227,1,1,10,6,1,7,76
501235,1,1,10,5,1,6,64
501244,1,1,10,9,0,9,73
501260,1,1,10,9,0,9,58
501272,1,1,10,13,0,13,81
501274,1,1,10,6,0,6,49
548312,1,1,10,10,0,10,85
548320,1,1,10,7,1,8,92
548349,1,1,10,14,0,14,87
548358,1,1,10,8,1,9,98
548373,1,1,10,8,0,8,86
548375,1,1,10,6,0,6,54
548380,1,1,10,5,0,5,45
548383,1,1,10,7,0,7,68
598013,1,1,10,2,2,4,72
598018,1,1,10,8,0,8,76
598027,1,1,10,8,0,8,65
598034,1,1,10,7,0,7,81
598045,1,1,10,0,0,0,50
598058,1,1,10,6,0,6,66
598074,1,1,10,4,0,4,56
729284,1,1,10,9,0,9,63
729294,1,1,10,7,0,7,63
729304,1,1,10,6,0,6,82
734032,1,1,10,13,0,13,86
734048,1,1,10,5,1,6,73
829718,1,1,10,7,0,7,77
829766,1,1,10,8,1,9,72
829776,1,1,10,5,4,9,111
829786,1,1,10,4,0,4,77
980914,1,1,10,9,1,10,81
980952,1,1,10,9,0,9,87
980968,1,1,10,12,0,12,74
980980,1,1,10,14,0,14,57
981000,1,1,10,5,0,5,87
981006,1,1,10,1,0,1,55
981014,1,1,10,8,0,8,85
1082597,1,1,10,7,0,7,79
1082604,1,1,10,8,0,8,75
1082613,1,1,10,8,0,8,96
1082617,1,1,10,7,1,8,87
1082631,1,1,10,4,0,4,59
1082649,1,1,10,4,0,4,43
335991,2,1,10,2,1,3,38
336005,2,1,10,4,0,4,78
336008,2,1,10,7,0,7,52
336040,2,1,10,7,1,8,74
392191,2,1,10,1,0,1,79
392195,2,1,10,4,0,4,67
392202,2,1,10,1,0,1,66
392208,2,1,10,5,1,6,60
392236,2,1,10,5,0,5,83
392238,2,1,10,1,0,1,38
419114,2,1,10,6,0,6,85
419118,2,1,10,6,0,6,67
419123,2,1,10,6,0,6,65
419136,2,1,10,2,1,3,55
419163,2,1,10,5,0,5,69
419166,2,1,10,9,0,9,72
501203,2,1,10,12,0,12,76
501214,2,1,10,6,0,6,90
501219,2,1,10,4,0,4,45
501224,2,1,10,3,4,7,59
501239,2,1,10,9,0,9,71
501247,2,1,10,7,0,7,69
501250,2,1,10,8,1,9,61
501267,2,1,10,5,0,5,74
548317,2,1,10,12,1,13,65
548325,2,1,10,7,0,7,68
548328,2,1,10,3,1,4,70
548333,2,1,10,3,0,3,75
548340,2,1,10,6,1,7,65
548352,2,1,10,4,0,4,68
548362,2,1,10,4,0,4,80
548368,2,1,10,9,0,9,61
548386,2,1,10,9,0,9,100
598003,2,1,10,7,0,7,75
598010,2,1,10,1,4,5,55
598021,2,1,10,8,0,8,82
598036,2,1,10,8,1,9,75
598039,2,1,10,9,0,9,85
598048,2,1,10,7,0,7,82
598055,2,1,10,3,4,7,62
598062,2,1,10,10,0,10,61
598066,2,1,10,8,0,8,74
729312,2,1,10,4,0,4,43
729320,2,1,10,9,0,9,59
733976,2,1,10,2,0,2,66
733984,2,1,10,4,1,5,80
733990,2,1,10,13,0,13,90
734002,2,1,10,10,0,10,89
734014,2,1,10,7,0,7,68
734020,2,1,10,7,0,7,60
734028,2,1,10,8,2,10,88
734042,2,1,10,7,0,7,78
734054,2,1,10,2,0,2,89
829710,2,1,10,11,0,11,85
829728,2,1,10,8,1,9,66
829738,2,1,10,5,0,5,68
829744,2,1,10,7,1,8,79
829748,2,1,10,5,0,5,86
829770,2,1,10,3,0,3,70
829796,2,1,10,5,0,5,74
829810,2,1,10,7,0,7,74
829816,2,1,10,10,0,10,97
980908,2,1,10,2,5,7,69
980920,2,1,10,10,1,11,72
980930,2,1,10,10,0,10,93
980944,2,1,10,6,0,6,78
980956,2,1,10,16,6,22,88
980964,2,1,10,2,1,3,69
981020,2,1,10,3,0,3,66
1082593,2,1,10,7,0,7,116
1082601,2,1,10,9,0,9,116
1082608,2,1,10,8,5,13,88
1082620,2,1,10,13,1,14,101
1082622,2,1,10,8,0,8,101
1082627,2,1,10,9,1,10,82
1082636,2,1,10,9,2,11,126
1082639,2,1,10,3,0,3,79
1082644,2,1,10,5,0,5,92
335997,1,2,10,1,0,1,77
336011,1,2,10,6,0,6,51
336017,1,2,10,11,0,11,56
336021,1,2,10,9,1,10,74
336031,1,2,10,6,0,6,70
336034,1,2,10,3,0,3,41
336039,1,2,10,8,1,9,80
392187,1,2,10,5,0,5,57
392196,1,2,10,6,0,6,71
392199,1,2,10,6,0,6,74
392209,1,2,10,6,0,6,62
392218,1,2,10,5,0,5,49
392241,1,2,10,3,0,3,64
419114,1,2,10,4,0,4,57
419128,1,2,10,5,1,6,67
419138,1,2,10,13,0,13,80
419150,1,2,10,7,0,7,68
501210,1,2,10,9,0,9,50
501237,1,2,10,4,0,4,78
501249,1,2,10,14,0,14,103
501273,1,2,10,8,0,8,73
501275,1,2,10,10,1,11,111
548315,1,2,10,6,0,6,69
548323,1,2,10,6,0,6,96
548341,1,2,10,5,0,5,62
548355,1,2,10,11,0,11,59
548367,1,2,10,3,0,3,88
548372,1,2,10,8,0,8,69
548377,1,2,10,13,0,13,79
598004,1,2,10,3,0,3,59
598009,1,2,10,8,0,8,55
598017,1,2,10,9,0,9,64
598032,1,2,10,4,0,4,128
598041,1,2,10,3,2,5,75
598047,1,2,10,6,10,16,75
598050,1,2,10,3,0,3,52
598059,1,2,10,9,0,9,74
598062,1,2,10,6,1,7,54
598069,1,2,10,10,1,11,88
729310,1,2,10,11,1,12,45
729318,1,2,10,3,0,3,69
734004,1,2,10,11,0,11,57
734010,1,2,10,8,2,10,60
734026,1,2,10,5,0,5,48
734040,1,2,10,10,0,10,56
829724,1,2,10,12,0,12,77
829768,1,2,10,6,1,7,83
829790,1,2,10,14,1,15,104
829800,1,2,10,12,3,15,88
829824,1,2,10,13,0,13,60
829826,1,2,10,4,1,5,46
980912,1,2,10,15,0,15,88
980926,1,2,10,6,4,10,97
980932,1,2,10,9,1,10,89
980936,1,2,10,10,0,10,79
980942,1,2,10,8,0,8,76
980964,1,2,10,15,0,15,79
980982,1,2,10,6,0,6,73
980986,1,2,10,11,0,11,60
980992,1,2,10,13,0,13,72
981004,1,2,10,18,0,18,129
1082595,1,2,10,6,0,6,61
1082598,1,2,10,6,0,6,53
1082602,1,2,10,4,0,4,66
1082610,1,2,10,9,0,9,92
1082621,1,2,10,2,1,3,61
1082628,1,2,10,4,0,4,80
1082636,1,2,10,3,1,4,63
1082646,1,2,10,7,0,7,66
335987,2,2,10,6,2,8,51
335990,2,2,10,7,0,7,76
336001,2,2,10,11,0,11,93
336003,2,2,10,11,1,12,83
336007,2,2,10,3,0,3,61
336015,2,2,10,2,0,2,53
336028,2,2,10,5,0,5,38
392190,2,2,10,3,0,3,56
392193,2,2,10,7,0,7,57
392204,2,2,10,8,0,8,65
392213,2,2,10,6,0,6,74
392223,2,2,10,4,0,4,58
392226,2,2,10,7,0,7,70
392229,2,2,10,5,0,5,57
392237,2,2,10,6,0,6,54
392243,2,2,10,2,1,3,82
392244,2,2,10,9,1,10,69
419117,2,2,10,11,0,11,89
419120,2,2,10,5,0,5,90
419124,2,2,10,8,0,8,85
419133,2,2,10,7,0,7,78
419141,2,2,10,7,2,9,77
419145,2,2,10,5,0,5,56
419153,2,2,10,6,1,7,76
419156,2,2,10,3,0,3,72
419159,2,2,10,6,0,6,91
419162,2,2,10,5,1,6,64
419167,2,2,10,2,1,3,83
419169,2,2,10,6,1,7,53
501205,2,2,10,5,0,5,85
501213,2,2,10,8,0,8,53
501216,2,2,10,10,0,10,67
501227,2,2,10,4,0,4,92
501232,2,2,10,1,0,1,97
501252,2,2,10,7,0,7,109
501257,2,2,10,4,0,4,86
501260,2,2,10,2,2,4,89
501265,2,2,10,7,0,7,69
501271,2,2,10,9,0,9,80
501276,2,2,10,2,0,2,69
548320,2,2,10,10,0,10,43
548329,2,2,10,5,0,5,76
548332,2,2,10,7,0,7,63
548336,2,2,10,12,0,12,72
548349,2,2,10,7,2,9,56
548361,2,2,10,9,0,9,83
548365,2,2,10,4,0,4,54
548381,2,2,10,3,0,3,51
598013,2,2,10,5,0,5,80
598022,2,2,10,10,0,10,84
598028,2,2,10,1,2,3,67
598038,2,2,10,9,1,10,66
598053,2,2,10,8,0,8,69
729286,2,2,10,5,1,6,69
729292,2,2,10,3,0,3,50
729304,2,2,10,5,0,5,77
733982,2,2,10,8,1,9,59
733988,2,2,10,12,4,16,98
733996,2,2,10,4,0,4,52
734018,2,2,10,6,0,6,45
734032,2,2,10,5,0,5,72
829718,2,2,10,10,1,11,77
829742,2,2,10,4,0,4,60
829750,2,2,10,13,0,13,75
829754,2,2,10,7,0,7,83
829762,2,2,10,3,0,3,90
829776,2,2,10,15,0,15,115
829784,2,2,10,6,0,6,71
829808,2,2,10,4,1,5,84
980958,2,2,10,6,0,6,83
980974,2,2,10,11,0,11,81
981000,2,2,10,9,0,9,91
981016,2,2,10,8,0,8,83
981018,2,2,10,5,0,5,70
981024,2,2,10,12,0,12,112
1082591,2,2,10,12,1,13,98
1082607,2,2,10,3,1,4,67
1082617,2,2,10,1,0,1,49
1082624,2,2,10,0,1,1,49
1082633,2,2,10,13,0,13,68
335988,1,3,10,5,0,5,88
335994,1,3,10,9,1,10,82
336001,1,3,10,5,0,5,65
336006,1,3,10,12,0,12,82
336010,1,3,10,7,0,7,58
336012,1,3,10,6,0,6,66
336018,1,3,10,6,1,7,85
336023,1,3,10,9,2,11,57
336045,1,3,10,11,0,11,75
392190,1,3,10,9,0,9,106
392201,1,3,10,10,1,11,88
392207,1,3,10,12,0,12,81
392211,1,3,10,13,0,13,77
392214,1,3,10,6,0,6,84
392219,1,3,10,4,0,4,80
392229,1,3,10,5,0,5,72
392236,1,3,10,5,0,5,83
392239,1,3,10,5,0,5,70
392243,1,3,10,4,0,4,74
419118,1,3,10,4,0,4,59
419130,1,3,10,14,0,14,85
419142,1,3,10,2,0,2,91
419147,1,3,10,14,1,15,85
419152,1,3,10,5,0,5,74
419160,1,3,10,2,0,2,55
419168,1,3,10,7,0,7,62
419170,1,3,10,8,1,9,58
501203,1,3,10,6,0,6,78
501211,1,3,10,12,0,12,67
501216,1,3,10,9,0,9,80
501220,1,3,10,7,0,7,72
501231,1,3,10,3,0,3,66
501241,1,3,10,5,0,5,58
501250,1,3,10,10,0,10,40
501254,1,3,10,7,0,7,84
501258,1,3,10,12,0,12,67
501266,1,3,10,3,0,3,64
501271,1,3,10,1,0,1,36
501276,1,3,10,10,0,10,94
548311,1,3,10,6,0,6,75
548316,1,3,10,4,0,4,75
548321,1,3,10,3,0,3,66
548327,1,3,10,4,0,4,71
548335,1,3,10,4,0,4,68
548352,1,3,10,6,1,7,74
548357,1,3,10,7,0,7,82
548360,1,3,10,4,0,4,72
548376,1,3,10,1,0,1,45
548384,1,3,10,14,0,14,61
548385,1,3,10,6,0,6,83
548386,1,3,10,4,0,4,86
598025,1,3,10,3,1,4,60
598039,1,3,10,7,0,7,103
598043,1,3,10,9,0,9,55
598046,1,3,10,14,0,14,69
598056,1,3,10,12,0,12,91
598063,1,3,10,8,1,9,75
598067,1,3,10,2,0,2,71
598075,1,3,10,6,0,6,69
729288,1,3,10,6,0,6,102
729298,1,3,10,10,0,10,65
729302,1,3,10,5,0,5,71
733976,1,3,10,13,0,13,85
734018,1,3,10,3,0,3,55
734028,1,3,10,4,0,4,59
734034,1,3,10,4,0,4,81
829712,1,3,10,4,0,4,82
829716,1,3,10,11,0,11,89
829728,1,3,10,7,0,7,88
829740,1,3,10,3,0,3,68
829750,1,3,10,7,0,7,81
829758,1,3,10,11,1,12,97
829770,1,3,10,2,6,8,73
829784,1,3,10,3,2,5,68
829794,1,3,10,2,0,2,67
829802,1,3,10,10,0,10,60
829806,1,3,10,1,0,1,46
335998,2,3,10,5,0,5,77
336014,2,3,10,3,0,3,98
336034,2,3,10,1,0,1,61
336038,2,3,10,13,2,15,99
336042,2,3,10,4,0,4,72
336044,2,3,10,2,0,2,62
392186,2,3,10,3,1,4,70
392194,2,3,10,9,0,9,106
392207,2,3,10,3,0,3,57
392222,2,3,10,5,1,6,67
392232,2,3,10,5,1,6,56
419115,2,3,10,11,0,11,70
419121,2,3,10,13,0,13,102
419126,2,3,10,6,0,6,73
419128,2,3,10,8,0,8,61
419134,2,3,10,4,0,4,80
419138,2,3,10,8,0,8,89
419158,2,3,10,14,1,15,103
419164,2,3,10,8,0,8,94
501226,2,3,10,8,0,8,84
501233,2,3,10,10,0,10,65
501245,2,3,10,6,0,6,73
501273,2,3,10,10,0,10,62
548323,2,3,10,14,0,14,85
548337,2,3,10,4,0,4,70
548348,2,3,10,3,0,3,69
548366,2,3,10,4,0,4,53
548369,2,3,10,5,0,5,75
548373,2,3,10,8,0,8,96
598007,2,3,10,9,0,9,58
598012,2,3,10,6,0,6,65
598017,2,3,10,10,0,10,64
598020,2,3,10,6,0,6,63
598027,2,3,10,8,0,8,48
598031,2,3,10,11,0,11,92
598035,2,3,10,1,0,1,76
598051,2,3,10,8,0,8,48
598078,2,3,10,3,1,4,54
729308,2,3,10,10,1,11,76
729316,2,3,10,3,0,3,75
733986,2,3,10,2,0,2,69
733992,2,3,10,13,0,13,85
734000,2,3,10,15,0,15,75
734008,2,3,10,2,0,2,76
734040,2,3,10,3,0,3,87
734050,2,3,10,9,0,9,89
734052,2,3,10,3,2,5,122
829734,2,3,10,7,0,7,128
829778,2,3,10,6,0,6,87
829814,2,3,10,9,0,9,76
829822,2,3,10,6,1,7,86
829826,2,3,10,4,0,4,62
829828,2,3,10,9,1,10,67
335992,1,4,10,9,0,9,82
335996,1,4,10,8,0,8,94
336008,1,4,10,3,0,3,85
336024,1,4,10,9,0,9,88
336033,1,4,10,10,0,10,84
336040,1,4,10,11,0,11,82
336044,1,4,10,1,0,1,45
392188,1,4,10,12,1,13,91
392191,1,4,10,9,0,9,67
392200,1,4,10,8,0,8,60
392205,1,4,10,6,2,8,50
392227,1,4,10,3,0,3,70
392234,1,4,10,3,0,3,55
419113,1,4,10,10,0,10,76
419117,1,4,10,14,0,14,87
419126,1,4,10,4,0,4,59
419137,1,4,10,9,0,9,85
419141,1,4,10,8,0,8,74
419148,1,4,10,7,0,7,86
419161,1,4,10,9,0,9,72
419164,1,4,10,12,0,12,86
501207,1,4,10,1,0,1,46
501225,1,4,10,8,0,8,106
501239,1,4,10,2,0,2,55
501253,1,4,10,11,0,11,71
501256,1,4,10,13,5,18,86
501262,1,4,10,6,0,6,66
501265,1,4,10,21,1,22,99
548328,1,4,10,11,0,11,60
548333,1,4,10,2,0,2,63
548336,1,4,10,6,0,6,70
548344,1,4,10,3,0,3,56
548348,1,4,10,4,1,5,77
548364,1,4,10,9,0,9,86
548374,1,4,10,2,0,2,64
548379,1,4,10,14,0,14,50
598012,1,4,10,8,0,8,72
598019,1,4,10,10,1,11,57
598021,1,4,10,7,0,7,70
598026,1,4,10,7,0,7,55
598033,1,4,10,6,2,8,76
598036,1,4,10,8,0,8,72
598057,1,4,10,7,2,9,74
598071,1,4,10,12,0,12,80
729300,1,4,10,14,1,15,77
729312,1,4,10,5,0,5,76
733978,1,4,10,6,1,7,70
733992,1,4,10,9,0,9,69
733996,1,4,10,14,0,14,107
734002,1,4,10,12,0,12,85
734030,1,4,10,5,0,5,90
734038,1,4,10,6,2,8,83
734052,1,4,10,10,1,11,109
734054,1,4,10,4,0,4,58
829722,1,4,10,9,1,10,87
829730,1,4,10,3,0,3,73
829738,1,4,10,11,2,13,77
829772,1,4,10,3,0,3,46
829796,1,4,10,11,0,11,75
829808,1,4,10,6,0,6,106
829814,1,4,10,2,0,2,56
980910,1,4,10,5,0,5,87
980918,1,4,10,4,0,4,58
980930,1,4,10,4,0,4,56
980940,1,4,10,2,0,2,65
980960,1,4,10,4,0,4,78
980976,1,4,10,7,0,7,76
980996,1,4,10,11,0,11,77
981010,1,4,10,9,0,9,76
1082601,1,4,10,17,0,17,95
1082612,1,4,10,6,0,6,69
1082616,1,4,10,7,1,8,88
1082633,1,4,10,2,0,2,55
1082637,1,4,10,9,0,9,81
1082639,1,4,10,5,1,6,63
1082641,1,4,10,4,1,5,126
1082645,1,4,10,5,0,5,55
335988,2,4,10,13,0,13,110
336000,2,4,10,6,0,6,81
336004,2,4,10,10,0,10,77
336011,2,4,10,14,0,14,81
336018,2,4,10,7,1,8,76
336021,2,4,10,4,0,4,70
336036,2,4,10,4,0,4,101
392196,2,4,10,12,1,13,80
392209,2,4,10,7,0,7,70
392212,2,4,10,3,1,4,81
392215,2,4,10,2,2,4,53
392219,2,4,10,5,1,6,90
392221,2,4,10,6,0,6,86
392231,2,4,10,1,0,1,46
392239,2,4,10,3,1,4,42
419122,2,4,10,6,0,6,57
419129,2,4,10,9,1,10,102
419132,2,4,10,9,0,9,74
419144,2,4,10,14,0,14,107
419151,2,4,10,6,0,6,87
419154,2,4,10,6,1,7,59
501211,2,4,10,13,0,13,99
501217,2,4,10,8,0,8,104
501228,2,4,10,5,0,5,96
501242,2,4,10,6,1,7,62
501249,2,4,10,4,0,4,62
501259,2,4,10,11,1,12,84
501269,2,4,10,4,1,5,77
548314,2,4,10,4,1,5,73
548318,2,4,10,4,4,8,53
548324,2,4,10,5,0,5,60
548339,2,4,10,14,0,14,75
548355,2,4,10,7,0,7,80
548359,2,4,10,5,0,5,65
548371,2,4,10,11,0,11,76
548376,2,4,10,8,1,9,65
598008,2,4,10,9,0,9,84
598030,2,4,10,11,0,11,83
598042,2,4,10,3,0,3,80
598046,2,4,10,8,0,8,65
598050,2,4,10,3,0,3,79
598061,2,4,10,3,0,3,54
598064,2,4,10,7,4,11,77
598069,2,4,10,6,4,10,68
729288,2,4,10,3,0,3,93
729296,2,4,10,4,0,4,69
729318,2,4,10,3,4,7,63
734012,2,4,10,6,0,6,131
734024,2,4,10,3,0,3,95
734044,2,4,10,8,1,9,78
734048,2,4,10,8,0,8,68
829714,2,4,10,1,0,1,66
829746,2,4,10,6,0,6,67
829758,2,4,10,2,0,2,57
829764,2,4,10,4,1,5,61
829780,2,4,10,4,0,4,73
829790,2,4,10,12,0,12,63
829804,2,4,10,5,0,5,70
980924,2,4,10,7,0,7,71
980946,2,4,10,7,0,7,75
980968,2,4,10,11,0,11,64
980982,2,4,10,9,0,9,83
980990,2,4,10,8,0,8,61
981004,2,4,10,5,1,6,90
1082594,2,4,10,7,0,7,73
1082598,2,4,10,11,1,12,97
1082605,2,4,10,11,0,11,64
1082609,2,4,10,1,0,1,62
1082623,2,4,10,1,0,1,76
335989,1,5,10,5,1,6,53
336005,1,5,10,14,0,14,89
336013,1,5,10,5,0,5,79
336028,1,5,10,5,3,8,94
336038,1,5,10,12,0,12,107
336043,1,5,10,5,1,6,83
392195,1,5,10,4,1,5,78
392215,1,5,10,13,1,14,93
392222,1,5,10,6,0,6,61
392230,1,5,10,4,0,4,66
392238,1,5,10,2,1,3,61
419116,1,5,10,3,0,3,57
419120,1,5,10,2,0,2,45
419123,1,5,10,12,0,12,92
419129,1,5,10,10,0,10,87
419134,1,5,10,10,0,10,96
419146,1,5,10,7,0,7,82
419159,1,5,10,5,0,5,53
419163,1,5,10,4,0,4,73
501214,1,5,10,10,0,10,67
501219,1,5,10,5,0,5,61
501245,1,5,10,14,0,14,86
501257,1,5,10,6,0,6,74
501263,1,5,10,5,0,5,69
548314,1,5,10,8,1,9,82
548317,1,5,10,6,0,6,68
548325,1,5,10,2,5,7,58
548329,1,5,10,4,0,4,61
548337,1,5,10,6,0,6,62
548354,1,5,10,8,0,8,80
548359,1,5,10,7,0,7,94
548366,1,5,10,16,2,18,61
548370,1,5,10,16,0,16,77
548378,1,5,10,6,0,6,61
548382,1,5,10,20,2,22,74
598006,1,5,10,8,0,8,73
598010,1,5,10,10,0,10,63
598014,1,5,10,10,1,11,72
598024,1,5,10,15,1,16,88
598028,1,5,10,6,0,6,66
598031,1,5,10,5,1,6,88
598048,1,5,10,7,2,9,71
598077,1,5,10,4,0,4,65
729296,1,5,10,8,0,8,85
729320,1,5,10,6,0,6,63
733984,1,5,10,5,0,5,76
734008,1,5,10,19,0,19,84
734016,1,5,10,7,2,9,86
734046,1,5,10,5,1,6,59
829714,1,5,10,12,0,12,73
829746,1,5,10,12,0,12,90
829754,1,5,10,5,0,5,73
829782,1,5,10,10,0,10,74
829816,1,5,10,10,2,12,107
335992,2,5,10,11,0,11,87
335995,2,5,10,4,0,4,114
335997,2,5,10,4,1,5,73
336010,2,5,10,4,0,4,78
336016,2,5,10,12,0,12,81
336020,2,5,10,15,0,15,80
336024,2,5,10,13,0,13,67
336032,2,5,10,7,0,7,69
336041,2,5,10,13,0,13,67
336045,2,5,10,14,0,14,75
392187,2,5,10,4,0,4,32
392200,2,5,10,5,0,5,48
392203,2,5,10,4,0,4,60
392207,2,5,10,4,0,4,61
392210,2,5,10,6,0,6,60
392218,2,5,10,11,0,11,62
392225,2,5,10,8,0,8,59
392235,2,5,10,9,1,10,60
419112,2,5,10,4,0,4,69
419131,2,5,10,11,0,11,95
419139,2,5,10,2,0,2,69
419142,2,5,10,15,0,15,105
419148,2,5,10,3,0,3,111
419155,2,5,10,9,0,9,60
501204,2,5,10,4,0,4,60
501209,2,5,10,12,0,12,86
501225,2,5,10,6,0,6,61
501230,2,5,10,11,0,11,64
501236,2,5,10,9,0,9,46
501240,2,5,10,7,1,8,59
501254,2,5,10,2,0,2,70
501268,2,5,10,9,0,9,97
548322,2,5,10,7,0,7,79
548331,2,5,10,11,0,11,89
548341,2,5,10,8,0,8,67
548350,2,5,10,6,0,6,67
548363,2,5,10,6,0,6,79
598019,2,5,10,6,0,6,68
598037,2,5,10,8,0,8,53
598041,2,5,10,7,0,7,80
598052,2,5,10,8,0,8,84
598054,2,5,10,9,0,9,77
598057,2,5,10,8,0,8,73
598063,2,5,10,6,0,6,49
598068,2,5,10,2,0,2,60
598070,2,5,10,2,0,2,44
598076,2,5,10,2,0,2,57
729290,2,5,10,12,0,12,61
729302,2,5,10,3,0,3,56
729310,2,5,10,2,0,2,48
733980,2,5,10,11,0,11,71
733994,2,5,10,7,4,11,60
734004,2,5,10,5,0,5,68
734022,2,5,10,1,0,1,69
734038,2,5,10,5,1,6,64
829720,2,5,10,11,0,11,74
829726,2,5,10,4,0,4,69
829732,2,5,10,6,0,6,63
829740,2,5,10,15,0,15,88
829774,2,5,10,5,0,5,87
829792,2,5,10,15,0,15,68
829802,2,5,10,4,0,4,63
829824,2,5,10,7,0,7,68
336000,1,6,10,9,0,9,69
336003,1,6,10,12,0,12,91
336014,1,6,10,8,1,9,83
336020,1,6,10,3,1,4,68
336025,1,6,10,9,1,10,76
336027,1,6,10,10,1,11,115
392194,1,6,10,8,0,8,90
392203,1,6,10,5,0,5,66
392228,1,6,10,3,1,4,81
392231,1,6,10,1,0,1,52
392235,1,6,10,5,0,5,60
392237,1,6,10,5,0,5,63
392242,1,6,10,4,4,8,83
419121,1,6,10,4,1,5,89
419133,1,6,10,6,1,7,95
419136,1,6,10,9,0,9,91
419139,1,6,10,8,1,9,79
419145,1,6,10,10,0,10,89
419154,1,6,10,5,0,5,63
501206,1,6,10,8,0,8,53
501209,1,6,10,1,1,2,43
501228,1,6,10,11,0,11,115
501232,1,6,10,5,0,5,69
501238,1,6,10,4,0,4,46
501243,1,6,10,7,0,7,62
501270,1,6,10,7,1,8,55
548347,1,6,10,6,0,6,88
548350,1,6,10,11,0,11,73
548362,1,6,10,4,0,4,79
548369,1,6,10,4,0,4,52
598003,1,6,10,8,0,8,68
598015,1,6,10,2,0,2,46
598022,1,6,10,3,1,4,67
598040,1,6,10,1,0,1,68
598049,1,6,10,5,0,5,43
598054,1,6,10,2,0,2,55
598064,1,6,10,3,0,3,54
729286,1,6,10,5,4,9,49
733980,1,6,10,2,1,3,71
733986,1,6,10,9,0,9,75
733990,1,6,10,5,0,5,66
733998,1,6,10,2,0,2,75
734024,1,6,10,6,0,6,84
734044,1,6,10,3,1,4,69
829720,1,6,10,13,0,13,84
829736,1,6,10,14,0,14,80
829744,1,6,10,9,0,9,69
829752,1,6,10,5,0,5,65
829762,1,6,10,9,0,9,54
829788,1,6,10,3,0,3,69
829818,1,6,10,10,2,12,91
980908,1,6,10,2,0,2,55
980938,1,6,10,4,1,5,65
980956,1,6,10,9,0,9,70
980970,1,6,10,5,1,6,69
981002,1,6,10,7,0,7,49
981016,1,6,10,8,0,8,75
1082599,1,6,10,5,0,5,81
1082605,1,6,10,12,0,12,83
1082608,1,6,10,12,0,12,83
1082622,1,6,10,7,0,7,78
1082626,1,6,10,4,0,4,37
1082642,1,6,10,2,0,2,85
335989,2,6,10,7,1,8,86
335993,2,6,10,12,0,12,95
336006,2,6,10,5,0,5,106
336009,2,6,10,16,0,16,81
336022,2,6,10,5,0,5,64
336031,2,6,10,5,0,5,105
336037,2,6,10,9,0,9,88
336043,2,6,10,6,2,8,56
392199,2,6,10,3,0,3,64
392206,2,6,10,8,0,8,70
392211,2,6,10,3,0,3,72
392216,2,6,10,3,0,3,76
392220,2,6,10,6,0,6,52
392224,2,6,10,3,0,3,72
392240,2,6,10,16,0,16,93
419113,2,6,10,7,0,7,61
419116,2,6,10,9,0,9,99
419119,2,6,10,3,0,3,83
419125,2,6,10,4,0,4,85
419149,2,6,10,11,0,11,91
419157,2,6,10,3,2,5,87
419160,2,6,10,5,1,6,56
419165,2,6,10,4,0,4,59
501218,2,6,10,8,0,8,98
501221,2,6,10,7,0,7,78
501235,2,6,10,7,0,7,60
501248,2,6,10,17,0,17,85
501251,2,6,10,10,0,10,56
501258,2,6,10,4,1,5,65
501262,2,6,10,6,0,6,67
548312,2,6,10,17,0,17,87
548315,2,6,10,2,0,2,68
548321,2,6,10,10,0,10,79
548326,2,6,10,7,1,8,71
548330,2,6,10,5,0,5,58
548334,2,6,10,10,0,10,112
548338,2,6,10,4,1,5,92
548342,2,6,10,9,0,9,99
548354,2,6,10,8,0,8,96
548374,2,6,10,2,0,2,55
548377,2,6,10,14,0,14,96
548379,2,6,10,4,1,5,87
548383,2,6,10,9,1,10,83
548385,2,6,10,7,0,7,89
598006,2,6,10,7,1,8,73
598011,2,6,10,14,1,15,84
598025,2,6,10,9,0,9,58
598029,2,6,10,14,0,14,102
598033,2,6,10,11,4,15,57
598045,2,6,10,6,0,6,56
598059,2,6,10,4,0,4,88
598067,2,6,10,4,1,5,65
598072,2,6,10,3,0,3,65
729294,2,6,10,13,0,13,84
729298,2,6,10,7,0,7,53
729306,2,6,10,14,0,14,86
729314,2,6,10,6,0,6,50
734010,2,6,10,3,0,3,76
734016,2,6,10,5,0,5,62
734036,2,6,10,3,0,3,62
829712,2,6,10,9,0,9,67
829730,2,6,10,5,0,5,69
829766,2,6,10,10,0,10,64
829772,2,6,10,11,0,11,75
829782,2,6,10,0,1,1,67
829798,2,6,10,3,0,3,65
829806,2,6,10,6,0,6,66
980918,2,6,10,6,2,8,68
980926,2,6,10,12,0,12,93
980950,2,6,10,8,0,8,51
980966,2,6,10,8,0,8,93
980976,2,6,10,15,0,15,91
980988,2,6,10,4,0,4,78
980998,2,6,10,10,1,11,81
981008,2,6,10,6,0,6,68
1082595,2,6,10,9,0,9,79
1082611,2,6,10,6,1,7,87
1082614,2,6,10,13,0,13,57
1082630,2,6,10,15,1,16,96
1082632,2,6,10,16,0,16,113
1082635,2,6,10,2,1,3,50
1082640,2,6,10,10,0,10,92
1082646,2,6,10,8,1,9,76
335990,1,7,10,1,1,2,74
335999,1,7,10,7,0,7,54
336009,1,7,10,8,4,12,74
336029,1,7,10,4,0,4,78
336037,1,7,10,2,0,2,81
336041,1,7,10,9,0,9,60
392186,1,7,10,9,0,9,64
392202,1,7,10,8,0,8,111
392208,1,7,10,5,0,5,61
392213,1,7,10,5,0,5,53
392220,1,7,10,4,0,4,43
392223,1,7,10,5,0,5,67
392232,1,7,10,5,0,5,70
392240,1,7,10,4,2,6,72
419112,1,7,10,11,1,12,101
419119,1,7,10,7,7,14,112
419124,1,7,10,5,0,5,74
419135,1,7,10,5,1,6,78
419143,1,7,10,8,0,8,70
419151,1,7,10,8,0,8,74
419155,1,7,10,5,0,5,73
419157,1,7,10,2,0,2,65
419162,1,7,10,5,2,7,75
419166,1,7,10,3,0,3,69
419167,1,7,10,6,1,7,81
501215,1,7,10,6,0,6,71
501226,1,7,10,6,2,8,67
501229,1,7,10,2,0,2,72
501236,1,7,10,2,0,2,50
501242,1,7,10,10,0,10,67
501246,1,7,10,3,0,3,65
501251,1,7,10,9,0,9,76
501268,1,7,10,4,0,4,55
548322,1,7,10,4,1,5,80
548330,1,7,10,3,0,3,43
548339,1,7,10,2,0,2,58
548356,1,7,10,11,5,16,72
548365,1,7,10,6,0,6,48
548368,1,7,10,6,1,7,76
598007,1,7,10,5,0,5,72
598011,1,7,10,5,0,5,80
598016,1,7,10,8,0,8,72
598029,1,7,10,4,0,4,53
598038,1,7,10,11,0,11,97
598042,1,7,10,11,0,11,59
598044,1,7,10,7,0,7,60
598051,1,7,10,2,0,2,47
598055,1,7,10,6,0,6,69
598068,1,7,10,8,0,8,81
598078,1,7,10,7,1,8,58
729292,1,7,10,3,0,3,63
729308,1,7,10,10,0,10,57
729314,1,7,10,3,0,3,49
733988,1,7,10,8,0,8,85
734000,1,7,10,3,0,3,57
734014,1,7,10,6,0,6,62
734022,1,7,10,6,0,6,76
734036,1,7,10,10,0,10,100
734050,1,7,10,10,0,10,82
829710,1,7,10,3,0,3,57
829726,1,7,10,6,0,6,45
829734,1,7,10,9,0,9,62
829742,1,7,10,10,0,10,83
829756,1,7,10,10,0,10,72
829774,1,7,10,7,1,8,81
829780,1,7,10,12,0,12,96
829810,1,7,10,8,0,8,67
829822,1,7,10,8,0,8,86
829828,1,7,10,10,0,10,98
980906,1,7,10,1,0,1,48
980922,1,7,10,8,0,8,59
980928,1,7,10,4,0,4,58
980946,1,7,10,8,0,8,77
980990,1,7,10,8,0,8,45
980998,1,7,10,10,0,10,84
981012,1,7,10,5,0,5,72
1082592,1,7,10,6,0,6,82
1082614,1,7,10,5,2,7,68
1082635,1,7,10,5,0,5,84
1082638,1,7,10,5,1,6,59
1082644,1,7,10,7,0,7,79
1082650,1,7,10,6,0,6,56
335994,2,7,10,8,0,8,83
335996,2,7,10,2,0,2,67
336002,2,7,10,5,1,6,69
336013,2,7,10,12,1,13,64
336017,2,7,10,8,0,8,79
336023,2,7,10,14,3,17,107
336033,2,7,10,7,0,7,90
392197,2,7,10,8,0,8,84
392202,2,7,10,4,0,4,70
392205,2,7,10,3,0,3,47
392217,2,7,10,10,0,10,71
392227,2,7,10,12,0,12,74
392230,2,7,10,5,0,5,54
419119,2,7,10,1,0,1,84
419127,2,7,10,5,0,5,76
419130,2,7,10,4,0,4,98
419137,2,7,10,8,0,8,82
419147,2,7,10,5,0,5,67
419170,2,7,10,14,1,15,58
501206,2,7,10,3,1,4,48
501210,2,7,10,12,0,12,78
501223,2,7,10,6,0,6,63
501256,2,7,10,8,0,8,63
501261,2,7,10,4,4,8,49
501272,2,7,10,8,1,9,84
501274,2,7,10,4,0,4,87
501275,2,7,10,8,0,8,80
548311,2,7,10,4,0,4,76
548313,2,7,10,4,0,4,48
548319,2,7,10,5,0,5,49
548344,2,7,10,5,0,5,64
548347,2,7,10,9,1,10,88
548351,2,7,10,5,0,5,52
548360,2,7,10,4,0,4,74
548372,2,7,10,5,0,5,56
548375,2,7,10,7,0,7,59
548382,2,7,10,7,0,7,79
548384,2,7,10,4,1,5,77
598004,2,7,10,2,2,4,62
598024,2,7,10,3,0,3,42
598034,2,7,10,4,0,4,79
598060,2,7,10,5,0,5,50
598065,2,7,10,6,0,6,73
598071,2,7,10,7,0,7,69
598075,2,7,10,3,0,3,92
598077,2,7,10,3,0,3,73
729284,2,7,10,7,0,7,54
729322,2,7,10,12,0,12,60
733978,2,7,10,1,0,1,70
734006,2,7,10,13,0,13,75
734030,2,7,10,11,0,11,96
734046,2,7,10,15,1,16,120
829722,2,7,10,5,0,5,32
829752,2,7,10,9,0,9,81
829788,2,7,10,4,0,4,61
829794,2,7,10,9,0,9,84
829800,2,7,10,17,0,17,83
829820,2,7,10,7,1,8,73
980914,2,7,10,10,5,15,87
980932,2,7,10,11,0,11,81
980938,2,7,10,8,0,8,78
980952,2,7,10,7,0,7,85
980962,2,7,10,4,0,4,76
980978,2,7,10,4,0,4,54
980986,2,7,10,2,0,2,60
1082597,2,7,10,2,0,2,74
1082600,2,7,10,9,0,9,85
1082602,2,7,10,11,0,11,48
1082606,2,7,10,3,1,4,89
1082612,2,7,10,6,0,6,123
1082618,2,7,10,8,0,8,68
1082625,2,7,10,6,0,6,82
1082628,2,7,10,4,0,4,74
1082641,2,7,10,4,0,4,108
1082647,2,7,10,9,0,9,71
1082649,2,7,10,3,0,3,64
335991,1,8,10,2,2,4,52
335993,1,8,10,1,1,2,45
335995,1,8,10,7,0,7,85
336004,1,8,10,9,0,9,76
336007,1,8,10,5,0,5,81
336016,1,8,10,8,0,8,74
336036,1,8,10,3,1,4,70
336042,1,8,10,6,0,6,57
392193,1,8,10,14,0,14,91
392197,1,8,10,12,0,12,88
392206,1,8,10,3,0,3,55
392210,1,8,10,4,0,4,58
392217,1,8,10,4,0,4,63
392221,1,8,10,2,0,2,72
392225,1,8,10,8,0,8,77
392244,1,8,10,3,0,3,62
419115,1,8,10,11,0,11,80
419122,1,8,10,16,0,16,100
419125,1,8,10,6,0,6,77
419131,1,8,10,6,1,7,79
419156,1,8,10,12,0,12,71
419165,1,8,10,13,0,13,79
419169,1,8,10,2,0,2,43
501204,1,8,10,5,0,5,69
501213,1,8,10,3,0,3,73
501217,1,8,10,10,0,10,81
501221,1,8,10,13,0,13,90
501234,1,8,10,4,0,4,37
501248,1,8,10,9,0,9,67
501255,1,8,10,7,0,7,72
501261,1,8,10,1,0,1,53
501269,1,8,10,3,0,3,85
548319,1,8,10,6,0,6,61
548326,1,8,10,3,0,3,84
548331,1,8,10,6,0,6,83
548334,1,8,10,3,1,4,64
548340,1,8,10,6,0,6,67
548346,1,8,10,6,1,7,71
548351,1,8,10,3,0,3,51
548353,1,8,10,10,0,10,58
548361,1,8,10,5,0,5,74
548371,1,8,10,11,0,11,76
548381,1,8,10,5,1,6,47
335999,2,8,10,21,1,22,130
336012,2,8,10,1,0,1,78
336019,2,8,10,2,2,4,74
336025,2,8,10,6,0,6,84
336029,2,8,10,3,0,3,59
336039,2,8,10,5,1,6,63
392189,2,8,10,16,1,17,69
392201,2,8,10,5,0,5,85
392214,2,8,10,3,1,4,79
392228,2,8,10,3,0,3,83
392233,2,8,10,3,0,3,71
392234,2,8,10,4,0,4,65
392241,2,8,10,6,1,7,85
392242,2,8,10,4,0,4,102
419111,2,8,10,11,0,11,88
419135,2,8,10,9,0,9,78
419140,2,8,10,8,1,9,87
419143,2,8,10,7,0,7,68
419146,2,8,10,9,0,9,86
419150,2,8,10,9,3,12,80
419152,2,8,10,4,0,4,56
419161,2,8,10,8,0,8,82
419168,2,8,10,3,0,3,43
501208,2,8,10,9,0,9,62
501229,2,8,10,7,0,7,72
501241,2,8,10,7,0,7,88
501244,2,8,10,4,0,4,68
501264,2,8,10,7,0,7,78
548316,2,8,10,10,0,10,73
548357,2,8,10,6,1,7,76
548364,2,8,10,2,0,2,70
548378,2,8,10,3,1,4,69
501205,1,9,10,2,0,2,82
501212,1,9,10,12,0,12,65
501224,1,9,10,0,0,0,55
501230,1,9,10,7,0,7,54
501247,1,9,10,9,0,9,69
501252,1,9,10,4,0,4,72
501259,1,9,10,9,0,9,103
501215,2,9,10,10,0,10,84
501220,2,9,10,9,0,9,90
501234,2,9,10,2,0,2,45
501238,2,9,10,2,1,3,51
501243,2,9,10,6,1,7,89
501266,2,9,10,3,0,3,63
501218,1,10,10,14,0,14,98
501223,1,10,10,6,0,6,60
501233,1,10,10,4,0,4,54
501240,1,10,10,5,0,5,77
501264,1,10,10,9,0,9,62
501267,1,10,10,8,0,8,54
548313,1,10,10,3,0,3,51
548318,1,10,10,12,1,13,71
548324,1,10,10,7,0,7,62
548332,1,10,10,11,1,12,96
548338,1,10,10,4,2,6,88
548342,1,10,10,4,0,4,50
548363,1,10,10,6,0,6,56
598008,1,10,10,5,0,5,38
598020,1,10,10,8,0,8,78
598030,1,10,10,9,0,9,77
598052,1,10,10,11,1,12,92
598060,1,10,10,4,0,4,58
598066,1,10,10,15,0,15,72
598072,1,10,10,3,0,3,74
501207,2,10,10,2,1,3,74
501212,2,10,10,2,0,2,61
501231,2,10,10,6,0,6,58
501237,2,10,10,3,0,3,63
501246,2,10,10,1,0,1,48
501253,2,10,10,4,0,4,69
501255,2,10,10,9,0,9,82
548327,2,10,10,6,0,6,72
548335,2,10,10,4,0,4,65
548346,2,10,10,2,0,2,73
548353,2,10,10,6,0,6,75
548356,2,10,10,2,0,2,47
548358,2,10,10,10,1,11,66
548367,2,10,10,6,1,7,80
548370,2,10,10,8,0,8,60
548380,2,10,10,6,0,6,61
598005,2,10,10,4,0,4,48
598014,2,10,10,5,0,5,87
598016,2,10,10,4,0,4,72
598023,2,10,10,6,0,6,65
598032,2,10,10,8,0,8,76
598040,2,10,10,4,0,4,75
598043,2,10,10,7,0,7,68
598047,2,10,10,8,1,9,77
598058,2,10,10,5,0,5,49
598005,1,11,10,2,0,2,60
598023,1,11,10,1,0,1,42
598035,1,11,10,3,2,5,62
598037,1,11,10,7,0,7,64
598053,1,11,10,6,0,6,62
598061,1,11,10,4,0,4,56
598065,1,11,10,10,0,10,87
598070,1,11,10,8,0,8,48
598076,1,11,10,6,0,6,48
729290,1,11,10,7,0,7,69
729306,1,11,10,9,0,9,81
729316,1,11,10,3,0,3,65
729322,1,11,10,6,0,6,71
733982,1,11,10,10,1,11,72
733994,1,11,10,6,1,7,74
734006,1,11,10,2,0,2,70
734012,1,11,10,5,0,5,72
734020,1,11,10,12,0,12,77
734042,1,11,10,5,0,5,78
829732,1,11,10,4,0,4,55
829748,1,11,10,13,0,13,80
829764,1,11,10,6,0,6,76
829778,1,11,10,8,0,8,107
829792,1,11,10,12,0,12,88
829798,1,11,10,5,0,5,62
829804,1,11,10,12,1,13,86
829812,1,11,10,8,0,8,125
829820,1,11,10,4,0,4,54
980920,1,11,10,3,1,4,52
980948,1,11,10,3,0,3,39
980958,1,11,10,8,0,8,82
980978,1,11,10,8,1,9,85
980984,1,11,10,11,1,12,63
980988,1,11,10,11,1,12,80
981008,1,11,10,4,1,5,68
981020,1,11,10,9,0,9,71
981024,1,11,10,9,0,9,97
1082591,1,11,10,4,0,4,88
1082600,1,11,10,11,2,13,75
1082609,1,11,10,3,1,4,54
1082611,1,11,10,7,0,7,80
1082615,1,11,10,8,0,8,65
1082623,1,11,10,8,0,8,107
1082627,1,11,10,18,0,18,123
1082630,1,11,10,4,1,5,83
1082648,1,11,10,13,0,13,61
598009,2,11,10,4,0,4,56
598015,2,11,10,1,1,2,51
598018,2,11,10,11,0,11,68
598026,2,11,10,6,0,6,56
598044,2,11,10,4,1,5,61
598049,2,11,10,3,0,3,55
598056,2,11,10,11,0,11,75
598074,2,11,10,3,0,3,77
729300,2,11,10,10,0,10,74
734026,2,11,10,4,0,4,72
734034,2,11,10,8,0,8,100
829716,2,11,10,10,1,11,80
829724,2,11,10,5,0,5,95
829736,2,11,10,10,0,10,69
829756,2,11,10,6,0,6,74
829786,2,11,10,4,0,4,63
980912,2,11,10,5,1,6,92
980928,2,11,10,10,0,10,66
980934,2,11,10,9,1,10,96
980940,2,11,10,3,0,3,90
980972,2,11,10,3,0,3,57
980996,2,11,10,3,1,4,78
981014,2,11,10,3,0,3,73
981022,2,11,10,4,0,4,66
1082596,2,11,10,12,1,13,89
1082604,2,11,10,6,0,6,59
1082634,2,11,10,4,1,5,74
1082638,2,11,10,7,0,7,83
1082643,2,11,10,11,0,11,82
980916,1,12,10,5,0,5,87
980924,1,12,10,3,0,3,76
980944,1,12,10,6,0,6,61
980954,1,12,10,14,1,15,85
980962,1,12,10,2,0,2,93
980974,1,12,10,5,2,7,89
980994,1,12,10,5,2,7,70
1082594,1,12,10,10,0,10,63
1082603,1,12,10,5,0,5,92
1082607,1,12,10,10,0,10,79
1082618,1,12,10,10,0,10,84
1082620,1,12,10,9,0,9,83
1082624,1,12,10,4,0,4,67
1082634,1,12,10,3,0,3,51
1082647,1,12,10,5,0,5,63
980906,2,12,10,3,0,3,79
980936,2,12,10,8,0,8,73
980948,2,12,10,8,0,8,88
980970,2,12,10,9,0,9,74
980984,2,12,10,5,0,5,52
981002,2,12,10,3,0,3,63
981010,2,12,10,3,0,3,62
1082592,2,12,10,11,0,11,93
1082599,2,12,10,10,0,10,68
1082615,2,12,10,15,0,15,83
1082629,2,12,10,15,0,15,67
1082631,2,12,10,7,0,7,96
1082642,2,12,10,4,0,4,78
1082645,2,12,10,4,0,4,62
1082650,2,12,10,8,0,8,58
980934,1,13,10,7,0,7,74
980950,1,13,10,10,0,10,110
980966,1,13,10,8,0,8,65
980972,1,13,10,7,2,9,54
981018,1,13,10,16,0,16,58
981022,1,13,10,4,0,4,67
1082593,1,13,10,15,0,15,91
1082596,1,13,10,3,0,3,60
1082606,1,13,10,8,0,8,75
1082625,1,13,10,8,0,8,70
1082629,1,13,10,8,0,8,94
1082632,1,13,10,10,0,10,93
1082640,1,13,10,5,1,6,91
1082643,1,13,10,12,0,12,105
980910,2,13,10,9,0,9,98
980916,2,13,10,4,2,6,93
980922,2,13,10,8,0,8,74
980942,2,13,10,8,0,8,95
980954,2,13,10,12,0,12,112
980960,2,13,10,7,1,8,57
980980,2,13,10,8,0,8,89
980992,2,13,10,3,0,3,54
981006,2,13,10,9,1,10,97
981012,2,13,10,4,0,4,100
1082603,2,13,10,1,1,2,96
1082610,2,13,10,7,1,8,103
1082613,2,13,10,3,0,3,99
1082616,2,13,10,11,1,12,82
1082621,2,13,10,6,2,8,89
1082637,2,13,10,12,0,12,103
335987,1,1,11,11,4,15,102
335998,1,1,11,3,0,3,75
336002,1,1,11,11,0,11,71
336015,1,1,11,3,0,3,79
336019,1,1,11,3,0,3,76
336022,1,1,11,3,0,3,72
336026,1,1,11,2,0,2,46
336030,1,1,11,7,1,8,69
336032,1,1,11,10,0,10,69
392189,1,1,11,5,0,5,36
392204,1,1,11,5,0,5,66
392212,1,1,11,6,0,6,58
392216,1,1,11,2,0,2,71
392224,1,1,11,3,0,3,55
392226,1,1,11,3,4,7,76
392233,1,1,11,10,0,10,60
419111,1,1,11,2,2,4,61
419127,1,1,11,3,0,3,70
419132,1,1,11,14,0,14,89
419140,1,1,11,3,0,3,83
419144,1,1,11,9,0,9,78
419149,1,1,11,12,0,12,100
419153,1,1,11,18,0,18,101
419158,1,1,11,14,0,14,65
501208,1,1,11,9,0,9,74
501227,1,1,11,14,0,14,90
501235,1,1,11,15,0,15,79
501244,1,1,11,5,1,6,79
501260,1,1,11,11,0,11,69
501272,1,1,11,15,0,15,96
501274,1,1,11,15,0,15,64
548312,1,1,11,3,0,3,88
548320,1,1,11,11,0,11,103
548349,1,1,11,9,0,9,96
548358,1,1,11,8,0,8,106
548373,1,1,11,10,0,10,96
548375,1,1,11,9,1,10,64
548380,1,1,11,4,0,4,49
548383,1,1,11,2,1,3,71
598013,1,1,11,6,0,6,78
598018,1,1,11,4,1,5,81
598027,1,1,11,3,0,3,68
598034,1,1,11,7,0,7,88
598045,1,1,11,3,1,4,54
598058,1,1,11,7,0,7,73
598074,1,1,11,4,0,4,60
729284,1,1,11,6,0,6,69
729294,1,1,11,12,0,12,75
729304,1,1,11,6,1,7,89
734032,1,1,11,9,0,9,95
734048,1,1,11,7,1,8,81
829718,1,1,11,5,0,5,82
829766,1,1,11,7,0,7,79
829786,1,1,11,4,0,4,81
980914,1,1,11,18,0,18,99
980952,1,1,11,6,0,6,93
980968,1,1,11,9,0,9,83
980980,1,1,11,7,0,7,64
981000,1,1,11,3,1,4,91
981006,1,1,11,3,1,4,59
981014,1,1,11,6,0,6,91
1082597,1,1,11,3,0,3,82
1082604,1,1,11,12,0,12,87
1082613,1,1,11,13,0,13,109
1082617,1,1,11,6,0,6,93
1082631,1,1,11,15,0,15,74
1082649,1,1,11,10,0,10,53
335991,2,1,11,11,0,11,49
336005,2,1,11,14,1,15,93
336008,2,1,11,5,0,5,57
336040,2,1,11,3,1,4,78
392195,2,1,11,4,2,6,73
392202,2,1,11,2,0,2,72
392208,2,1,11,4,1,5,65
392236,2,1,11,8,0,8,91
392238,2,1,11,6,0,6,44
419114,2,1,11,9,0,9,94
419118,2,1,11,2,2,4,71
419123,2,1,11,7,0,7,72
419136,2,1,11,10,1,11,66
419163,2,1,11,4,0,4,73
419166,2,1,11,4,0,4,76
501203,2,1,11,12,0,12,88
501214,2,1,11,6,0,6,96
501219,2,1,11,8,0,8,53
501224,2,1,11,5,0,5,64
501239,2,1,11,4,5,9,80
501247,2,1,11,0,0,0,69
501267,2,1,11,11,0,11,85
548317,2,1,11,8,0,8,73
548325,2,1,11,2,0,2,70
548328,2,1,11,3,0,3,73
548333,2,1,11,4,1,5,80
548340,2,1,11,8,0,8,73
548352,2,1,11,7,0,7,75
548362,2,1,11,6,0,6,86
548368,2,1,11,6,0,6,67
548386,2,1,11,11,0,11,111
598003,2,1,11,5,0,5,80
598010,2,1,11,1,0,1,56
598021,2,1,11,10,0,10,92
598036,2,1,11,1,0,1,76
598039,2,1,11,9,0,9,94
598048,2,1,11,8,0,8,90
598055,2,1,11,5,1,6,68
598062,2,1,11,1,0,1,62
598066,2,1,11,11,0,11,85
729312,2,1,11,6,1,7,50
729320,2,1,11,5,1,6,65
733976,2,1,11,3,0,3,69
733984,2,1,11,13,0,13,93
733990,2,1,11,12,0,12,102
734002,2,1,11,2,0,2,91
734014,2,1,11,10,0,10,78
734020,2,1,11,6,0,6,66
734028,2,1,11,8,0,8,96
734042,2,1,11,22,0,22,100
734054,2,1,11,18,0,18,107
829710,2,1,11,9,0,9,94
829728,2,1,11,9,0,9,75
829738,2,1,11,9,0,9,77
829744,2,1,11,9,0,9,88
829748,2,1,11,7,0,7,93
829770,2,1,11,1,0,1,71
829796,2,1,11,9,1,10,84
829810,2,1,11,14,0,14,88
829816,2,1,11,5,1,6,103
980908,2,1,11,7,0,7,76
980920,2,1,11,14,0,14,86
980930,2,1,11,5,0,5,98
980944,2,1,11,3,0,3,81
980956,2,1,11,4,1,5,93
980964,2,1,11,4,0,4,73
981020,2,1,11,4,0,4,70
1082593,2,1,11,14,1,15,131
1082601,2,1,11,5,2,7,123
1082608,2,1,11,4,1,5,93
1082620,2,1,11,10,0,10,111
1082622,2,1,11,3,0,3,104
1082627,2,1,11,8,0,8,90
1082636,2,1,11,10,0,10,136
1082639,2,1,11,3,0,3,82
1082644,2,1,11,14,0,14,106
335997,1,2,11,1,0,1,78
336011,1,2,11,7,0,7,58
336017,1,2,11,17,1,18,74
336021,1,2,11,3,0,3,77
336031,1,2,11,3,0,3,73
336034,1,2,11,3,0,3,44
336039,1,2,11,5,0,5,85
392187,1,2,11,3,0,3,60
392196,1,2,11,3,0,3,74
392199,1,2,11,4,0,4,78
392209,1,2,11,10,0,10,72
392218,1,2,11,4,0,4,53
392241,1,2,11,18,0,18,82
419114,1,2,11,6,1,7,64
419128,1,2,11,8,0,8,75
419138,1,2,11,6,0,6,86
419150,1,2,11,3,0,3,71
501210,1,2,11,3,2,5,55
501237,1,2,11,6,0,6,84
501249,1,2,11,19,0,19,122
501273,1,2,11,3,0,3,76
501275,1,2,11,3,0,3,114
548315,1,2,11,6,0,6,75
548323,1,2,11,8,0,8,104
548341,1,2,11,2,0,2,64
548355,1,2,11,5,0,5,64
548367,1,2,11,5,0,5,93
548372,1,2,11,14,2,16,85
548377,1,2,11,4,0,4,83
598004,1,2,11,15,0,15,74
598009,1,2,11,7,0,7,62
598017,1,2,11,5,0,5,69
598032,1,2,11,12,0,12,140
598041,1,2,11,16,0,16,91
598047,1,2,11,15,0,15,90
598050,1,2,11,6,0,6,58
598059,1,2,11,5,0,5,79
598062,1,2,11,3,0,3,57
598069,1,2,11,8,0,8,96
729310,1,2,11,2,0,2,47
729318,1,2,11,7,0,7,76
734004,1,2,11,9,0,9,66
734010,1,2,11,14,0,14,74
734026,1,2,11,12,0,12,60
734040,1,2,11,7,0,7,63
829724,1,2,11,7,0,7,84
829768,1,2,11,9,1,10,93
829790,1,2,11,14,1,15,119
829800,1,2,11,13,0,13,101
829824,1,2,11,10,0,10,70
829826,1,2,11,5,1,6,52
980912,1,2,11,11,0,11,99
980926,1,2,11,9,0,9,106
980932,1,2,11,4,0,4,93
980936,1,2,11,18,0,18,97
980942,1,2,11,4,1,5,81
980964,1,2,11,13,0,13,92
980982,1,2,11,6,0,6,79
980986,1,2,11,2,0,2,62
980992,1,2,11,5,0,5,77
981004,1,2,11,18,0,18,147
1082595,1,2,11,5,0,5,66
1082598,1,2,11,6,0,6,59
1082602,1,2,11,5,0,5,71
1082610,1,2,11,16,1,17,109
1082621,1,2,11,12,0,12,73
1082628,1,2,11,7,0,7,87
1082636,1,2,11,8,0,8,71
1082646,1,2,11,5,0,5,71
335987,2,2,11,5,0,5,56
335990,2,2,11,4,0,4,80
336001,2,2,11,9,0,9,102
336003,2,2,11,14,0,14,97
336007,2,2,11,18,0,18,79
336015,2,2,11,15,0,15,68
336028,2,2,11,4,0,4,42
392190,2,2,11,9,1,10,66
392193,2,2,11,8,0,8,65
392204,2,2,11,4,0,4,69
392213,2,2,11,6,1,7,81
392223,2,2,11,10,0,10,68
392226,2,2,11,4,0,4,74
392229,2,2,11,6,0,6,63
392237,2,2,11,10,0,10,64
392243,2,2,11,6,0,6,88
392244,2,2,11,9,0,9,78
419117,2,2,11,11,0,11,100
419120,2,2,11,1,2,3,93
419124,2,2,11,7,0,7,92
419133,2,2,11,8,0,8,86
419141,2,2,11,8,0,8,85
419145,2,2,11,15,0,15,71
419153,2,2,11,6,0,6,82
419156,2,2,11,5,0,5,77
419159,2,2,11,12,0,12,103
419162,2,2,11,10,0,10,74
419167,2,2,11,11,1,12,95
419169,2,2,11,7,0,7,60
501205,2,2,11,1,0,1,86
501213,2,2,11,3,0,3,56
501216,2,2,11,9,1,10,77
501227,2,2,11,14,0,14,106
501232,2,2,11,5,0,5,102
501252,2,2,11,6,0,6,115
501257,2,2,11,4,0,4,90
501260,2,2,11,7,0,7,96
501265,2,2,11,3,4,7,76
501271,2,2,11,1,0,1,81
501276,2,2,11,4,0,4,73
548320,2,2,11,14,0,14,57
548329,2,2,11,3,0,3,79
548332,2,2,11,4,1,5,68
548336,2,2,11,4,0,4,76
548349,2,2,11,3,0,3,59
548361,2,2,11,9,1,10,93
548365,2,2,11,21,1,22,76
548381,2,2,11,3,0,3,54
598013,2,2,11,13,2,15,95
598022,2,2,11,12,0,12,96
598028,2,2,11,6,5,11,78
598038,2,2,11,3,0,3,69
598053,2,2,11,12,1,13,82
729286,2,2,11,10,0,10,79
729292,2,2,11,7,0,7,57
729304,2,2,11,13,0,13,90
733982,2,2,11,2,0,2,61
733988,2,2,11,11,0,11,109
733996,2,2,11,21,3,24,76
734018,2,2,11,12,1,13,58
734032,2,2,11,6,1,7,79
829718,2,2,11,16,0,16,93
829742,2,2,11,15,1,16,76
829750,2,2,11,9,0,9,84
829754,2,2,11,5,0,5,88
829762,2,2,11,9,0,9,99
829784,2,2,11,2,0,2,73
980958,2,2,11,6,0,6,89
980974,2,2,11,13,0,13,94
981000,2,2,11,5,0,5,96
981016,2,2,11,2,0,2,85
981018,2,2,11,10,1,11,81
981024,2,2,11,8,0,8,120
1082591,2,2,11,12,1,13,111
1082607,2,2,11,3,2,5,72
1082624,2,2,11,4,0,4,53
1082633,2,2,11,4,0,4,72
335988,1,3,11,19,0,19,107
335994,1,3,11,14,0,14,96
336001,1,3,11,7,0,7,72
336006,1,3,11,16,0,16,98
336010,1,3,11,1,0,1,59
336012,1,3,11,3,1,4,70
336018,1,3,11,15,0,15,100
336023,1,3,11,0,0,0,57
336045,1,3,11,2,0,2,77
392190,1,3,11,2,0,2,108
392201,1,3,11,8,0,8,96
392207,1,3,11,3,0,3,84
392211,1,3,11,14,0,14,91
392214,1,3,11,4,0,4,88
392219,1,3,11,12,0,12,92
392229,1,3,11,12,0,12,84
392236,1,3,11,7,0,7,90
392239,1,3,11,3,1,4,74
392243,1,3,11,2,1,3,77
419118,1,3,11,5,0,5,64
419130,1,3,11,8,2,10,95
419142,1,3,11,6,0,6,97
419147,1,3,11,11,0,11,96
419152,1,3,11,4,1,5,79
419160,1,3,11,5,0,5,60
419168,1,3,11,8,0,8,70
419170,1,3,11,9,0,9,67
501203,1,3,11,5,0,5,83
501211,1,3,11,10,1,11,78
501216,1,3,11,17,0,17,97
501220,1,3,11,7,0,7,79
501231,1,3,11,3,0,3,69
501241,1,3,11,5,0,5,63
501250,1,3,11,9,0,9,49
501254,1,3,11,4,1,5,89
501258,1,3,11,6,0,6,73
501266,1,3,11,4,1,5,69
501271,1,3,11,8,0,8,44
501276,1,3,11,9,0,9,103
548311,1,3,11,4,1,5,80
548316,1,3,11,9,1,10,85
548321,1,3,11,2,0,2,68
548327,1,3,11,10,3,13,84
548335,1,3,11,6,0,6,74
548352,1,3,11,3,0,3,77
548357,1,3,11,7,2,9,91
548360,1,3,11,12,1,13,85
548376,1,3,11,1,0,1,46
548384,1,3,11,19,0,19,80
548385,1,3,11,21,0,21,104
548386,1,3,11,5,0,5,91
598025,1,3,11,8,1,9,69
598039,1,3,11,3,0,3,106
598043,1,3,11,6,0,6,61
598046,1,3,11,13,0,13,82
598056,1,3,11,13,0,13,104
598063,1,3,11,6,1,7,82
598067,1,3,11,6,0,6,77
598075,1,3,11,15,0,15,84
729288,1,3,11,10,0,10,112
729298,1,3,11,12,0,12,77
729302,1,3,11,3,0,3,74
733976,1,3,11,6,1,7,92
734018,1,3,11,11,1,12,67
734028,1,3,11,3,0,3,62
734034,1,3,11,8,0,8,89
829712,1,3,11,5,1,6,88
829716,1,3,11,7,0,7,96
829728,1,3,11,5,4,9,97
829740,1,3,11,5,0,5,73
829750,1,3,11,9,0,9,90
829758,1,3,11,11,0,11,108
829770,1,3,11,6,0,6,79
829784,1,3,11,5,0,5,73
829794,1,3,11,3,0,3,70
829802,1,3,11,4,1,5,65
829806,1,3,11,7,0,7,53
335998,2,3,11,4,0,4,81
336014,2,3,11,1,1,2,100
336034,2,3,11,4,0,4,65
336038,2,3,11,12,1,13,112
336042,2,3,11,5,0,5,77
336044,2,3,11,13,0,13,75
392186,2,3,11,3,0,3,73
392194,2,3,11,7,0,7,113
392207,2,3,11,3,0,3,64
392222,2,3,11,3,0,3,70
392232,2,3,11,8,0,8,64
419115,2,3,11,8,0,8,78
419121,2,3,11,17,0,17,119
419126,2,3,11,9,1,10,83
419128,2,3,11,3,0,3,64
419134,2,3,11,5,0,5,85
419138,2,3,11,16,0,16,105
419158,2,3,11,17,1,18,121
419164,2,3,11,1,0,1,95
501226,2,3,11,13,0,13,97
501233,2,3,11,6,0,6,71
501245,2,3,11,19,0,19,92
501273,2,3,11,8,0,8,70
548323,2,3,11,6,0,6,91
548337,2,3,11,6,0,6,76
548348,2,3,11,4,0,4,73
548366,2,3,11,4,0,4,57
548369,2,3,11,8,0,8,83
548373,2,3,11,2,0,2,98
598007,2,3,11,4,0,4,62
598012,2,3,11,6,0,6,71
598017,2,3,11,4,0,4,68
598020,2,3,11,11,0,11,74
598027,2,3,11,5,0,5,53
598031,2,3,11,11,0,11,103
598035,2,3,11,8,0,8,84
598051,2,3,11,4,0,4,52
598078,2,3,11,3,0,3,57
729308,2,3,11,2,0,2,78
729316,2,3,11,10,0,10,85
733986,2,3,11,9,0,9,78
733992,2,3,11,4,1,5,90
734000,2,3,11,7,0,7,82
734008,2,3,11,4,0,4,80
734040,2,3,11,3,0,3,90
734050,2,3,11,9,0,9,98
734052,2,3,11,12,0,12,134
829734,2,3,11,3,1,4,132
829778,2,3,11,12,0,12,99
829814,2,3,11,5,0,5,81
829822,2,3,11,2,0,2,88
829826,2,3,11,2,0,2,64
829828,2,3,11,14,0,14,81
335992,1,4,11,3,0,3,85
335996,1,4,11,13,0,13,107
336008,1,4,11,6,0,6,91
336024,1,4,11,16,0,16,104
336033,1,4,11,8,1,9,93
336040,1,4,11,13,0,13,95
336044,1,4,11,5,0,5,50
392188,1,4,11,7,0,7,98
392191,1,4,11,14,0,14,81
392200,1,4,11,3,0,3,63
392205,1,4,11,5,0,5,55
392227,1,4,11,7,2,9,79
392234,1,4,11,5,0,5,60
419113,1,4,11,11,0,11,87
419117,1,4,11,9,0,9,96
419126,1,4,11,5,0,5,64
419137,1,4,11,6,0,6,91
419141,1,4,11,10,0,10,84
419148,1,4,11,17,0,17,103
419161,1,4,11,13,1,14,86
419164,1,4,11,4,0,4,90
501207,1,4,11,4,0,4,50
501225,1,4,11,10,1,11,117
501239,1,4,11,8,1,9,64
501253,1,4,11,6,0,6,77
501256,1,4,11,6,4,10,96
501262,1,4,11,18,0,18,84
501265,1,4,11,10,2,12,111
548328,1,4,11,8,0,8,68
548333,1,4,11,5,0,5,68
548336,1,4,11,4,1,5,75
548344,1,4,11,11,0,11,67
548348,1,4,11,15,0,15,92
548364,1,4,11,5,0,5,91
548374,1,4,11,8,0,8,72
548379,1,4,11,6,0,6,56
598012,1,4,11,4,2,6,78
598019,1,4,11,6,0,6,63
598021,1,4,11,3,0,3,73
598026,1,4,11,14,0,14,69
598033,1,4,11,5,0,5,81
598036,1,4,11,4,0,4,76
598057,1,4,11,11,0,11,85
598071,1,4,11,7,0,7,87
729300,1,4,11,9,0,9,86
729312,1,4,11,11,0,11,87
733978,1,4,11,6,3,9,79
733992,1,4,11,15,2,17,86
733996,1,4,11,8,0,8,115
734002,1,4,11,5,0,5,90
734030,1,4,11,3,0,3,93
734038,1,4,11,10,1,11,94
734052,1,4,11,2,0,2,111
734054,1,4,11,9,0,9,67
829722,1,4,11,4,0,4,91
829730,1,4,11,10,0,10,83
829738,1,4,11,6,0,6,83
829772,1,4,11,2,0,2,48
829796,1,4,11,3,0,3,78
829814,1,4,11,3,0,3,59
980910,1,4,11,11,0,11,98
980918,1,4,11,1,0,1,59
980930,1,4,11,5,1,6,62
980940,1,4,11,6,0,6,71
980960,1,4,11,8,0,8,86
980976,1,4,11,4,0,4,80
980996,1,4,11,10,0,10,87
981010,1,4,11,5,0,5,81
1082601,1,4,11,2,0,2,97
1082612,1,4,11,10,1,11,80
1082616,1,4,11,3,0,3,91
1082633,1,4,11,5,0,5,60
1082637,1,4,11,8,0,8,89
1082639,1,4,11,3,1,4,67
1082641,1,4,11,4,1,5,131
1082645,1,4,11,4,0,4,59
335988,2,4,11,5,0,5,115
336000,2,4,11,7,1,8,89
336004,2,4,11,13,0,13,90
336011,2,4,11,0,0,0,81
336018,2,4,11,10,1,11,87
336021,2,4,11,20,1,21,91
336036,2,4,11,2,2,4,105
392196,2,4,11,4,0,4,84
392209,2,4,11,3,0,3,73
392212,2,4,11,4,0,4,85
392215,2,4,11,12,0,12,65
392219,2,4,11,10,0,10,100
392221,2,4,11,6,4,10,96
392231,2,4,11,9,1,10,56
392239,2,4,11,2,1,3,45
419122,2,4,11,7,0,7,64
419129,2,4,11,5,0,5,107
419132,2,4,11,5,0,5,79
419144,2,4,11,16,0,16,123
419151,2,4,11,2,0,2,89
419154,2,4,11,6,0,6,65
501211,2,4,11,11,0,11,110
501217,2,4,11,3,4,7,111
501228,2,4,11,7,0,7,103
501242,2,4,11,11,0,11,73
501249,2,4,11,5,0,5,67
501259,2,4,11,12,0,12,96
501269,2,4,11,7,0,7,84
548314,2,4,11,11,0,11,84
548318,2,4,11,5,0,5,58
548324,2,4,11,8,0,8,68
548339,2,4,11,5,0,5,80
548355,2,4,11,10,0,10,90
548359,2,4,11,3,0,3,68
548371,2,4,11,7,0,7,83
548376,2,4,11,6,0,6,71
598008,2,4,11,7,1,8,92
598030,2,4,11,7,0,7,90
598042,2,4,11,7,4,11,91
598046,2,4,11,8,0,8,73
598050,2,4,11,9,2,11,90
598061,2,4,11,6,0,6,60
598064,2,4,11,8,0,8,85
598069,2,4,11,11,0,11,79
729288,2,4,11,11,0,11,104
729296,2,4,11,15,1,16,85
729318,2,4,11,7,0,7,70
734012,2,4,11,9,1,10,141
734024,2,4,11,5,0,5,100
734044,2,4,11,13,1,14,92
734048,2,4,11,9,0,9,77
829714,2,4,11,11,0,11,77
829746,2,4,11,17,0,17,84
829758,2,4,11,9,0,9,66
829764,2,4,11,4,0,4,65
829780,2,4,11,9,0,9,82
829790,2,4,11,2,0,2,65
829804,2,4,11,4,0,4,74
980924,2,4,11,15,0,15,86
980946,2,4,11,13,0,13,88
980968,2,4,11,12,0,12,76
980982,2,4,11,5,0,5,88
980990,2,4,11,5,0,5,66
981004,2,4,11,6,0,6,96
1082594,2,4,11,9,3,12,85
1082598,2,4,11,10,0,10,107
1082605,2,4,11,8,0,8,72
1082609,2,4,11,1,0,1,63
1082623,2,4,11,12,0,12,88
335989,1,5,11,2,0,2,55
336005,1,5,11,14,0,14,103
336013,1,5,11,3,0,3,82
336028,1,5,11,6,0,6,100
336038,1,5,11,20,0,20,127
336043,1,5,11,20,1,21,104
392195,1,5,11,2,0,2,80
392215,1,5,11,9,0,9,102
392222,1,5,11,7,0,7,68
392230,1,5,11,7,0,7,73
392238,1,5,11,1,0,1,62
419116,1,5,11,7,0,7,64
419120,1,5,11,4,0,4,49
419123,1,5,11,3,0,3,95
419129,1,5,11,6,1,7,94
419134,1,5,11,4,0,4,100
419146,1,5,11,10,2,12,94
419159,1,5,11,3,1,4,57
419163,1,5,11,4,0,4,77
501214,1,5,11,8,0,8,75
501219,1,5,11,3,3,6,67
501245,1,5,11,2,0,2,88
501257,1,5,11,3,0,3,77
501263,1,5,11,7,0,7,76
548314,1,5,11,6,0,6,88
548317,1,5,11,6,0,6,74
548325,1,5,11,4,0,4,62
548329,1,5,11,5,0,5,66
548337,1,5,11,9,0,9,71
548354,1,5,11,7,0,7,87
548359,1,5,11,2,0,2,96
548366,1,5,11,6,0,6,67
548370,1,5,11,12,0,12,89
548378,1,5,11,7,1,8,69
548382,1,5,11,9,0,9,83
598006,1,5,11,12,0,12,85
598010,1,5,11,4,0,4,67
598014,1,5,11,8,0,8,80
598024,1,5,11,8,0,8,96
598028,1,5,11,4,0,4,70
598031,1,5,11,8,2,10,98
598048,1,5,11,4,0,4,75
598077,1,5,11,8,0,8,73
729296,1,5,11,13,0,13,98
729320,1,5,11,10,0,10,73
733984,1,5,11,5,0,5,81
734008,1,5,11,2,0,2,86
734016,1,5,11,10,1,11,97
734046,1,5,11,19,0,19,78
829714,1,5,11,1,2,3,76
829746,1,5,11,4,0,4,94
829754,1,5,11,9,0,9,82
829782,1,5,11,6,0,6,80
829816,1,5,11,4,0,4,111
335992,2,5,11,12,0,12,99
335995,2,5,11,7,0,7,121
335997,2,5,11,6,0,6,79
336010,2,5,11,9,1,10,88
336016,2,5,11,5,0,5,86
336020,2,5,11,8,0,8,88
336024,2,5,11,11,0,11,78
336032,2,5,11,10,1,11,80
336041,2,5,11,5,0,5,72
336045,2,5,11,5,0,5,80
392187,2,5,11,14,1,15,47
392200,2,5,11,10,0,10,58
392203,2,5,11,4,0,4,64
392207,2,5,11,2,0,2,66
392210,2,5,11,8,0,8,68
392218,2,5,11,5,0,5,67
392225,2,5,11,12,1,13,72
392235,2,5,11,10,1,11,71
419112,2,5,11,19,0,19,88
419131,2,5,11,5,0,5,100
419139,2,5,11,3,1,4,73
419142,2,5,11,9,0,9,114
419148,2,5,11,5,0,5,116
419155,2,5,11,3,0,3,63
501204,2,5,11,7,0,7,67
501209,2,5,11,6,0,6,92
501225,2,5,11,13,0,13,74
501230,2,5,11,3,0,3,67
501236,2,5,11,5,0,5,51
501240,2,5,11,2,0,2,61
501254,2,5,11,8,0,8,78
501268,2,5,11,12,0,12,109
548322,2,5,11,10,0,10,89
548331,2,5,11,12,0,12,101
548341,2,5,11,12,1,13,80
548350,2,5,11,10,1,11,78
548363,2,5,11,10,0,10,89
598019,2,5,11,5,0,5,73
598037,2,5,11,17,0,17,70
598041,2,5,11,5,0,5,85
598052,2,5,11,10,0,10,94
598054,2,5,11,8,0,8,85
598057,2,5,11,7,2,9,82
598063,2,5,11,22,1,23,72
598068,2,5,11,9,0,9,69
598070,2,5,11,5,0,5,49
598076,2,5,11,5,0,5,62
729290,2,5,11,8,0,8,69
729302,2,5,11,7,0,7,63
729310,2,5,11,7,0,7,55
733980,2,5,11,5,0,5,76
733994,2,5,11,4,0,4,64
734004,2,5,11,14,0,14,82
734022,2,5,11,1,0,1,70
734038,2,5,11,6,0,6,70
829720,2,5,11,4,1,5,79
829726,2,5,11,9,0,9,78
829732,2,5,11,2,0,2,65
829740,2,5,11,6,0,6,94
829774,2,5,11,11,0,11,98
829792,2,5,11,9,0,9,77
829802,2,5,11,8,0,8,71
829824,2,5,11,3,0,3,71
336000,1,6,11,12,0,12,81
336003,1,6,11,11,0,11,102
336014,1,6,11,13,1,14,97
336020,1,6,11,7,0,7,75
336025,1,6,11,10,0,10,86
336027,1,6,11,2,1,3,118
392194,1,6,11,6,0,6,96
392203,1,6,11,3,0,3,69
392228,1,6,11,5,0,5,86
392231,1,6,11,8,2,10,62
392235,1,6,11,6,0,6,66
392237,1,6,11,5,0,5,68
392242,1,6,11,2,0,2,85
419121,1,6,11,11,1,12,101
419133,1,6,11,5,0,5,100
419136,1,6,11,6,0,6,97
419139,1,6,11,7,0,7,86
419145,1,6,11,3,0,3,92
419154,1,6,11,5,0,5,68
501206,1,6,11,5,1,6,59
501209,1,6,11,11,0,11,54
501228,1,6,11,13,0,13,128
501232,1,6,11,5,0,5,74
501238,1,6,11,4,3,7,53
501243,1,6,11,4,2,6,68
501270,1,6,11,1,0,1,56
548347,1,6,11,22,1,23,111
548350,1,6,11,15,0,15,88
548362,1,6,11,4,1,5,84
548369,1,6,11,4,0,4,56
598003,1,6,11,7,0,7,75
598015,1,6,11,5,0,5,51
598022,1,6,11,5,0,5,72
598040,1,6,11,2,0,2,70
598049,1,6,11,7,2,9,52
598054,1,6,11,15,0,15,70
598064,1,6,11,16,0,16,70
729286,1,6,11,9,0,9,58
733980,1,6,11,4,2,6,77
733986,1,6,11,13,0,13,88
733990,1,6,11,16,0,16,82
733998,1,6,11,9,0,9,84
734024,1,6,11,0,0,0,84
734044,1,6,11,13,0,13,82
829720,1,6,11,8,1,9,93
829736,1,6,11,11,1,12,92
829744,1,6,11,9,0,9,78
829752,1,6,11,16,0,16,81
829762,1,6,11,8,0,8,62
829788,1,6,11,8,0,8,77
829818,1,6,11,18,0,18,109
980908,1,6,11,8,5,13,68
980938,1,6,11,5,0,5,70
980956,1,6,11,7,0,7,77
980970,1,6,11,7,1,8,77
981002,1,6,11,5,0,5,54
981016,1,6,11,5,0,5,80
1082599,1,6,11,7,0,7,88
1082605,1,6,11,6,1,7,90
1082608,1,6,11,4,0,4,87
1082622,1,6,11,4,1,5,83
1082626,1,6,11,9,0,9,46
1082642,1,6,11,3,1,4,89
335989,2,6,11,9,0,9,95
335993,2,6,11,5,0,5,100
336006,2,6,11,6,1,7,113
336009,2,6,11,4,0,4,85
336022,2,6,11,3,0,3,67
336031,2,6,11,7,0,7,112
336037,2,6,11,2,0,2,90
336043,2,6,11,8,0,8,64
392199,2,6,11,5,0,5,69
392206,2,6,11,4,1,5,75
392211,2,6,11,7,0,7,79
392216,2,6,11,5,5,10,86
392220,2,6,11,2,2,4,56
392224,2,6,11,3,1,4,76
392240,2,6,11,5,6,11,104
419113,2,6,11,4,0,4,65
419116,2,6,11,7,0,7,106
419119,2,6,11,11,0,11,95
419125,2,6,11,5,1,6,91
419149,2,6,11,10,0,10,101
419157,2,6,11,3,0,3,90
419160,2,6,11,3,1,4,60
419165,2,6,11,5,1,6,65
501218,2,6,11,10,1,11,109
501221,2,6,11,6,0,6,84
501235,2,6,11,2,0,2,62
501248,2,6,11,7,0,7,92
501251,2,6,11,8,0,8,64
501258,2,6,11,3,3,6,71
501262,2,6,11,5,0,5,72
548312,2,6,11,7,2,9,96
548315,2,6,11,4,0,4,72
548321,2,6,11,8,0,8,87
548326,2,6,11,4,0,4,75
548330,2,6,11,9,0,9,67
548334,2,6,11,11,1,12,124
548338,2,6,11,10,2,12,104
548342,2,6,11,12,0,12,111
548354,2,6,11,6,0,6,102
548374,2,6,11,15,0,15,70
548377,2,6,11,9,0,9,105
548379,2,6,11,9,0,9,96
548383,2,6,11,5,0,5,88
548385,2,6,11,8,1,9,98
598006,2,6,11,7,2,9,82
598011,2,6,11,13,0,13,97
598025,2,6,11,4,0,4,62
598029,2,6,11,7,0,7,109
598033,2,6,11,4,0,4,61
598045,2,6,11,7,0,7,63
598059,2,6,11,8,0,8,96
598067,2,6,11,4,4,8,73
598072,2,6,11,7,0,7,72
729294,2,6,11,4,0,4,88
729298,2,6,11,10,0,10,63
729306,2,6,11,12,0,12,98
729314,2,6,11,11,1,12,62
734010,2,6,11,6,0,6,82
734016,2,6,11,5,0,5,67
734036,2,6,11,7,0,7,69
829712,2,6,11,8,0,8,75
829730,2,6,11,10,0,10,79
829766,2,6,11,7,0,7,71
829772,2,6,11,11,2,13,88
829782,2,6,11,4,1,5,72
829798,2,6,11,1,0,1,66
829806,2,6,11,8,0,8,74
980918,2,6,11,9,2,11,79
980926,2,6,11,7,0,7,100
980950,2,6,11,7,0,7,58
980966,2,6,11,3,0,3,96
980976,2,6,11,6,0,6,97
980988,2,6,11,5,0,5,83
980998,2,6,11,3,0,3,84
981008,2,6,11,7,0,7,75
1082595,2,6,11,6,0,6,85
1082611,2,6,11,3,0,3,90
1082614,2,6,11,10,0,10,67
1082630,2,6,11,5,0,5,101
1082632,2,6,11,23,1,24,137
1082635,2,6,11,8,0,8,58
1082640,2,6,11,6,0,6,98
1082646,2,6,11,8,0,8,84
335990,1,7,11,7,0,7,81
335999,1,7,11,2,0,2,56
336009,1,7,11,4,0,4,78
336029,1,7,11,4,1,5,83
336037,1,7,11,15,0,15,96
336041,1,7,11,9,2,11,71
392186,1,7,11,9,0,9,73
392202,1,7,11,7,0,7,118
392208,1,7,11,3,1,4,65
392213,1,7,11,8,0,8,61
392220,1,7,11,4,0,4,47
392223,1,7,11,9,0,9,76
392232,1,7,11,5,0,5,75
392240,1,7,11,2,1,3,75
419112,1,7,11,10,0,10,111
419119,1,7,11,10,0,10,122
419124,1,7,11,1,1,2,76
419135,1,7,11,7,0,7,85
419143,1,7,11,8,1,9,79
419151,1,7,11,6,0,6,80
419155,1,7,11,1,3,4,77
419157,1,7,11,5,0,5,70
419162,1,7,11,3,0,3,78
419166,1,7,11,2,0,2,71
419167,1,7,11,3,0,3,84
501215,1,7,11,18,0,18,89
501226,1,7,11,7,0,7,74
501229,1,7,11,2,0,2,74
501236,1,7,11,1,0,1,51
501242,1,7,11,10,0,10,77
501246,1,7,11,4,0,4,69
501251,1,7,11,6,0,6,82
501268,1,7,11,6,0,6,61
548322,1,7,11,7,0,7,87
548330,1,7,11,2,0,2,45
548339,1,7,11,7,0,7,65
548356,1,7,11,6,0,6,78
548365,1,7,11,8,0,8,56
548368,1,7,11,17,1,18,94
598007,1,7,11,5,2,7,79
598011,1,7,11,7,0,7,87
598016,1,7,11,7,0,7,79
598029,1,7,11,13,0,13,66
598038,1,7,11,9,0,9,106
598042,1,7,11,5,1,6,65
598044,1,7,11,9,0,9,69
598051,1,7,11,5,0,5,52
598055,1,7,11,8,0,8,77
598068,1,7,11,13,0,13,94
598078,1,7,11,7,0,7,65
729292,1,7,11,6,0,6,69
729308,1,7,11,12,0,12,69
729314,1,7,11,2,0,2,51
733988,1,7,11,3,0,3,88
734000,1,7,11,12,0,12,69
734014,1,7,11,2,0,2,64
734022,1,7,11,9,1,10,86
734036,1,7,11,12,0,12,112
734050,1,7,11,4,0,4,86
829710,1,7,11,9,0,9,66
829726,1,7,11,1,0,1,46
829734,1,7,11,9,0,9,71
829742,1,7,11,14,0,14,97
829756,1,7,11,11,0,11,83
829774,1,7,11,7,0,7,88
829780,1,7,11,6,0,6,102
829810,1,7,11,6,0,6,73
829822,1,7,11,5,0,5,91
829828,1,7,11,12,0,12,110
980906,1,7,11,3,0,3,51
980922,1,7,11,3,0,3,62
980928,1,7,11,2,1,3,61
980946,1,7,11,10,0,10,87
980990,1,7,11,2,0,2,47
980998,1,7,11,6,0,6,90
981012,1,7,11,15,0,15,87
1082592,1,7,11,8,2,10,92
1082614,1,7,11,6,0,6,74
1082635,1,7,11,13,0,13,97
1082638,1,7,11,8,0,8,67
1082644,1,7,11,7,0,7,86
1082650,1,7,11,9,0,9,65
335994,2,7,11,4,3,7,90
335996,2,7,11,1,0,1,68
336002,2,7,11,6,0,6,75
336013,2,7,11,7,1,8,72
336017,2,7,11,16,0,16,95
336023,2,7,11,7,1,8,115
336033,2,7,11,9,0,9,99
392197,2,7,11,2,0,2,86
392202,2,7,11,2,0,2,74
392205,2,7,11,5,1,6,53
392217,2,7,11,4,0,4,75
392227,2,7,11,10,2,12,86
392230,2,7,11,2,0,2,56
419119,2,7,11,7,0,7,102
419127,2,7,11,4,0,4,80
419130,2,7,11,2,1,3,101
419137,2,7,11,7,0,7,89
419147,2,7,11,5,1,6,73
419170,2,7,11,8,1,9,67
501206,2,7,11,3,0,3,51
501210,2,7,11,3,0,3,81
501223,2,7,11,5,0,5,68
501256,2,7,11,8,0,8,71
501261,2,7,11,3,1,4,53
501272,2,7,11,6,1,7,91
501274,2,7,11,6,0,6,93
501275,2,7,11,3,0,3,83
548311,2,7,11,8,0,8,84
548313,2,7,11,6,0,6,54
548319,2,7,11,7,1,8,57
548344,2,7,11,2,0,2,66
548347,2,7,11,9,0,9,97
548351,2,7,11,5,0,5,57
548360,2,7,11,14,0,14,88
548372,2,7,11,19,0,19,75
548375,2,7,11,1,0,1,60
548382,2,7,11,16,0,16,95
548384,2,7,11,12,1,13,90
598004,2,7,11,7,0,7,69
598024,2,7,11,7,0,7,49
598034,2,7,11,3,0,3,82
598060,2,7,11,5,0,5,55
598065,2,7,11,8,1,9,82
598071,2,7,11,7,0,7,76
598075,2,7,11,6,0,6,98
598077,2,7,11,8,2,10,83
729284,2,7,11,11,0,11,65
729322,2,7,11,3,0,3,63
733978,2,7,11,5,0,5,75
734006,2,7,11,5,0,5,80
734030,2,7,11,8,0,8,104
734046,2,7,11,18,1,19,139
829722,2,7,11,8,1,9,41
829752,2,7,11,3,0,3,84
829788,2,7,11,4,0,4,65
829794,2,7,11,1,0,1,85
829800,2,7,11,13,1,14,97
829820,2,7,11,6,1,7,80
980914,2,7,11,14,0,14,101
980932,2,7,11,8,0,8,89
980938,2,7,11,6,0,6,84
980952,2,7,11,6,0,6,91
980962,2,7,11,10,0,10,86
980978,2,7,11,4,0,4,58
980986,2,7,11,3,0,3,63
1082597,2,7,11,9,0,9,83
1082600,2,7,11,4,1,5,90
1082602,2,7,11,6,0,6,54
1082606,2,7,11,3,0,3,92
1082612,2,7,11,11,0,11,134
1082618,2,7,11,9,0,9,77
1082625,2,7,11,8,0,8,90
1082628,2,7,11,12,0,12,86
1082641,2,7,11,8,1,9,117
1082647,2,7,11,4,0,4,75
1082649,2,7,11,16,0,16,80
335991,1,8,11,5,0,5,57
335993,1,8,11,9,0,9,54
335995,1,8,11,13,1,14,99
336004,1,8,11,7,0,7,83
336007,1,8,11,20,0,20,101
336016,1,8,11,10,0,10,84
336036,1,8,11,8,1,9,79
336042,1,8,11,2,0,2,59
392193,1,8,11,10,0,10,101
392197,1,8,11,6,1,7,95
392206,1,8,11,4,2,6,61
392210,1,8,11,7,0,7,65
392217,1,8,11,6,0,6,69
392221,1,8,11,1,0,1,73
392225,1,8,11,5,0,5,82
392244,1,8,11,3,0,3,65
419115,1,8,11,8,0,8,88
419122,1,8,11,3,0,3,103
419125,1,8,11,6,0,6,83
419131,1,8,11,5,0,5,84
419156,1,8,11,10,0,10,81
419165,1,8,11,6,0,6,85
419169,1,8,11,5,0,5,48
501204,1,8,11,2,0,2,71
501213,1,8,11,8,0,8,81
501217,1,8,11,7,0,7,88
501221,1,8,11,13,0,13,103
501234,1,8,11,11,0,11,48
501248,1,8,11,12,0,12,79
501255,1,8,11,4,0,4,76
501261,1,8,11,6,0,6,59
501269,1,8,11,15,2,17,102
548319,1,8,11,4,0,4,65
548326,1,8,11,15,2,17,101
548331,1,8,11,13,0,13,96
548334,1,8,11,6,0,6,70
548340,1,8,11,9,0,9,76
548346,1,8,11,12,0,12,83
548351,1,8,11,8,0,8,59
548353,1,8,11,5,0,5,63
548361,1,8,11,3,0,3,77
548371,1,8,11,11,0,11,87
548381,1,8,11,4,0,4,51
335999,2,8,11,16,1,17,147
336012,2,8,11,10,0,10,88
336019,2,8,11,11,1,12,86
336025,2,8,11,9,0,9,93
336029,2,8,11,3,0,3,62
336039,2,8,11,12,0,12,75
392189,2,8,11,8,0,8,77
392201,2,8,11,14,0,14,99
392214,2,8,11,4,1,5,84
392228,2,8,11,3,1,4,87
392233,2,8,11,2,0,2,73
392234,2,8,11,5,0,5,70
392241,2,8,11,6,0,6,91
392242,2,8,11,13,0,13,115
419111,2,8,11,11,0,11,99
419135,2,8,11,7,0,7,85
419140,2,8,11,6,0,6,93
419143,2,8,11,5,2,7,75
419146,2,8,11,6,0,6,92
419150,2,8,11,9,0,9,89
419152,2,8,11,5,0,5,61
419161,2,8,11,16,0,16,98
419168,2,8,11,6,0,6,49
501208,2,8,11,6,1,7,69
501229,2,8,11,4,0,4,76
501241,2,8,11,2,0,2,90
501244,2,8,11,2,0,2,70
501264,2,8,11,2,0,2,80
548316,2,8,11,5,0,5,78
548357,2,8,11,3,0,3,79
548364,2,8,11,2,0,2,72
548378,2,8,11,7,0,7,76
501205,1,9,11,8,1,9,91
501212,1,9,11,9,0,9,74
501224,1,9,11,2,1,3,58
501230,1,9,11,9,0,9,63
501247,1,9,11,5,0,5,74
501252,1,9,11,3,0,3,75
501259,1,9,11,6,0,6,109
501215,2,9,11,11,0,11,95
501220,2,9,11,2,0,2,92
501234,2,9,11,3,0,3,48
501238,2,9,11,6,0,6,57
501243,2,9,11,10,0,10,99
501266,2,9,11,4,1,5,68
501218,1,10,11,4,0,4,102
501223,1,10,11,8,0,8,68
501233,1,10,11,9,0,9,63
501240,1,10,11,8,0,8,85
501264,1,10,11,11,0,11,73
501267,1,10,11,5,0,5,59
548313,1,10,11,6,1,7,58
548318,1,10,11,9,0,9,80
548324,1,10,11,8,1,9,71
548332,1,10,11,5,0,5,101
548338,1,10,11,2,1,3,91
548342,1,10,11,3,0,3,53
548363,1,10,11,16,0,16,72
598008,1,10,11,2,0,2,40
598020,1,10,11,5,1,6,84
598030,1,10,11,6,0,6,83
598052,1,10,11,4,1,5,97
598060,1,10,11,14,0,14,72
598066,1,10,11,17,0,17,89
598072,1,10,11,12,0,12,86
501207,2,10,11,6,0,6,80
501212,2,10,11,10,0,10,71
501231,2,10,11,8,0,8,66
501237,2,10,11,12,1,13,76
501246,2,10,11,13,0,13,61
501253,2,10,11,6,0,6,75
501255,2,10,11,5,0,5,87
548327,2,10,11,7,2,9,81
548335,2,10,11,5,2,7,72
548346,2,10,11,4,1,5,78
548353,2,10,11,5,0,5,80
548356,2,10,11,2,0,2,49
548358,2,10,11,5,4,9,75
548367,2,10,11,4,0,4,84
548370,2,10,11,8,0,8,68
548380,2,10,11,3,0,3,64
598005,2,10,11,2,0,2,50
598014,2,10,11,9,0,9,96
598016,2,10,11,5,0,5,77
598023,2,10,11,6,0,6,71
598032,2,10,11,7,2,9,85
598040,2,10,11,3,0,3,78
598043,2,10,11,4,0,4,72
598047,2,10,11,5,0,5,82
598058,2,10,11,4,0,4,53
598005,1,11,11,7,0,7,67
598023,1,11,11,7,0,7,49
598035,1,11,11,5,0,5,67
598037,1,11,11,6,0,6,70
598053,1,11,11,2,0,2,64
598061,1,11,11,8,0,8,64
598065,1,11,11,11,0,11,98
598070,1,11,11,3,0,3,51
598076,1,11,11,5,2,7,55
729290,1,11,11,6,0,6,75
729306,1,11,11,4,0,4,85
729316,1,11,11,3,4,7,72
729322,1,11,11,5,0,5,76
733982,1,11,11,9,0,9,81
733994,1,11,11,5,0,5,79
734006,1,11,11,3,0,3,73
734012,1,11,11,11,0,11,83
734020,1,11,11,7,0,7,84
734042,1,11,11,4,1,5,83
829732,1,11,11,11,1,12,67
829748,1,11,11,14,0,14,94
829764,1,11,11,6,0,6,82
829778,1,11,11,8,1,9,116
829792,1,11,11,3,0,3,91
829798,1,11,11,2,0,2,64
829804,1,11,11,4,0,4,90
829812,1,11,11,10,0,10,135
829820,1,11,11,4,0,4,58
980920,1,11,11,3,0,3,55
980948,1,11,11,3,0,3,42
980958,1,11,11,5,0,5,87
980978,1,11,11,5,0,5,90
980984,1,11,11,3,0,3,66
980988,1,11,11,8,0,8,88
981008,1,11,11,10,0,10,78
981020,1,11,11,2,0,2,73
981024,1,11,11,6,0,6,103
1082591,1,11,11,10,0,10,98
1082600,1,11,11,9,0,9,84
1082609,1,11,11,12,0,12,66
1082611,1,11,11,10,1,11,91
1082615,1,11,11,5,0,5,70
1082623,1,11,11,6,0,6,113
1082627,1,11,11,3,0,3,126
1082630,1,11,11,7,0,7,90
1082648,1,11,11,10,0,10,71
598009,2,11,11,3,0,3,59
598015,2,11,11,3,0,3,54
598018,2,11,11,2,1,3,71
598026,2,11,11,10,0,10,66
598044,2,11,11,3,0,3,64
598049,2,11,11,4,0,4,59
598056,2,11,11,12,0,12,87
598074,2,11,11,7,0,7,84
729300,2,11,11,5,0,5,79
734026,2,11,11,11,0,11,83
734034,2,11,11,14,0,14,114
829716,2,11,11,7,1,8,88
829724,2,11,11,10,0,10,105
829736,2,11,11,10,0,10,79
829756,2,11,11,3,0,3,77
829786,2,11,11,3,0,3,66
980912,2,11,11,7,0,7,99
980928,2,11,11,4,0,4,70
980934,2,11,11,4,0,4,100
980940,2,11,11,5,0,5,95
980972,2,11,11,8,0,8,65
980996,2,11,11,7,1,8,86
981014,2,11,11,12,0,12,85
981022,2,11,11,9,0,9,75
1082596,2,11,11,12,0,12,101
1082604,2,11,11,11,0,11,70
1082634,2,11,11,2,0,2,76
1082638,2,11,11,11,0,11,94
1082643,2,11,11,4,0,4,86
980916,1,12,11,6,0,6,93
980924,1,12,11,5,1,6,82
980944,1,12,11,10,0,10,71
980954,1,12,11,8,0,8,93
980962,1,12,11,9,0,9,102
980974,1,12,11,8,0,8,97
980994,1,12,11,4,0,4,74
1082594,1,12,11,7,1,8,71
1082603,1,12,11,9,0,9,101
1082607,1,12,11,5,1,6,85
1082618,1,12,11,4,0,4,88
1082620,1,12,11,6,0,6,89
1082624,1,12,11,2,0,2,69
1082634,1,12,11,17,0,17,68
1082647,1,12,11,9,0,9,72
980906,2,12,11,6,0,6,85
980936,2,12,11,7,0,7,80
980948,2,12,11,5,1,6,94
980970,2,12,11,10,3,13,87
980984,2,12,11,8,0,8,60
981002,2,12,11,12,1,13,76
981010,2,12,11,8,1,9,71
1082592,2,12,11,4,0,4,97
1082599,2,12,11,8,0,8,76
1082615,2,12,11,4,0,4,87
1082629,2,12,11,4,1,5,72
1082631,2,12,11,5,0,5,101
1082642,2,12,11,6,0,6,84
1082645,2,12,11,5,0,5,67
1082650,2,12,11,7,0,7,65
980934,1,13,11,3,0,3,77
980950,1,13,11,5,0,5,115
980966,1,13,11,10,0,10,75
980972,1,13,11,7,0,7,61
981018,1,13,11,6,0,6,64
981022,1,13,11,10,0,10,77
1082593,1,13,11,4,0,4,95
1082596,1,13,11,8,0,8,68
1082606,1,13,11,6,0,6,81
1082625,1,13,11,12,1,13,83
1082629,1,13,11,6,1,7,101
1082632,1,13,11,16,0,16,109
1082640,1,13,11,7,0,7,98
1082643,1,13,11,6,0,6,111
980910,2,13,11,9,0,9,107
980916,2,13,11,6,2,8,101
980922,2,13,11,5,1,6,80
980942,2,13,11,6,1,7,102
980954,2,13,11,4,0,4,116
980960,2,13,11,4,0,4,61
980980,2,13,11,4,0,4,93
980992,2,13,11,12,1,13,67
981006,2,13,11,10,0,10,107
981012,2,13,11,10,1,11,111
1082603,2,13,11,6,0,6,102
1082610,2,13,11,3,0,3,106
1082613,2,13,11,11,0,11,110
1082616,2,13,11,7,1,8,90
1082621,2,13,11,15,0,15,104
1082637,2,13,11,10,1,11,114
335987,1,1,12,10,0,10,112
335998,1,1,12,3,1,4,79
336002,1,1,12,3,0,3,74
336015,1,1,12,9,1,10,89
336019,1,1,12,6,1,7,83
336022,1,1,12,7,0,7,79
336026,1,1,12,7,0,7,53
336030,1,1,12,16,0,16,85
336032,1,1,12,3,0,3,72
392189,1,1,12,11,0,11,47
392204,1,1,12,8,0,8,74
392212,1,1,12,13,0,13,71
392216,1,1,12,12,0,12,83
392224,1,1,12,1,2,3,58
392226,1,1,12,4,1,5,81
392233,1,1,12,7,0,7,67
419111,1,1,12,10,0,10,71
419127,1,1,12,3,1,4,74
419132,1,1,12,11,1,12,101
419140,1,1,12,2,1,3,86
419144,1,1,12,10,1,11,89
419149,1,1,12,3,1,4,104
419153,1,1,12,2,0,2,103
419158,1,1,12,6,1,7,72
501208,1,1,12,9,0,9,83
501227,1,1,12,3,0,3,93
501235,1,1,12,3,1,4,83
501244,1,1,12,5,0,5,84
501260,1,1,12,14,0,14,83
501272,1,1,12,4,0,4,100
501274,1,1,12,8,0,8,72
548312,1,1,12,9,0,9,97
548320,1,1,12,12,0,12,115
548349,1,1,12,11,0,11,107
548358,1,1,12,5,0,5,111
548373,1,1,12,4,0,4,100
548375,1,1,12,13,1,14,78
548380,1,1,12,11,0,11,60
548383,1,1,12,10,0,10,81
598013,1,1,12,10,0,10,88
598018,1,1,12,7,0,7,88
598027,1,1,12,5,0,5,73
598034,1,1,12,4,1,5,93
598045,1,1,12,6,0,6,60
598058,1,1,12,2,0,2,75
598074,1,1,12,6,0,6,66
729284,1,1,12,9,0,9,78
729294,1,1,12,7,0,7,82
729304,1,1,12,2,0,2,91
734032,1,1,12,10,0,10,105
734048,1,1,12,9,0,9,90
829718,1,1,12,5,0,5,87
829766,1,1,12,4,0,4,83
829786,1,1,12,5,0,5,86
980914,1,1,12,8,1,9,108
980952,1,1,12,8,0,8,101
980968,1,1,12,5,1,6,89
980980,1,1,12,10,0,10,74
981000,1,1,12,9,0,9,100
981006,1,1,12,2,0,2,61
981014,1,1,12,6,0,6,97
1082597,1,1,12,7,0,7,89
1082604,1,1,12,7,0,7,94
1082613,1,1,12,7,0,7,116
1082617,1,1,12,1,0,1,94
1082631,1,1,12,15,0,15,89
1082649,1,1,12,8,0,8,61
335991,2,1,12,4,11,15,64
336005,2,1,12,6,1,7,100
336008,2,1,12,6,0,6,63
336040,2,1,12,6,1,7,85
392195,2,1,12,5,1,6,79
392202,2,1,12,5,0,5,79
392208,2,1,12,10,0,10,75
392236,2,1,12,12,0,12,103
392238,2,1,12,3,0,3,47
419114,2,1,12,8,0,8,102
419118,2,1,12,7,0,7,78
419123,2,1,12,6,1,7,79
419136,2,1,12,6,1,7,73
419163,2,1,12,12,0,12,85
419166,2,1,12,3,0,3,79
501203,2,1,12,3,0,3,91
501214,2,1,12,6,0,6,102
501219,2,1,12,4,0,4,57
501224,2,1,12,9,0,9,73
501239,2,1,12,4,1,5,85
501247,2,1,12,14,1,15,84
501267,2,1,12,7,0,7,92
548317,2,1,12,4,0,4,77
548325,2,1,12,3,1,4,74
548328,2,1,12,2,4,6,79
548333,2,1,12,3,0,3,83
548340,2,1,12,4,1,5,78
548352,2,1,12,7,0,7,82
548362,2,1,12,8,0,8,94
548368,2,1,12,15,0,15,82
548386,2,1,12,10,0,10,121
598003,2,1,12,7,0,7,87
598010,2,1,12,6,0,6,62
598021,2,1,12,5,0,5,97
598036,2,1,12,7,4,11,87
598039,2,1,12,5,0,5,99
598048,2,1,12,10,0,10,100
598055,2,1,12,9,0,9,77
598062,2,1,12,6,0,6,68
598066,2,1,12,11,0,11,96
729312,2,1,12,6,1,7,57
729320,2,1,12,8,0,8,73
733976,2,1,12,5,0,5,74
733984,2,1,12,5,0,5,98
733990,2,1,12,5,0,5,107
734002,2,1,12,10,1,11,102
734014,2,1,12,7,0,7,85
734020,2,1,12,15,0,15,81
734028,2,1,12,3,0,3,99
734042,2,1,12,15,1,16,116
734054,2,1,12,3,0,3,110
829710,2,1,12,4,0,4,98
829728,2,1,12,11,0,11,86
829738,2,1,12,6,1,7,84
829744,2,1,12,8,0,8,96
829748,2,1,12,8,0,8,101
829770,2,1,12,5,0,5,76
829796,2,1,12,2,0,2,86
829810,2,1,12,8,0,8,96
829816,2,1,12,13,0,13,116
980908,2,1,12,6,0,6,82
980920,2,1,12,4,1,5,91
980930,2,1,12,9,0,9,107
980944,2,1,12,8,0,8,89
980956,2,1,12,6,0,6,99
980964,2,1,12,10,1,11,84
981020,2,1,12,11,0,11,81
1082593,2,1,12,10,6,16,147
1082601,2,1,12,5,0,5,128
1082608,2,1,12,5,1,6,99
1082620,2,1,12,12,0,12,123
1082622,2,1,12,9,0,9,113
1082627,2,1,12,17,0,17,107
1082636,2,1,12,4,1,5,141
1082639,2,1,12,3,1,4,86
1082644,2,1,12,9,0,9,115
335997,1,2,12,0,0,0,78
336011,1,2,12,10,1,11,69
336017,1,2,12,1,0,1,75
336021,1,2,12,4,0,4,81
336031,1,2,12,6,0,6,79
336034,1,2,12,8,0,8,52
336039,1,2,12,7,1,8,93
392187,1,2,12,3,0,3,63
392196,1,2,12,13,0,13,87
392199,1,2,12,3,0,3,81
392209,1,2,12,7,1,8,80
392218,1,2,12,7,0,7,60
392241,1,2,12,8,0,8,90
419114,1,2,12,9,0,9,73
419128,1,2,12,8,3,11,86
419138,1,2,12,8,0,8,94
419150,1,2,12,6,0,6,77
501210,1,2,12,8,1,9,64
501237,1,2,12,10,0,10,94
501249,1,2,12,4,0,4,126
501273,1,2,12,10,0,10,86
501275,1,2,12,5,0,5,119
548315,1,2,12,10,0,10,85
548323,1,2,12,9,5,14,118
548341,1,2,12,6,5,11,75
548355,1,2,12,16,2,18,82
548367,1,2,12,3,1,4,97
548372,1,2,12,3,0,3,88
548377,1,2,12,13,0,13,96
598004,1,2,12,1,0,1,75
598009,1,2,12,4,0,4,66
598017,1,2,12,5,0,5,74
598032,1,2,12,8,3,11,151
598041,1,2,12,8,0,8,99
598047,1,2,12,6,0,6,96
598050,1,2,12,11,0,11,69
598059,1,2,12,2,2,4,83
598062,1,2,12,6,0,6,63
598069,1,2,12,12,0,12,108
729310,1,2,12,4,0,4,51
729318,1,2,12,4,0,4,80
734004,1,2,12,4,0,4,70
734010,1,2,12,18,0,18,92
734026,1,2,12,19,0,19,79
734040,1,2,12,10,0,10,73
829724,1,2,12,9,0,9,93
829768,1,2,12,10,0,10,103
829790,1,2,12,4,0,4,123
829800,1,2,12,13,0,13,114
829824,1,2,12,11,1,12,82
829826,1,2,12,13,0,13,65
980912,1,2,12,12,0,12,111
980926,1,2,12,3,0,3,109
980932,1,2,12,3,0,3,96
980936,1,2,12,9,0,9,106
980942,1,2,12,4,0,4,85
980964,1,2,12,5,0,5,97
980982,1,2,12,6,0,6,85
980986,1,2,12,4,0,4,66
980992,1,2,12,22,0,22,99
981004,1,2,12,16,3,19,166
1082595,1,2,12,7,1,8,74
1082598,1,2,12,6,0,6,65
1082602,1,2,12,5,0,5,76
1082610,1,2,12,9,1,10,119
1082621,1,2,12,4,0,4,77
1082628,1,2,12,9,0,9,96
1082636,1,2,12,7,0,7,78
1082646,1,2,12,19,0,19,90
335987,2,2,12,3,0,3,59
335990,2,2,12,14,0,14,94
336001,2,2,12,9,0,9,111
336003,2,2,12,8,2,10,107
336007,2,2,12,4,0,4,83
336015,2,2,12,8,0,8,76
336028,2,2,12,8,0,8,50
392190,2,2,12,5,0,5,71
392193,2,2,12,9,1,10,75
392204,2,2,12,6,0,6,75
392213,2,2,12,6,0,6,87
392223,2,2,12,5,1,6,74
392226,2,2,12,6,0,6,80
392229,2,2,12,3,0,3,66
392237,2,2,12,6,0,6,70
392243,2,2,12,3,1,4,92
392244,2,2,12,1,0,1,79
419117,2,2,12,14,0,14,114
419124,2,2,12,8,0,8,100
419133,2,2,12,4,0,4,90
419141,2,2,12,7,1,8,93
419145,2,2,12,6,0,6,77
419153,2,2,12,3,0,3,85
419156,2,2,12,5,0,5,82
419159,2,2,12,11,0,11,114
419162,2,2,12,4,0,4,78
419167,2,2,12,4,1,5,100
419169,2,2,12,11,0,11,71
501205,2,2,12,4,1,5,91
501213,2,2,12,6,1,7,63
501216,2,2,12,7,1,8,85
501227,2,2,12,17,0,17,123
501232,2,2,12,3,0,3,105
501252,2,2,12,3,0,3,118
501257,2,2,12,7,0,7,97
501260,2,2,12,3,0,3,99
501265,2,2,12,8,0,8,84
501271,2,2,12,5,2,7,88
501276,2,2,12,13,2,15,88
548320,2,2,12,2,2,4,61
548329,2,2,12,3,0,3,82
548332,2,2,12,7,1,8,76
548336,2,2,12,10,0,10,86
548349,2,2,12,4,0,4,63
548361,2,2,12,4,0,4,97
548365,2,2,12,3,0,3,79
548381,2,2,12,8,0,8,62
598013,2,2,12,8,1,9,104
598022,2,2,12,7,0,7,103
598028,2,2,12,3,1,4,82
598038,2,2,12,9,0,9,78
598053,2,2,12,14,0,14,96
729286,2,2,12,7,0,7,86
729292,2,2,12,8,0,8,65
729304,2,2,12,3,0,3,93
733982,2,2,12,12,0,12,73
733988,2,2,12,7,0,7,116
733996,2,2,12,9,0,9,85
734018,2,2,12,8,0,8,66
734032,2,2,12,11,0,11,90
829718,2,2,12,10,0,10,103
829742,2,2,12,18,1,19,95
829750,2,2,12,2,0,2,86
829754,2,2,12,5,0,5,93
829784,2,2,12,13,0,13,86
980958,2,2,12,3,0,3,92
980974,2,2,12,3,0,3,97
981000,2,2,12,5,0,5,101
981016,2,2,12,3,0,3,88
981018,2,2,12,8,0,8,89
981024,2,2,12,9,0,9,129
1082591,2,2,12,7,0,7,118
1082607,2,2,12,5,1,6,78
1082624,2,2,12,7,0,7,60
1082633,2,2,12,3,0,3,75
335988,1,3,12,20,0,20,127
335994,1,3,12,11,5,16,112
336001,1,3,12,11,0,11,83
336006,1,3,12,8,0,8,106
336010,1,3,12,17,0,17,76
336012,1,3,12,7,0,7,77
336018,1,3,12,8,1,9,109
336023,1,3,12,9,0,9,66
336045,1,3,12,9,1,10,87
392190,1,3,12,3,0,3,111
392201,1,3,12,3,1,4,100
392207,1,3,12,1,1,2,86
392211,1,3,12,15,0,15,106
392214,1,3,12,9,2,11,99
392219,1,3,12,8,0,8,100
392229,1,3,12,9,0,9,93
392236,1,3,12,7,1,8,98
392239,1,3,12,5,0,5,79
392243,1,3,12,6,1,7,84
419118,1,3,12,4,0,4,68
419130,1,3,12,5,1,6,101
419142,1,3,12,16,0,16,113
419147,1,3,12,9,0,9,105
419152,1,3,12,4,0,4,83
419160,1,3,12,2,0,2,62
419168,1,3,12,4,0,4,74
419170,1,3,12,1,0,1,68
501203,1,3,12,7,0,7,90
501211,1,3,12,16,0,16,94
501216,1,3,12,7,0,7,104
501220,1,3,12,8,0,8,87
501231,1,3,12,5,0,5,74
501241,1,3,12,14,0,14,77
501250,1,3,12,5,1,6,55
501254,1,3,12,13,0,13,102
501258,1,3,12,12,0,12,85
501266,1,3,12,9,0,9,78
501271,1,3,12,4,0,4,48
501276,1,3,12,17,1,18,121
548311,1,3,12,3,1,4,84
548316,1,3,12,7,1,8,93
548321,1,3,12,4,0,4,72
548327,1,3,12,4,0,4,88
548335,1,3,12,9,0,9,83
548352,1,3,12,7,0,7,84
548357,1,3,12,10,0,10,101
548360,1,3,12,6,1,7,92
548376,1,3,12,11,0,11,57
548384,1,3,12,1,1,2,82
548385,1,3,12,11,0,11,115
548386,1,3,12,13,0,13,104
598025,1,3,12,14,0,14,83
598039,1,3,12,8,0,8,114
598043,1,3,12,7,0,7,68
598046,1,3,12,9,0,9,91
598056,1,3,12,7,0,7,111
598063,1,3,12,4,0,4,86
598067,1,3,12,11,0,11,88
598075,1,3,12,10,0,10,94
729288,1,3,12,4,0,4,116
729298,1,3,12,13,0,13,90
729302,1,3,12,7,0,7,81
733976,1,3,12,10,0,10,102
734018,1,3,12,10,0,10,77
734028,1,3,12,9,0,9,71
734034,1,3,12,6,0,6,95
829712,1,3,12,8,0,8,96
829716,1,3,12,22,1,23,119
829728,1,3,12,4,0,4,101
829740,1,3,12,10,2,12,85
829750,1,3,12,14,1,15,105
829758,1,3,12,8,0,8,116
829770,1,3,12,6,0,6,85
829784,1,3,12,6,0,6,79
829794,1,3,12,10,0,10,80
829802,1,3,12,9,0,9,74
829806,1,3,12,7,0,7,60
335998,2,3,12,9,0,9,90
336014,2,3,12,7,0,7,107
336034,2,3,12,4,0,4,69
336038,2,3,12,17,0,17,129
336042,2,3,12,8,3,11,88
336044,2,3,12,5,0,5,80
392186,2,3,12,10,0,10,83
392194,2,3,12,11,0,11,124
392207,2,3,12,12,0,12,78
392222,2,3,12,7,0,7,77
392232,2,3,12,5,1,6,70
419115,2,3,12,4,0,4,82
419121,2,3,12,9,1,10,129
419126,2,3,12,10,1,11,94
419128,2,3,12,8,1,9,73
419134,2,3,12,5,0,5,90
419138,2,3,12,1,1,2,107
419158,2,3,12,5,0,5,126
419164,2,3,12,13,1,14,109
501226,2,3,12,4,0,4,101
501233,2,3,12,8,1,9,80
501245,2,3,12,5,0,5,97
501273,2,3,12,1,0,1,71
548323,2,3,12,6,0,6,97
548337,2,3,12,7,0,7,83
548348,2,3,12,9,1,10,83
548366,2,3,12,2,1,3,60
548369,2,3,12,4,0,4,87
548373,2,3,12,6,0,6,104
598007,2,3,12,3,1,4,66
598012,2,3,12,3,0,3,74
598017,2,3,12,10,0,10,78
598020,2,3,12,4,0,4,78
598027,2,3,12,3,0,3,56
598031,2,3,12,6,0,6,109
598035,2,3,12,2,0,2,86
598051,2,3,12,1,1,2,54
598078,2,3,12,2,0,2,59
729308,2,3,12,7,0,7,85
729316,2,3,12,9,0,9,94
733986,2,3,12,13,1,14,92
733992,2,3,12,8,0,8,98
734000,2,3,12,3,0,3,85
734008,2,3,12,6,1,7,87
734040,2,3,12,5,0,5,95
734050,2,3,12,5,0,5,103
734052,2,3,12,6,0,6,140
829734,2,3,12,11,0,11,143
829778,2,3,12,10,1,11,110
829814,2,3,12,11,0,11,92
829822,2,3,12,7,0,7,95
829826,2,3,12,8,0,8,72
829828,2,3,12,8,0,8,89
335992,1,4,12,12,0,12,97
335996,1,4,12,3,0,3,110
336008,1,4,12,11,0,11,102
336024,1,4,12,11,0,11,115
336033,1,4,12,7,1,8,101
336040,1,4,12,9,0,9,104
336044,1,4,12,6,0,6,56
392188,1,4,12,6,0,6,104
392191,1,4,12,7,7,14,95
392200,1,4,12,8,0,8,71
392205,1,4,12,5,0,5,60
392227,1,4,12,1,0,1,80
392234,1,4,12,8,0,8,68
419113,1,4,12,4,0,4,91
419117,1,4,12,8,0,8,104
419126,1,4,12,14,0,14,78
419137,1,4,12,4,0,4,95
419141,1,4,12,3,1,4,88
419148,1,4,12,6,0,6,109
419161,1,4,12,1,0,1,87
419164,1,4,12,3,0,3,93
501207,1,4,12,2,0,2,52
501225,1,4,12,7,0,7,124
501239,1,4,12,0,2,2,66
501253,1,4,12,2,0,2,79
501256,1,4,12,4,0,4,100
501262,1,4,12,2,0,2,86
501265,1,4,12,12,2,14,125
548328,1,4,12,5,0,5,73
548333,1,4,12,7,0,7,75
548336,1,4,12,4,2,6,81
548344,1,4,12,8,0,8,75
548348,1,4,12,5,0,5,97
548364,1,4,12,6,0,6,97
548374,1,4,12,8,0,8,80
548379,1,4,12,6,1,7,63
598012,1,4,12,10,0,10,88
598019,1,4,12,9,0,9,72
598021,1,4,12,5,0,5,78
598026,1,4,12,7,0,7,76
598033,1,4,12,5,0,5,86
598036,1,4,12,9,0,9,85
598057,1,4,12,4,4,8,93
598071,1,4,12,3,0,3,90
729300,1,4,12,12,0,12,98
729312,1,4,12,7,0,7,94
733978,1,4,12,14,0,14,93
733992,1,4,12,14,0,14,100
733996,1,4,12,1,0,1,116
734002,1,4,12,6,0,6,96
734030,1,4,12,3,1,4,97
734038,1,4,12,9,0,9,103
734052,1,4,12,19,1,20,131
734054,1,4,12,15,0,15,82
829722,1,4,12,8,0,8,99
829730,1,4,12,8,1,9,92
829738,1,4,12,7,1,8,91
829772,1,4,12,4,0,4,52
829796,1,4,12,10,0,10,88
829814,1,4,12,9,0,9,68
980910,1,4,12,3,1,4,102
980918,1,4,12,4,0,4,63
980930,1,4,12,9,1,10,72
980940,1,4,12,6,0,6,77
980960,1,4,12,7,1,8,94
980976,1,4,12,13,0,13,93
980996,1,4,12,6,0,6,93
981010,1,4,12,7,0,7,88
1082601,1,4,12,1,0,1,98
1082612,1,4,12,11,0,11,91
1082616,1,4,12,13,0,13,104
1082633,1,4,12,3,0,3,63
1082637,1,4,12,10,0,10,99
1082639,1,4,12,18,1,19,86
1082641,1,4,12,10,0,10,141
1082645,1,4,12,5,0,5,64
335988,2,4,12,12,0,12,127
336000,2,4,12,13,1,14,103
336004,2,4,12,10,1,11,101
336011,2,4,12,11,1,12,93
336018,2,4,12,8,0,8,95
336021,2,4,12,10,0,10,101
336036,2,4,12,10,0,10,115
392196,2,4,12,7,0,7,91
392209,2,4,12,3,4,7,80
392212,2,4,12,9,0,9,94
392215,2,4,12,8,1,9,74
392219,2,4,12,15,0,15,115
392221,2,4,12,5,0,5,101
392231,2,4,12,4,0,4,60
392239,2,4,12,2,0,2,47
419122,2,4,12,4,0,4,68
419129,2,4,12,5,0,5,112
419132,2,4,12,3,0,3,82
419144,2,4,12,13,0,13,136
419151,2,4,12,3,1,4,93
419154,2,4,12,3,0,3,68
501211,2,4,12,9,0,9,119
501217,2,4,12,4,1,5,116
501228,2,4,12,13,1,14,117
501242,2,4,12,4,1,5,78
501249,2,4,12,3,0,3,70
501259,2,4,12,19,0,19,115
501269,2,4,12,2,0,2,86
548314,2,4,12,3,0,3,87
548318,2,4,12,12,2,14,72
548324,2,4,12,3,0,3,71
548339,2,4,12,6,0,6,86
548355,2,4,12,8,0,8,98
548359,2,4,12,10,0,10,78
548371,2,4,12,16,0,16,99
548376,2,4,12,5,0,5,76
598008,2,4,12,7,0,7,99
598030,2,4,12,12,0,12,102
598042,2,4,12,3,1,4,95
598046,2,4,12,19,0,19,92
598050,2,4,12,9,0,9,99
598061,2,4,12,2,0,2,62
598064,2,4,12,8,0,8,93
598069,2,4,12,10,1,11,90
729288,2,4,12,11,1,12,116
729296,2,4,12,16,1,17,102
729318,2,4,12,14,0,14,84
734012,2,4,12,15,0,15,156
734024,2,4,12,6,1,7,107
734044,2,4,12,8,1,9,101
734048,2,4,12,3,0,3,80
829714,2,4,12,4,0,4,81
829746,2,4,12,2,1,3,87
829758,2,4,12,2,0,2,68
829764,2,4,12,6,0,6,71
829780,2,4,12,7,1,8,90
829790,2,4,12,13,0,13,78
829804,2,4,12,4,1,5,79
980924,2,4,12,10,0,10,96
980946,2,4,12,7,0,7,95
980968,2,4,12,17,0,17,93
980982,2,4,12,5,0,5,93
980990,2,4,12,7,1,8,74
981004,2,4,12,9,0,9,105
1082594,2,4,12,3,0,3,88
1082598,2,4,12,11,1,12,119
1082605,2,4,12,9,0,9,81
1082609,2,4,12,4,0,4,67
1082623,2,4,12,8,0,8,96
335989,1,5,12,12,0,12,67
336005,1,5,12,7,1,8,111
336013,1,5,12,3,0,3,85
336028,1,5,12,9,0,9,109
336038,1,5,12,10,0,10,137
336043,1,5,12,9,0,9,113
392195,1,5,12,5,0,5,85
392215,1,5,12,11,0,11,113
392222,1,5,12,6,0,6,74
392230,1,5,12,11,0,11,84
392238,1,5,12,1,0,1,63
419116,1,5,12,9,0,9,73
419120,1,5,12,13,0,13,62
419123,1,5,12,8,0,8,103
419129,1,5,12,6,0,6,100
419134,1,5,12,11,0,11,111
419146,1,5,12,7,0,7,101
419159,1,5,12,9,0,9,66
419163,1,5,12,7,0,7,84
501214,1,5,12,4,0,4,79
501219,1,5,12,6,0,6,73
501245,1,5,12,4,0,4,92
501257,1,5,12,9,0,9,86
501263,1,5,12,4,0,4,80
548314,1,5,12,6,1,7,95
548317,1,5,12,7,0,7,81
548325,1,5,12,11,0,11,73
548329,1,5,12,9,0,9,75
548337,1,5,12,5,0,5,76
548354,1,5,12,5,0,5,92
548359,1,5,12,14,0,14,110
548366,1,5,12,4,0,4,71
548370,1,5,12,5,0,5,94
548378,1,5,12,4,0,4,73
548382,1,5,12,2,0,2,85
598006,1,5,12,6,0,6,91
598010,1,5,12,2,0,2,69
598014,1,5,12,3,0,3,83
598024,1,5,12,10,3,13,109
598028,1,5,12,4,0,4,74
598031,1,5,12,5,0,5,103
598048,1,5,12,4,0,4,79
598077,1,5,12,14,0,14,87
729296,1,5,12,20,1,21,119
729320,1,5,12,4,0,4,77
733984,1,5,12,11,0,11,92
734008,1,5,12,7,0,7,93
734016,1,5,12,11,0,11,108
734046,1,5,12,12,0,12,90
829714,1,5,12,7,0,7,83
829746,1,5,12,5,0,5,99
829754,1,5,12,4,1,5,87
829782,1,5,12,8,0,8,88
829816,1,5,12,4,0,4,115
335992,2,5,12,2,1,3,102
335995,2,5,12,5,0,5,126
335997,2,5,12,4,0,4,83
336010,2,5,12,3,1,4,92
336016,2,5,12,13,2,15,101
336020,2,5,12,8,2,10,98
336024,2,5,12,20,0,20,98
336032,2,5,12,17,0,17,97
336041,2,5,12,1,4,5,77
336045,2,5,12,6,1,7,87
392187,2,5,12,0,0,0,47
392200,2,5,12,4,4,8,66
392203,2,5,12,3,0,3,67
392207,2,5,12,1,0,1,79
392210,2,5,12,17,0,17,85
392218,2,5,12,8,1,9,76
392225,2,5,12,6,0,6,78
392235,2,5,12,8,0,8,79
419112,2,5,12,25,1,26,114
419131,2,5,12,5,0,5,105
419139,2,5,12,11,1,12,85
419142,2,5,12,10,0,10,124
419148,2,5,12,13,3,16,132
419155,2,5,12,6,0,6,69
501204,2,5,12,10,0,10,77
501209,2,5,12,6,0,6,98
501225,2,5,12,12,0,12,86
501230,2,5,12,9,0,9,76
501236,2,5,12,5,0,5,56
501240,2,5,12,7,0,7,68
501254,2,5,12,7,0,7,85
501268,2,5,12,11,0,11,120
548322,2,5,12,10,0,10,99
548331,2,5,12,9,0,9,110
548341,2,5,12,6,2,8,88
548350,2,5,12,7,0,7,85
548363,2,5,12,6,0,6,95
598019,2,5,12,3,0,3,76
598037,2,5,12,8,0,8,78
598041,2,5,12,10,0,10,95
598052,2,5,12,5,0,5,99
598054,2,5,12,11,1,12,97
598057,2,5,12,10,0,10,92
598063,2,5,12,10,0,10,82
598068,2,5,12,12,1,13,82
598070,2,5,12,2,0,2,51
598076,2,5,12,8,0,8,70
729290,2,5,12,6,0,6,75
729302,2,5,12,3,0,3,66
729310,2,5,12,6,0,6,61
733980,2,5,12,10,0,10,86
733994,2,5,12,6,0,6,70
734004,2,5,12,9,0,9,91
734022,2,5,12,5,0,5,75
734038,2,5,12,7,0,7,77
829720,2,5,12,5,1,6,85
829726,2,5,12,7,0,7,85
829732,2,5,12,11,1,12,77
829740,2,5,12,16,0,16,110
829774,2,5,12,11,0,11,109
829792,2,5,12,15,1,16,93
829802,2,5,12,2,2,4,75
829824,2,5,12,8,0,8,79
336000,1,6,12,7,0,7,88
336003,1,6,12,11,0,11,113
336014,1,6,12,3,0,3,100
336020,1,6,12,5,1,6,81
336025,1,6,12,13,0,13,99
392194,1,6,12,9,0,9,105
392203,1,6,12,13,0,13,82
392228,1,6,12,4,0,4,90
392231,1,6,12,5,0,5,67
392235,1,6,12,5,0,5,71
392237,1,6,12,5,0,5,73
392242,1,6,12,1,0,1,86
419121,1,6,12,3,1,4,105
419133,1,6,12,3,0,3,103
419136,1,6,12,8,0,8,105
419139,1,6,12,5,0,5,91
419145,1,6,12,18,1,19,111
419154,1,6,12,2,0,2,70
501206,1,6,12,9,0,9,68
501209,1,6,12,8,0,8,62
501228,1,6,12,19,0,19,147
501232,1,6,12,10,1,11,85
501238,1,6,12,7,0,7,60
501243,1,6,12,8,0,8,76
548347,1,6,12,11,0,11,122
548350,1,6,12,7,0,7,95
548362,1,6,12,5,0,5,89
548369,1,6,12,4,0,4,60
598003,1,6,12,4,0,4,79
598015,1,6,12,7,0,7,58
598022,1,6,12,3,1,4,76
598040,1,6,12,9,1,10,80
598049,1,6,12,4,0,4,56
598054,1,6,12,8,0,8,78
598064,1,6,12,5,0,5,75
729286,1,6,12,5,0,5,63
733980,1,6,12,3,0,3,80
733986,1,6,12,6,2,8,96
733990,1,6,12,3,0,3,85
733998,1,6,12,7,0,7,91
734024,1,6,12,8,0,8,92
734044,1,6,12,4,0,4,86
829720,1,6,12,3,2,5,98
829736,1,6,12,3,0,3,95
829744,1,6,12,3,0,3,81
829752,1,6,12,19,1,20,101
829762,1,6,12,5,0,5,67
829788,1,6,12,3,0,3,80
829818,1,6,12,3,0,3,112
980908,1,6,12,7,5,12,80
980938,1,6,12,14,0,14,84
980956,1,6,12,14,1,15,92
980970,1,6,12,5,1,6,83
981002,1,6,12,3,0,3,57
981016,1,6,12,2,0,2,82
1082599,1,6,12,16,0,16,104
1082605,1,6,12,7,0,7,97
1082608,1,6,12,11,0,11,98
1082622,1,6,12,10,0,10,93
1082626,1,6,12,5,0,5,51
1082642,1,6,12,16,0,16,105
335989,2,6,12,5,0,5,100
335993,2,6,12,3,9,12,112
336006,2,6,12,5,0,5,118
336009,2,6,12,4,1,5,90
336022,2,6,12,6,0,6,73
336031,2,6,12,2,0,2,114
336037,2,6,12,8,0,8,98
336043,2,6,12,11,0,11,75
392199,2,6,12,8,0,8,77
392206,2,6,12,10,0,10,85
392211,2,6,12,7,0,7,86
392216,2,6,12,6,0,6,92
392220,2,6,12,4,0,4,60
392224,2,6,12,7,0,7,83
392240,2,6,12,9,1,10,114
419113,2,6,12,13,0,13,78
419116,2,6,12,7,0,7,113
419119,2,6,12,0,0,0,102
419125,2,6,12,6,0,6,97
419149,2,6,12,2,1,3,104
419157,2,6,12,4,0,4,94
419160,2,6,12,1,0,1,61
419165,2,6,12,4,0,4,69
501218,2,6,12,6,0,6,115
501221,2,6,12,2,0,2,86
501235,2,6,12,4,0,4,66
501248,2,6,12,15,0,15,107
501251,2,6,12,12,0,12,76
501258,2,6,12,9,1,10,81
501262,2,6,12,2,0,2,74
548312,2,6,12,4,0,4,100
548315,2,6,12,4,0,4,76
548321,2,6,12,11,0,11,98
548326,2,6,12,7,1,8,83
548330,2,6,12,7,0,7,74
548334,2,6,12,5,0,5,129
548338,2,6,12,10,0,10,114
548342,2,6,12,4,0,4,115
548354,2,6,12,7,1,8,110
548374,2,6,12,12,0,12,82
548377,2,6,12,10,1,11,116
548379,2,6,12,10,0,10,106
548383,2,6,12,6,1,7,95
548385,2,6,12,7,2,9,107
598006,2,6,12,8,0,8,90
598011,2,6,12,4,1,5,102
598025,2,6,12,5,0,5,67
598029,2,6,12,5,0,5,114
598033,2,6,12,5,0,5,66
598045,2,6,12,15,0,15,78
598059,2,6,12,8,1,9,105
598067,2,6,12,10,0,10,83
598072,2,6,12,10,1,11,83
729294,2,6,12,9,0,9,97
729298,2,6,12,11,0,11,74
729306,2,6,12,1,0,1,99
729314,2,6,12,11,0,11,73
734010,2,6,12,15,0,15,97
734016,2,6,12,9,0,9,76
734036,2,6,12,13,0,13,82
829712,2,6,12,7,0,7,82
829730,2,6,12,10,0,10,89
829766,2,6,12,14,0,14,85
829772,2,6,12,13,0,13,101
829782,2,6,12,15,0,15,87
829798,2,6,12,7,0,7,73
829806,2,6,12,8,0,8,82
980918,2,6,12,17,0,17,96
980926,2,6,12,5,0,5,105
980950,2,6,12,14,0,14,72
980966,2,6,12,9,0,9,105
980976,2,6,12,7,1,8,105
980988,2,6,12,8,0,8,91
980998,2,6,12,5,1,6,90
981008,2,6,12,8,0,8,83
1082595,2,6,12,9,0,9,94
1082611,2,6,12,5,0,5,95
1082614,2,6,12,2,0,2,69
1082630,2,6,12,8,0,8,109
1082632,2,6,12,16,0,16,153
1082635,2,6,12,5,1,6,64
1082640,2,6,12,11,1,12,110
1082646,2,6,12,3,0,3,87
335990,1,7,12,13,0,13,94
335999,1,7,12,3,2,5,61
336009,1,7,12,14,0,14,92
336029,1,7,12,5,3,8,91
336037,1,7,12,11,0,11,107
336041,1,7,12,4,0,4,75
392186,1,7,12,10,1,11,84
392202,1,7,12,5,0,5,123
392208,1,7,12,8,0,8,73
392213,1,7,12,6,0,6,67
392220,1,7,12,3,1,4,51
392223,1,7,12,6,0,6,82
392232,1,7,12,4,0,4,79
392240,1,7,12,15,0,15,90
419112,1,7,12,10,0,10,121
419119,1,7,12,2,1,3,125
419124,1,7,12,4,0,4,80
419135,1,7,12,6,1,7,92
419143,1,7,12,5,0,5,84
419151,1,7,12,7,0,7,87
419155,1,7,12,14,0,14,91
419157,1,7,12,10,0,10,80
419162,1,7,12,16,0,16,94
419166,1,7,12,3,0,3,74
419167,1,7,12,4,0,4,88
501215,1,7,12,2,0,2,91
501226,1,7,12,11,1,12,86
501229,1,7,12,4,0,4,78
501236,1,7,12,4,0,4,55
501242,1,7,12,15,0,15,92
501246,1,7,12,11,0,11,80
501251,1,7,12,14,0,14,96
501268,1,7,12,5,0,5,66
548322,1,7,12,9,0,9,96
548330,1,7,12,17,0,17,62
548339,1,7,12,19,0,19,84
548356,1,7,12,2,1,3,81
548365,1,7,12,4,0,4,60
548368,1,7,12,10,0,10,104
598007,1,7,12,4,0,4,83
598011,1,7,12,13,0,13,100
598016,1,7,12,11,0,11,90
598029,1,7,12,4,0,4,70
598038,1,7,12,4,0,4,110
598042,1,7,12,15,0,15,80
598044,1,7,12,5,0,5,74
598051,1,7,12,14,0,14,66
598055,1,7,12,7,0,7,84
598068,1,7,12,11,0,11,105
598078,1,7,12,9,0,9,74
729292,1,7,12,3,0,3,72
729308,1,7,12,4,0,4,73
729314,1,7,12,2,1,3,54
733988,1,7,12,7,0,7,95
734000,1,7,12,9,0,9,78
734014,1,7,12,6,0,6,70
734022,1,7,12,10,0,10,96
734036,1,7,12,8,0,8,120
734050,1,7,12,13,0,13,99
829710,1,7,12,3,0,3,69
829726,1,7,12,6,0,6,52
829734,1,7,12,13,0,13,84
829742,1,7,12,4,0,4,101
829756,1,7,12,9,0,9,92
829774,1,7,12,7,0,7,95
829780,1,7,12,8,0,8,110
829810,1,7,12,6,1,7,80
829822,1,7,12,10,0,10,101
829828,1,7,12,10,0,10,120
980906,1,7,12,6,0,6,57
980922,1,7,12,6,0,6,68
980928,1,7,12,6,0,6,67
980946,1,7,12,13,1,14,101
980990,1,7,12,6,0,6,53
980998,1,7,12,7,0,7,97
981012,1,7,12,14,2,16,103
1082592,1,7,12,3,0,3,95
1082614,1,7,12,8,0,8,82
1082635,1,7,12,11,1,12,109
1082638,1,7,12,5,0,5,72
1082644,1,7,12,8,0,8,94
1082650,1,7,12,1,0,1,66
335994,2,7,12,9,0,9,99
335996,2,7,12,22,0,22,90
336002,2,7,12,15,0,15,90
336013,2,7,12,1,0,1,73
336017,2,7,12,1,0,1,96
336023,2,7,12,5,0,5,120
336033,2,7,12,8,1,9,108
392197,2,7,12,4,0,4,90
392202,2,7,12,1,0,1,80
392205,2,7,12,3,0,3,56
392217,2,7,12,12,0,12,87
392227,2,7,12,7,0,7,93
392230,2,7,12,7,1,8,64
419119,2,7,12,5,5,10,112
419127,2,7,12,12,0,12,92
419130,2,7,12,5,0,5,106
419137,2,7,12,3,0,3,92
419147,2,7,12,8,1,9,82
419170,2,7,12,6,0,6,73
501206,2,7,12,14,1,15,66
501210,2,7,12,8,0,8,89
501223,2,7,12,9,1,10,78
501256,2,7,12,9,0,9,80
501261,2,7,12,3,0,3,56
501272,2,7,12,3,0,3,94
501274,2,7,12,6,0,6,99
501275,2,7,12,3,1,4,87
548311,2,7,12,3,0,3,87
548313,2,7,12,3,0,3,57
548319,2,7,12,3,0,3,60
548344,2,7,12,5,0,5,71
548347,2,7,12,15,0,15,112
548351,2,7,12,6,0,6,63
548360,2,7,12,9,1,10,98
548372,2,7,12,1,1,2,77
548375,2,7,12,3,0,3,63
548382,2,7,12,9,1,10,105
548384,2,7,12,7,0,7,97
598004,2,7,12,5,0,5,74
598024,2,7,12,8,0,8,57
598034,2,7,12,8,0,8,90
598060,2,7,12,8,0,8,63
598065,2,7,12,13,0,13,95
598071,2,7,12,2,0,2,78
598075,2,7,12,2,1,3,101
598077,2,7,12,14,2,16,99
729284,2,7,12,6,0,6,71
729322,2,7,12,4,0,4,67
733978,2,7,12,14,0,14,89
734006,2,7,12,13,0,13,93
734030,2,7,12,8,0,8,112
734046,2,7,12,18,0,18,157
829722,2,7,12,5,0,5,46
829752,2,7,12,5,0,5,89
829788,2,7,12,9,3,12,77
829794,2,7,12,1,0,1,86
829800,2,7,12,16,0,16,113
829820,2,7,12,22,0,22,102
980914,2,7,12,8,0,8,109
980932,2,7,12,8,0,8,97
980938,2,7,12,14,0,14,98
980952,2,7,12,11,0,11,102
980962,2,7,12,7,0,7,93
980978,2,7,12,4,0,4,62
980986,2,7,12,13,0,13,76
1082597,2,7,12,14,0,14,97
1082600,2,7,12,7,0,7,97
1082602,2,7,12,10,1,11,65
1082606,2,7,12,9,0,9,101
1082612,2,7,12,16,0,16,150
1082618,2,7,12,9,0,9,86
1082625,2,7,12,3,0,3,93
1082628,2,7,12,3,1,4,90
1082641,2,7,12,3,0,3,120
1082647,2,7,12,2,4,6,81
1082649,2,7,12,8,0,8,88
335991,1,8,12,2,0,2,59
335993,1,8,12,6,0,6,60
335995,1,8,12,9,0,9,108
336004,1,8,12,7,0,7,90
336007,1,8,12,7,0,7,108
336016,1,8,12,3,0,3,87
336036,1,8,12,9,0,9,88
336042,1,8,12,5,1,6,65
392193,1,8,12,4,2,6,107
392197,1,8,12,18,0,18,113
392206,1,8,12,15,1,16,77
392210,1,8,12,4,1,5,70
392217,1,8,12,11,0,11,80
392221,1,8,12,1,0,1,74
392225,1,8,12,3,1,4,86
392244,1,8,12,4,0,4,69
419115,1,8,12,11,0,11,99
419122,1,8,12,10,0,10,113
419125,1,8,12,12,0,12,95
419131,1,8,12,14,0,14,98
419156,1,8,12,14,0,14,95
419165,1,8,12,14,0,14,99
419169,1,8,12,3,1,4,52
501204,1,8,12,4,0,4,75
501213,1,8,12,9,0,9,90
501217,1,8,12,3,0,3,91
501221,1,8,12,3,0,3,106
501234,1,8,12,10,0,10,58
501248,1,8,12,6,2,8,87
501255,1,8,12,5,0,5,81
501261,1,8,12,9,0,9,68
501269,1,8,12,7,0,7,109
548319,1,8,12,14,1,15,80
548326,1,8,12,5,0,5,106
548331,1,8,12,9,0,9,105
548334,1,8,12,15,0,15,85
548340,1,8,12,7,1,8,84
548346,1,8,12,11,0,11,94
548351,1,8,12,5,0,5,64
548353,1,8,12,12,0,12,75
548361,1,8,12,10,0,10,87
548371,1,8,12,15,0,15,102
548381,1,8,12,2,0,2,53
335999,2,8,12,8,0,8,155
336012,2,8,12,6,0,6,94
336019,2,8,12,5,0,5,91
336025,2,8,12,19,0,19,112
336029,2,8,12,10,0,10,72
336039,2,8,12,15,0,15,90
392189,2,8,12,14,0,14,91
392201,2,8,12,8,0,8,107
392214,2,8,12,11,0,11,95
392228,2,8,12,12,0,12,99
392233,2,8,12,11,1,12,85
392234,2,8,12,3,0,3,73
392241,2,8,12,6,1,7,98
392242,2,8,12,5,0,5,120
419111,2,8,12,3,0,3,102
419135,2,8,12,6,0,6,91
419140,2,8,12,5,0,5,98
419143,2,8,12,7,0,7,82
419146,2,8,12,9,0,9,101
419150,2,8,12,7,1,8,97
419152,2,8,12,7,0,7,68
419161,2,8,12,12,0,12,110
419168,2,8,12,5,0,5,54
501208,2,8,12,10,1,11,80
501229,2,8,12,5,0,5,81
501241,2,8,12,11,0,11,101
501244,2,8,12,8,1,9,79
501264,2,8,12,4,0,4,84
548316,2,8,12,10,0,10,88
548357,2,8,12,5,1,6,85
548364,2,8,12,3,0,3,75
548378,2,8,12,7,2,9,85
501205,1,9,12,8,0,8,99
501212,1,9,12,9,0,9,83
501224,1,9,12,7,1,8,66
501230,1,9,12,5,0,5,68
501247,1,9,12,8,0,8,82
501252,1,9,12,5,1,6,81
501259,1,9,12,9,0,9,118
501215,2,9,12,13,0,13,108
501220,2,9,12,11,0,11,103
501234,2,9,12,5,0,5,53
501238,2,9,12,5,0,5,62
501243,2,9,12,10,0,10,109
501266,2,9,12,7,0,7,75
501218,1,10,12,6,0,6,108
501223,1,10,12,9,2,11,79
501233,1,10,12,8,0,8,71
501240,1,10,12,4,2,6,91
501264,1,10,12,5,0,5,78
501267,1,10,12,4,5,9,68
548313,1,10,12,12,0,12,70
548318,1,10,12,6,0,6,86
548324,1,10,12,6,0,6,77
548332,1,10,12,11,0,11,112
548338,1,10,12,12,1,13,104
548342,1,10,12,8,0,8,61
548363,1,10,12,6,1,7,79
598008,1,10,12,5,0,5,45
598020,1,10,12,4,1,5,89
598030,1,10,12,8,0,8,91
598052,1,10,12,5,0,5,102
598060,1,10,12,6,0,6,78
598066,1,10,12,5,0,5,94
598072,1,10,12,5,0,5,91
501207,2,10,12,13,0,13,93
501212,2,10,12,11,1,12,83
501231,2,10,12,7,0,7,73
501237,2,10,12,6,1,7,83
501246,2,10,12,11,0,11,72
501253,2,10,12,9,0,9,84
501255,2,10,12,6,0,6,93
548327,2,10,12,4,0,4,85
548335,2,10,12,13,0,13,85
548346,2,10,12,7,0,7,85
548353,2,10,12,11,0,11,91
548356,2,10,12,8,0,8,57
548358,2,10,12,5,0,5,80
548367,2,10,12,4,0,4,88
548370,2,10,12,8,0,8,76
548380,2,10,12,4,0,4,68
598005,2,10,12,7,0,7,57
598014,2,10,12,8,0,8,104
598016,2,10,12,6,0,6,83
598023,2,10,12,2,0,2,73
598032,2,10,12,8,0,8,93
598040,2,10,12,7,0,7,85
598043,2,10,12,2,0,2,74
598047,2,10,12,3,0,3,85
598058,2,10,12,5,0,5,58
598005,1,11,12,4,0,4,71
598023,1,11,12,13,0,13,62
598035,1,11,12,10,0,10,77
598037,1,11,12,3,1,4,74
598053,1,11,12,3,0,3,67
598061,1,11,12,7,0,7,71
598065,1,11,12,5,1,6,104
598070,1,11,12,6,4,10,61
598076,1,11,12,2,0,2,57
729290,1,11,12,4,0,4,79
729306,1,11,12,5,0,5,90
729316,1,11,12,6,0,6,78
729322,1,11,12,7,0,7,83
733982,1,11,12,6,0,6,87
733994,1,11,12,7,0,7,86
734006,1,11,12,7,0,7,80
734012,1,11,12,4,5,9,92
734020,1,11,12,12,0,12,96
734042,1,11,12,5,1,6,89
829732,1,11,12,8,0,8,75
829748,1,11,12,15,0,15,109
829764,1,11,12,3,0,3,85
829778,1,11,12,12,0,12,128
829792,1,11,12,4,1,5,96
829798,1,11,12,14,1,15,79
829804,1,11,12,9,0,9,99
829820,1,11,12,3,0,3,61
980920,1,11,12,8,0,8,63
980948,1,11,12,3,0,3,45
980958,1,11,12,11,0,11,98
980978,1,11,12,3,0,3,93
980984,1,11,12,3,0,3,69
980988,1,11,12,5,1,6,94
981008,1,11,12,13,0,13,91
981020,1,11,12,9,0,9,82
981024,1,11,12,12,1,13,116
1082591,1,11,12,8,0,8,106
1082600,1,11,12,9,0,9,93
1082609,1,11,12,9,0,9,75
1082611,1,11,12,7,0,7,98
1082615,1,11,12,13,0,13,83
1082623,1,11,12,6,1,7,120
1082627,1,11,12,7,0,7,133
1082630,1,11,12,3,0,3,93
1082648,1,11,12,2,2,4,75
598009,2,11,12,10,0,10,69
598015,2,11,12,9,0,9,63
598018,2,11,12,6,0,6,77
598026,2,11,12,4,0,4,70
598044,2,11,12,15,0,15,79
598049,2,11,12,4,1,5,64
598056,2,11,12,4,0,4,91
598074,2,11,12,6,0,6,90
729300,2,11,12,5,0,5,84
734026,2,11,12,14,0,14,97
734034,2,11,12,3,0,3,117
829716,2,11,12,5,0,5,93
829724,2,11,12,8,0,8,113
829736,2,11,12,7,0,7,86
829756,2,11,12,4,0,4,81
829786,2,11,12,3,0,3,69
980912,2,11,12,5,2,7,106
980928,2,11,12,13,0,13,83
980934,2,11,12,12,0,12,112
980940,2,11,12,3,0,3,98
980972,2,11,12,4,0,4,69
980996,2,11,12,10,1,11,97
981014,2,11,12,7,0,7,92
981022,2,11,12,7,0,7,82
1082596,2,11,12,7,1,8,109
1082604,2,11,12,10,0,10,80
1082634,2,11,12,7,0,7,83
1082638,2,11,12,4,0,4,98
1082643,2,11,12,16,0,16,102
980916,1,12,12,7,0,7,100
980924,1,12,12,5,0,5,87
980944,1,12,12,8,0,8,79
980954,1,12,12,11,0,11,104
980962,1,12,12,3,0,3,105
980974,1,12,12,13,0,13,110
980994,1,12,12,4,0,4,78
1082594,1,12,12,4,0,4,75
1082603,1,12,12,5,0,5,106
1082607,1,12,12,7,0,7,92
1082618,1,12,12,12,0,12,100
1082620,1,12,12,9,0,9,98
1082624,1,12,12,16,0,16,85
1082634,1,12,12,5,0,5,73
1082647,1,12,12,11,0,11,83
980906,2,12,12,11,0,11,96
980936,2,12,12,6,0,6,86
980970,2,12,12,6,1,7,94
980984,2,12,12,8,0,8,68
981010,2,12,12,9,1,10,81
1082592,2,12,12,8,0,8,105
1082599,2,12,12,3,0,3,79
1082615,2,12,12,4,0,4,91
1082629,2,12,12,8,0,8,80
1082631,2,12,12,9,0,9,110
1082642,2,12,12,8,0,8,92
1082645,2,12,12,11,0,11,78
1082650,2,12,12,6,0,6,71
980934,1,13,12,6,0,6,83
980950,1,13,12,2,0,2,117
980966,1,13,12,6,0,6,81
980972,1,13,12,9,0,9,70
981018,1,13,12,8,0,8,72
981022,1,13,12,4,0,4,81
1082593,1,13,12,7,0,7,102
1082596,1,13,12,7,0,7,75
1082606,1,13,12,2,0,2,83
1082625,1,13,12,0,1,1,84
1082629,1,13,12,8,0,8,109
1082632,1,13,12,18,0,18,127
1082640,1,13,12,4,1,5,103
1082643,1,13,12,7,0,7,118
980910,2,13,12,10,0,10,117
980916,2,13,12,13,0,13,114
980922,2,13,12,2,1,3,83
980942,2,13,12,10,1,11,113
980954,2,13,12,5,0,5,121
980960,2,13,12,3,0,3,64
980980,2,13,12,10,0,10,103
980992,2,13,12,2,0,2,69
981006,2,13,12,6,0,6,113
981012,2,13,12,10,0,10,121
1082603,2,13,12,5,0,5,107
1082610,2,13,12,1,0,1,107
1082613,2,13,12,9,0,9,119
1082616,2,13,12,5,0,5,95
1082621,2,13,12,11,0,11,115
1082637,2,13,12,9,0,9,123
335987,1,1,13,11,1,12,124
335998,1,1,13,8,0,8,87
336002,1,1,13,3,0,3,77
336015,1,1,13,6,0,6,95
336019,1,1,13,6,0,6,89
336022,1,1,13,6,1,7,86
336026,1,1,13,2,1,3,56
336030,1,1,13,4,0,4,89
336032,1,1,13,10,0,10,82
392189,1,1,13,5,0,5,52
392204,1,1,13,6,0,6,80
392212,1,1,13,4,0,4,75
392216,1,1,13,14,1,15,98
392224,1,1,13,4,0,4,62
392226,1,1,13,9,0,9,90
392233,1,1,13,4,0,4,71
419111,1,1,13,6,1,7,78
419127,1,1,13,6,0,6,80
419132,1,1,13,10,0,10,111
419140,1,1,13,13,0,13,99
419144,1,1,13,26,7,33,122
419149,1,1,13,6,0,6,110
419153,1,1,13,2,0,2,105
419158,1,1,13,13,0,13,85
501208,1,1,13,8,0,8,91
501227,1,1,13,8,0,8,101
501235,1,1,13,8,0,8,91
501244,1,1,13,3,0,3,87
501260,1,1,13,2,4,6,89
501272,1,1,13,4,0,4,104
501274,1,1,13,8,0,8,80
548320,1,1,13,8,0,8,123
548349,1,1,13,9,0,9,116
548358,1,1,13,3,0,3,114
548373,1,1,13,2,0,2,102
548375,1,1,13,9,0,9,87
548380,1,1,13,16,4,20,80
548383,1,1,13,7,0,7,88
598013,1,1,13,8,0,8,96
598018,1,1,13,8,0,8,96
598027,1,1,13,9,0,9,82
598034,1,1,13,9,0,9,102
598045,1,1,13,4,1,5,65
598058,1,1,13,6,4,10,85
598074,1,1,13,8,0,8,74
729284,1,1,13,8,0,8,86
729294,1,1,13,11,0,11,93
729304,1,1,13,5,0,5,96
734032,1,1,13,6,0,6,111
734048,1,1,13,5,1,6,96
829718,1,1,13,12,2,14,101
829766,1,1,13,6,2,8,91
829786,1,1,13,15,0,15,101
980914,1,1,13,10,0,10,118
980952,1,1,13,15,0,15,116
980968,1,1,13,11,0,11,100
980980,1,1,13,9,0,9,83
981000,1,1,13,5,2,7,107
981006,1,1,13,3,0,3,64
981014,1,1,13,13,1,14,111
1082597,1,1,13,9,0,9,98
1082604,1,1,13,14,0,14,108
1082613,1,1,13,6,0,6,122
1082617,1,1,13,4,0,4,98
1082631,1,1,13,6,0,6,95
1082649,1,1,13,10,0,10,71
335991,2,1,13,2,2,4,68
336005,2,1,13,7,0,7,107
336008,2,1,13,17,0,17,80
336040,2,1,13,2,0,2,87
392195,2,1,13,10,0,10,89
392202,2,1,13,0,0,0,80
392208,2,1,13,5,1,6,81
392236,2,1,13,11,0,11,114
392238,2,1,13,10,0,10,57
419114,2,1,13,4,3,7,109
419118,2,1,13,3,1,4,82
419123,2,1,13,8,0,8,87
419136,2,1,13,9,0,9,82
419163,2,1,13,15,1,16,101
419166,2,1,13,7,6,13,92
501203,2,1,13,4,0,4,95
501214,2,1,13,6,0,6,108
501219,2,1,13,7,0,7,64
501224,2,1,13,2,0,2,75
501239,2,1,13,6,0,6,91
501247,2,1,13,4,0,4,88
501267,2,1,13,6,0,6,98
548317,2,1,13,0,0,0,77
548325,2,1,13,5,0,5,79
548328,2,1,13,1,0,1,80
548333,2,1,13,8,0,8,91
548340,2,1,13,3,0,3,81
548352,2,1,13,2,2,4,86
548362,2,1,13,11,2,13,107
548368,2,1,13,12,1,13,95
548386,2,1,13,8,0,8,129
598003,2,1,13,6,0,6,93
598010,2,1,13,15,0,15,77
598021,2,1,13,9,0,9,106
598036,2,1,13,14,0,14,101
598039,2,1,13,8,0,8,107
598048,2,1,13,2,0,2,102
598055,2,1,13,2,0,2,79
598062,2,1,13,6,0,6,74
598066,2,1,13,9,0,9,105
729312,2,1,13,5,0,5,62
729320,2,1,13,11,1,12,85
733976,2,1,13,10,0,10,84
733984,2,1,13,15,1,16,114
733990,2,1,13,9,0,9,116
734002,2,1,13,8,0,8,110
734014,2,1,13,3,0,3,88
734020,2,1,13,7,0,7,88
734028,2,1,13,2,0,2,101
734042,2,1,13,26,0,26,142
734054,2,1,13,18,0,18,128
829710,2,1,13,9,0,9,107
829728,2,1,13,5,0,5,91
829738,2,1,13,19,0,19,103
829744,2,1,13,6,0,6,102
829770,2,1,13,3,1,4,80
829796,2,1,13,16,0,16,102
829810,2,1,13,10,0,10,106
829816,2,1,13,13,2,15,131
980908,2,1,13,2,0,2,84
980920,2,1,13,2,0,2,93
980930,2,1,13,3,0,3,110
980944,2,1,13,8,0,8,97
980956,2,1,13,3,0,3,102
980964,2,1,13,9,0,9,93
981020,2,1,13,11,0,11,92
1082593,2,1,13,6,0,6,153
1082601,2,1,13,8,0,8,136
1082608,2,1,13,11,0,11,110
1082620,2,1,13,6,6,12,135
1082622,2,1,13,12,0,12,125
1082627,2,1,13,3,0,3,110
1082636,2,1,13,11,0,11,152
1082639,2,1,13,11,0,11,97
1082644,2,1,13,11,0,11,126
335997,1,2,13,10,0,10,88
336011,1,2,13,3,0,3,72
336017,1,2,13,7,0,7,82
336021,1,2,13,10,0,10,91
336031,1,2,13,6,1,7,86
336034,1,2,13,6,0,6,58
336039,1,2,13,10,0,10,103
392187,1,2,13,7,0,7,70
392196,1,2,13,4,0,4,91
392199,1,2,13,5,0,5,86
392209,1,2,13,4,0,4,84
392218,1,2,13,3,0,3,63
392241,1,2,13,5,0,5,95
419114,1,2,13,5,0,5,78
419128,1,2,13,8,0,8,94
419138,1,2,13,10,0,10,104
419150,1,2,13,10,0,10,87
501210,1,2,13,7,0,7,71
501237,1,2,13,6,0,6,100
501249,1,2,13,9,0,9,135
501273,1,2,13,8,0,8,94
501275,1,2,13,10,1,11,130
548315,1,2,13,6,0,6,91
548323,1,2,13,4,0,4,122
548341,1,2,13,14,0,14,89
548355,1,2,13,18,1,19,101
548367,1,2,13,2,0,2,99
548372,1,2,13,2,0,2,90
548377,1,2,13,12,0,12,108
598004,1,2,13,7,0,7,82
598009,1,2,13,12,0,12,78
598017,1,2,13,12,0,12,86
598032,1,2,13,10,0,10,161
598041,1,2,13,0,0,0,99
598047,1,2,13,3,0,3,99
598050,1,2,13,8,2,10,79
598059,1,2,13,6,0,6,89
598062,1,2,13,7,0,7,70
598069,1,2,13,7,0,7,115
729310,1,2,13,4,0,4,55
729318,1,2,13,12,1,13,93
734004,1,2,13,13,1,14,84
734010,1,2,13,3,0,3,95
734026,1,2,13,4,3,7,86
734040,1,2,13,10,0,10,83
829724,1,2,13,4,0,4,97
829768,1,2,13,5,2,7,110
829790,1,2,13,16,2,18,141
829800,1,2,13,7,0,7,121
829824,1,2,13,6,0,6,88
829826,1,2,13,1,1,2,67
980912,1,2,13,14,1,15,126
980926,1,2,13,5,0,5,114
980932,1,2,13,2,0,2,98
980936,1,2,13,5,0,5,111
980942,1,2,13,7,0,7,92
980964,1,2,13,9,0,9,106
980982,1,2,13,10,0,10,95
980986,1,2,13,3,0,3,69
980992,1,2,13,12,0,12,111
981004,1,2,13,15,0,15,181
1082595,1,2,13,24,0,24,98
1082598,1,2,13,3,0,3,68
1082602,1,2,13,5,4,9,85
1082610,1,2,13,6,0,6,125
1082621,1,2,13,7,4,11,88
1082628,1,2,13,10,0,10,106
1082636,1,2,13,6,0,6,84
1082646,1,2,13,6,0,6,96
335987,2,2,13,9,2,11,70
335990,2,2,13,10,0,10,104
336001,2,2,13,8,0,8,119
336003,2,2,13,7,4,11,118
336007,2,2,13,5,0,5,88
336015,2,2,13,14,1,15,91
336028,2,2,13,17,2,19,69
392190,2,2,13,7,0,7,78
392193,2,2,13,6,0,6,81
392204,2,2,13,3,0,3,78
392213,2,2,13,5,0,5,92
392223,2,2,13,11,0,11,85
392226,2,2,13,14,0,14,94
392229,2,2,13,10,0,10,76
392237,2,2,13,5,1,6,76
392243,2,2,13,4,0,4,96
392244,2,2,13,11,1,12,91
419117,2,2,13,25,0,25,139
419124,2,2,13,10,0,10,110
419133,2,2,13,9,1,10,100
419141,2,2,13,8,0,8,101
419145,2,2,13,8,0,8,85
419153,2,2,13,16,0,16,101
419156,2,2,13,11,0,11,93
419159,2,2,13,2,0,2,116
419162,2,2,13,5,0,5,83
419167,2,2,13,4,2,6,106
419169,2,2,13,7,0,7,78
501205,2,2,13,9,0,9,100
501213,2,2,13,9,1,10,73
501216,2,2,13,9,1,10,95
501227,2,2,13,7,1,8,131
501232,2,2,13,3,0,3,108
501252,2,2,13,6,0,6,124
501257,2,2,13,11,0,11,108
501260,2,2,13,4,2,6,105
501265,2,2,13,5,0,5,89
501271,2,2,13,7,0,7,95
501276,2,2,13,3,1,4,92
548320,2,2,13,6,1,7,68
548329,2,2,13,10,0,10,92
548332,2,2,13,31,0,31,107
548336,2,2,13,12,0,12,98
548349,2,2,13,15,0,15,78
548361,2,2,13,5,0,5,102
548365,2,2,13,14,1,15,94
548381,2,2,13,4,0,4,66
598013,2,2,13,6,0,6,110
598022,2,2,13,3,0,3,106
598028,2,2,13,3,0,3,85
598038,2,2,13,3,0,3,81
598053,2,2,13,5,0,5,101
729286,2,2,13,3,0,3,89
729292,2,2,13,10,0,10,75
729304,2,2,13,10,0,10,103
733982,2,2,13,6,0,6,79
733988,2,2,13,2,0,2,118
733996,2,2,13,3,0,3,88
734018,2,2,13,4,1,5,71
734032,2,2,13,3,0,3,93
829718,2,2,13,10,0,10,113
829742,2,2,13,22,2,24,119
829750,2,2,13,3,0,3,89
829754,2,2,13,5,0,5,98
829784,2,2,13,7,0,7,93
980958,2,2,13,11,0,11,103
980974,2,2,13,5,1,6,103
981000,2,2,13,10,1,11,112
981016,2,2,13,8,0,8,96
981018,2,2,13,3,0,3,92
981024,2,2,13,12,0,12,141
1082591,2,2,13,8,0,8,126
1082607,2,2,13,5,0,5,83
1082624,2,2,13,1,0,1,61
1082633,2,2,13,7,2,9,84
335988,1,3,13,4,2,6,133
335994,1,3,13,11,0,11,123
336001,1,3,13,3,0,3,86
336006,1,3,13,8,0,8,114
336010,1,3,13,8,0,8,84
336012,1,3,13,4,0,4,81
336018,1,3,13,14,1,15,124
336023,1,3,13,6,1,7,73
336045,1,3,13,10,0,10,97
392190,1,3,13,5,0,5,116
392201,1,3,13,3,0,3,103
392207,1,3,13,3,0,3,89
392211,1,3,13,7,0,7,113
392214,1,3,13,6,0,6,105
392219,1,3,13,5,0,5,105
392229,1,3,13,8,0,8,101
392236,1,3,13,12,1,13,111
392239,1,3,13,6,0,6,85
392243,1,3,13,12,0,12,96
419118,1,3,13,9,0,9,77
419130,1,3,13,10,1,11,112
419142,1,3,13,16,0,16,129
419147,1,3,13,5,1,6,111
419152,1,3,13,5,2,7,90
419160,1,3,13,3,0,3,65
419168,1,3,13,5,1,6,80
419170,1,3,13,12,0,12,80
501203,1,3,13,5,0,5,95
501211,1,3,13,10,0,10,104
501216,1,3,13,3,0,3,107
501220,1,3,13,7,0,7,94
501231,1,3,13,11,0,11,85
501241,1,3,13,6,0,6,83
501250,1,3,13,4,0,4,59
501254,1,3,13,15,0,15,117
501258,1,3,13,10,0,10,95
501266,1,3,13,4,0,4,82
501271,1,3,13,8,4,12,60
501276,1,3,13,10,0,10,131
548311,1,3,13,2,0,2,86
548316,1,3,13,4,0,4,97
548321,1,3,13,1,0,1,73
548327,1,3,13,12,0,12,100
548335,1,3,13,6,0,6,89
548352,1,3,13,4,0,4,88
548357,1,3,13,7,1,8,109
548360,1,3,13,14,0,14,106
548376,1,3,13,2,0,2,59
548384,1,3,13,11,1,12,94
548385,1,3,13,12,0,12,127
548386,1,3,13,5,2,7,111
598025,1,3,13,11,0,11,94
598039,1,3,13,13,0,13,127
598043,1,3,13,13,0,13,81
598046,1,3,13,8,0,8,99
598056,1,3,13,5,0,5,116
598063,1,3,13,3,0,3,89
598067,1,3,13,4,0,4,92
598075,1,3,13,13,0,13,107
729288,1,3,13,12,0,12,128
729298,1,3,13,4,0,4,94
729302,1,3,13,4,0,4,85
733976,1,3,13,6,0,6,108
734018,1,3,13,15,0,15,92
734028,1,3,13,9,0,9,80
734034,1,3,13,3,0,3,98
829712,1,3,13,9,0,9,105
829716,1,3,13,14,0,14,133
829728,1,3,13,3,0,3,104
829740,1,3,13,4,0,4,89
829750,1,3,13,19,0,19,124
829758,1,3,13,10,0,10,126
829770,1,3,13,3,0,3,88
829784,1,3,13,10,0,10,89
829794,1,3,13,4,0,4,84
829802,1,3,13,9,0,9,83
829806,1,3,13,5,0,5,65
335998,2,3,13,4,1,5,95
336014,2,3,13,7,1,8,115
336034,2,3,13,14,1,15,84
336038,2,3,13,12,0,12,141
336042,2,3,13,8,0,8,96
336044,2,3,13,10,0,10,90
392186,2,3,13,8,0,8,91
392194,2,3,13,7,1,8,132
392207,2,3,13,4,0,4,83
392222,2,3,13,2,1,3,80
392232,2,3,13,9,5,14,84
419115,2,3,13,7,0,7,89
419121,2,3,13,7,3,10,139
419126,2,3,13,2,1,3,97
419128,2,3,13,7,0,7,80
419134,2,3,13,7,0,7,97
419138,2,3,13,4,0,4,111
419158,2,3,13,9,1,10,136
419164,2,3,13,7,0,7,116
501226,2,3,13,1,0,1,102
501233,2,3,13,9,0,9,89
501245,2,3,13,12,0,12,109
501273,2,3,13,21,2,23,94
548323,2,3,13,15,0,15,112
548337,2,3,13,5,0,5,88
548348,2,3,13,3,2,5,88
548366,2,3,13,1,0,1,61
548369,2,3,13,6,0,6,93
548373,2,3,13,4,0,4,108
598007,2,3,13,4,0,4,70
598012,2,3,13,14,0,14,88
598017,2,3,13,3,1,4,82
598020,2,3,13,8,0,8,86
598027,2,3,13,4,0,4,60
598031,2,3,13,5,0,5,114
598035,2,3,13,12,0,12,98
598051,2,3,13,1,0,1,55
598078,2,3,13,8,0,8,67
729308,2,3,13,10,0,10,95
729316,2,3,13,8,0,8,102
733986,2,3,13,9,2,11,103
733992,2,3,13,5,0,5,103
734000,2,3,13,7,0,7,92
734008,2,3,13,8,0,8,95
734040,2,3,13,4,0,4,99
734050,2,3,13,6,0,6,109
734052,2,3,13,3,0,3,143
829734,2,3,13,3,0,3,146
829778,2,3,13,5,0,5,115
829814,2,3,13,5,0,5,97
829822,2,3,13,4,0,4,99
829826,2,3,13,10,0,10,82
829828,2,3,13,9,0,9,98
335992,1,4,13,4,0,4,101
335996,1,4,13,6,0,6,116
336008,1,4,13,1,1,2,104
336024,1,4,13,7,0,7,122
336033,1,4,13,13,0,13,114
336040,1,4,13,4,0,4,108
336044,1,4,13,5,0,5,61
392191,1,4,13,6,0,6,101
392200,1,4,13,5,0,5,76
392205,1,4,13,10,5,15,75
392227,1,4,13,3,0,3,83
392234,1,4,13,5,1,6,74
419113,1,4,13,12,0,12,103
419117,1,4,13,13,2,15,119
419126,1,4,13,8,1,9,87
419137,1,4,13,6,0,6,101
419141,1,4,13,9,0,9,97
419148,1,4,13,2,1,3,112
419161,1,4,13,1,0,1,88
419164,1,4,13,14,0,14,107
501207,1,4,13,5,0,5,57
501225,1,4,13,8,0,8,132
501239,1,4,13,6,0,6,72
501253,1,4,13,3,0,3,82
501256,1,4,13,8,0,8,108
501262,1,4,13,25,0,25,111
501265,1,4,13,7,0,7,132
548328,1,4,13,1,1,2,75
548333,1,4,13,8,0,8,83
548336,1,4,13,7,1,8,89
548344,1,4,13,4,1,5,80
548348,1,4,13,8,0,8,105
548364,1,4,13,11,0,11,108
548374,1,4,13,9,0,9,89
548379,1,4,13,10,0,10,73
598012,1,4,13,9,0,9,97
598019,1,4,13,3,0,3,75
598021,1,4,13,8,0,8,86
598026,1,4,13,3,0,3,79
598033,1,4,13,2,0,2,88
598036,1,4,13,13,0,13,98
598057,1,4,13,7,0,7,100
598071,1,4,13,18,0,18,108
729300,1,4,13,25,0,25,123
729312,1,4,13,5,0,5,99
733978,1,4,13,8,0,8,101
733992,1,4,13,21,0,21,121
733996,1,4,13,14,1,15,131
734002,1,4,13,6,0,6,102
734030,1,4,13,4,0,4,101
734038,1,4,13,10,0,10,113
734052,1,4,13,15,2,17,148
734054,1,4,13,9,1,10,92
829722,1,4,13,6,0,6,105
829730,1,4,13,8,0,8,100
829738,1,4,13,4,0,4,95
829772,1,4,13,3,1,4,56
829796,1,4,13,9,2,11,99
829814,1,4,13,3,0,3,71
980910,1,4,13,5,0,5,107
980918,1,4,13,2,0,2,65
980930,1,4,13,4,2,6,78
980940,1,4,13,10,2,12,89
980960,1,4,13,6,0,6,100
980976,1,4,13,8,0,8,101
980996,1,4,13,7,2,9,102
981010,1,4,13,14,0,14,102
1082601,1,4,13,6,0,6,104
1082612,1,4,13,7,2,9,100
1082616,1,4,13,10,0,10,114
1082633,1,4,13,6,1,7,70
1082637,1,4,13,10,0,10,109
1082639,1,4,13,10,1,11,97
1082641,1,4,13,6,0,6,147
1082645,1,4,13,5,0,5,69
335988,2,4,13,12,2,14,141
336000,2,4,13,11,0,11,114
336004,2,4,13,7,0,7,108
336011,2,4,13,6,0,6,99
336018,2,4,13,2,0,2,97
336021,2,4,13,9,0,9,110
336036,2,4,13,4,0,4,119
392196,2,4,13,3,0,3,94
392209,2,4,13,4,0,4,84
392212,2,4,13,5,3,8,102
392215,2,4,13,8,0,8,82
392219,2,4,13,10,0,10,125
392221,2,4,13,10,0,10,111
392231,2,4,13,7,0,7,67
392239,2,4,13,2,0,2,49
419122,2,4,13,2,1,3,71
419129,2,4,13,3,0,3,115
419132,2,4,13,7,0,7,89
419144,2,4,13,8,0,8,144
419151,2,4,13,9,0,9,102
419154,2,4,13,3,0,3,71
501211,2,4,13,12,0,12,131
501217,2,4,13,16,0,16,132
501228,2,4,13,10,0,10,127
501242,2,4,13,3,1,4,82
501249,2,4,13,4,0,4,74
501259,2,4,13,16,0,16,131
501269,2,4,13,4,0,4,90
548314,2,4,13,12,0,12,99
548318,2,4,13,3,0,3,75
548324,2,4,13,4,0,4,75
548339,2,4,13,10,0,10,96
548355,2,4,13,17,0,17,115
548359,2,4,13,2,2,4,82
548371,2,4,13,3,0,3,102
548376,2,4,13,5,0,5,81
598008,2,4,13,0,1,1,100
598030,2,4,13,8,1,9,111
598042,2,4,13,15,0,15,110
598046,2,4,13,11,0,11,103
598050,2,4,13,12,0,12,111
598061,2,4,13,5,4,9,71
598064,2,4,13,4,0,4,97
598069,2,4,13,5,0,5,95
729288,2,4,13,21,1,22,138
729296,2,4,13,18,0,18,120
729318,2,4,13,4,0,4,88
734012,2,4,13,3,0,3,159
734024,2,4,13,7,0,7,114
734044,2,4,13,10,0,10,111
734048,2,4,13,6,0,6,86
829714,2,4,13,11,0,11,92
829746,2,4,13,13,0,13,100
829758,2,4,13,4,0,4,72
829764,2,4,13,4,0,4,75
829780,2,4,13,7,0,7,97
829790,2,4,13,4,0,4,82
829804,2,4,13,4,0,4,83
980924,2,4,13,4,0,4,100
980946,2,4,13,6,1,7,102
980968,2,4,13,5,0,5,98
980982,2,4,13,11,0,11,104
980990,2,4,13,13,1,14,88
981004,2,4,13,4,0,4,109
1082594,2,4,13,14,1,15,103
1082598,2,4,13,7,1,8,127
1082605,2,4,13,4,0,4,85
1082609,2,4,13,13,0,13,80
1082623,2,4,13,19,0,19,115
335989,1,5,13,7,2,9,76
336005,1,5,13,7,1,8,119
336013,1,5,13,8,1,9,94
336028,1,5,13,5,0,5,114
336038,1,5,13,3,0,3,140
336043,1,5,13,7,0,7,120
392195,1,5,13,7,1,8,93
392215,1,5,13,6,0,6,119
392222,1,5,13,1,0,1,75
392230,1,5,13,9,0,9,93
392238,1,5,13,6,0,6,69
419116,1,5,13,6,0,6,79
419120,1,5,13,5,1,6,68
419123,1,5,13,2,0,2,105
419129,1,5,13,9,2,11,111
419134,1,5,13,7,0,7,118
419146,1,5,13,6,0,6,107
419159,1,5,13,2,4,6,72
419163,1,5,13,12,0,12,96
501214,1,5,13,4,0,4,83
501219,1,5,13,5,0,5,78
501245,1,5,13,3,0,3,95
501257,1,5,13,8,0,8,94
501263,1,5,13,1,0,1,81
548314,1,5,13,7,0,7,102
548317,1,5,13,7,0,7,88
548325,1,5,13,4,0,4,77
548329,1,5,13,7,0,7,82
548337,1,5,13,4,1,5,81
548354,1,5,13,3,0,3,95
548359,1,5,13,5,1,6,116
548366,1,5,13,4,0,4,75
548370,1,5,13,15,0,15,109
548378,1,5,13,6,1,7,80
548382,1,5,13,6,0,6,91
598006,1,5,13,12,0,12,103
598010,1,5,13,10,0,10,79
598014,1,5,13,4,1,5,88
598024,1,5,13,4,1,5,114
598028,1,5,13,7,0,7,81
598031,1,5,13,9,0,9,112
598048,1,5,13,11,0,11,90
598077,1,5,13,5,1,6,93
729296,1,5,13,9,0,9,128
729320,1,5,13,5,0,5,82
733984,1,5,13,9,0,9,101
734008,1,5,13,9,0,9,102
734016,1,5,13,6,1,7,115
734046,1,5,13,16,0,16,106
829714,1,5,13,4,1,5,88
829746,1,5,13,15,0,15,114
829754,1,5,13,2,0,2,89
829782,1,5,13,9,0,9,97
829816,1,5,13,7,0,7,122
335992,2,5,13,12,0,12,114
335995,2,5,13,8,0,8,134
335997,2,5,13,8,0,8,91
336010,2,5,13,12,0,12,104
336016,2,5,13,9,1,10,111
336020,2,5,13,3,1,4,102
336024,2,5,13,11,0,11,109
336032,2,5,13,8,0,8,105
336041,2,5,13,3,0,3,80
336045,2,5,13,15,0,15,102
392187,2,5,13,5,0,5,52
392200,2,5,13,4,0,4,70
392203,2,5,13,19,0,19,86
392207,2,5,13,3,0,3,86
392210,2,5,13,4,0,4,89
392218,2,5,13,8,1,9,85
392225,2,5,13,4,0,4,82
392235,2,5,13,2,0,2,81
419112,2,5,13,15,2,17,131
419131,2,5,13,16,0,16,121
419139,2,5,13,8,0,8,93
419142,2,5,13,18,1,19,143
419148,2,5,13,8,0,8,140
419155,2,5,13,5,0,5,74
501204,2,5,13,6,0,6,83
501209,2,5,13,11,0,11,109
501225,2,5,13,13,0,13,99
501230,2,5,13,16,0,16,92
501236,2,5,13,4,0,4,60
501240,2,5,13,13,0,13,81
501254,2,5,13,10,1,11,96
501268,2,5,13,10,0,10,130
548322,2,5,13,16,0,16,115
548331,2,5,13,8,1,9,119
548341,2,5,13,2,1,3,91
548350,2,5,13,9,0,9,94
548363,2,5,13,8,0,8,103
598019,2,5,13,3,0,3,79
598037,2,5,13,4,0,4,82
598041,2,5,13,9,1,10,105
598052,2,5,13,7,0,7,106
598054,2,5,13,8,0,8,105
598057,2,5,13,3,0,3,95
598063,2,5,13,10,0,10,92
598068,2,5,13,6,4,10,92
598070,2,5,13,6,2,8,59
598076,2,5,13,3,0,3,73
729290,2,5,13,6,0,6,81
729302,2,5,13,9,0,9,75
729310,2,5,13,10,0,10,71
733980,2,5,13,15,0,15,101
733994,2,5,13,3,0,3,73
734004,2,5,13,8,0,8,99
734022,2,5,13,5,0,5,80
734038,2,5,13,4,2,6,83
829720,2,5,13,18,1,19,104
829726,2,5,13,7,0,7,92
829732,2,5,13,3,0,3,80
829740,2,5,13,5,0,5,115
829774,2,5,13,6,0,6,115
829792,2,5,13,14,0,14,107
829802,2,5,13,9,1,10,85
829824,2,5,13,4,0,4,83
336000,1,6,13,6,0,6,94
336003,1,6,13,6,0,6,119
336014,1,6,13,3,3,6,106
336020,1,6,13,8,0,8,89
336025,1,6,13,13,0,13,112
392194,1,6,13,4,0,4,109
392203,1,6,13,11,1,12,94
392228,1,6,13,4,0,4,94
392231,1,6,13,4,0,4,71
392235,1,6,13,7,0,7,78
392237,1,6,13,4,0,4,77
392242,1,6,13,8,0,8,94
419121,1,6,13,10,0,10,115
419133,1,6,13,8,1,9,112
419136,1,6,13,5,0,5,110
419139,1,6,13,9,0,9,100
419145,1,6,13,4,0,4,115
419154,1,6,13,5,0,5,75
501206,1,6,13,4,1,5,73
501209,1,6,13,8,0,8,70
501228,1,6,13,3,1,4,151
501232,1,6,13,12,0,12,97
501238,1,6,13,15,0,15,75
501243,1,6,13,9,0,9,85
548347,1,6,13,10,3,13,135
548350,1,6,13,4,0,4,99
548362,1,6,13,6,0,6,95
548369,1,6,13,11,0,11,71
598003,1,6,13,8,0,8,87
598015,1,6,13,5,1,6,64
598022,1,6,13,8,0,8,84
598040,1,6,13,12,0,12,92
598049,1,6,13,5,0,5,61
598054,1,6,13,6,0,6,84
598064,1,6,13,7,0,7,82
729286,1,6,13,10,1,11,74
733980,1,6,13,6,0,6,86
733986,1,6,13,12,0,12,108
733990,1,6,13,8,1,9,94
733998,1,6,13,8,3,11,102
734024,1,6,13,7,0,7,99
734044,1,6,13,6,0,6,92
829720,1,6,13,8,0,8,106
829736,1,6,13,7,1,8,103
829744,1,6,13,6,0,6,87
829752,1,6,13,11,0,11,112
829762,1,6,13,0,0,0,67
829788,1,6,13,8,0,8,88
829818,1,6,13,6,0,6,118
980908,1,6,13,4,0,4,84
980938,1,6,13,8,0,8,92
980956,1,6,13,7,0,7,99
980970,1,6,13,17,1,18,101
981002,1,6,13,5,0,5,62
981016,1,6,13,5,2,7,89
1082599,1,6,13,4,0,4,108
1082605,1,6,13,6,0,6,103
1082608,1,6,13,6,0,6,104
1082622,1,6,13,15,0,15,108
1082626,1,6,13,6,1,7,58
1082642,1,6,13,4,0,4,109
335989,2,6,13,6,5,11,111
335993,2,6,13,30,0,30,142
336006,2,6,13,5,0,5,123
336009,2,6,13,11,0,11,101
336022,2,6,13,7,0,7,80
336031,2,6,13,3,1,4,118
336037,2,6,13,13,0,13,111
336043,2,6,13,2,0,2,77
392199,2,6,13,7,0,7,84
392206,2,6,13,8,0,8,93
392211,2,6,13,14,0,14,100
392216,2,6,13,6,0,6,98
392220,2,6,13,2,0,2,62
392224,2,6,13,2,2,4,87
392240,2,6,13,14,0,14,128
419113,2,6,13,6,1,7,85
419116,2,6,13,2,0,2,115
419119,2,6,13,1,0,1,113
419125,2,6,13,3,0,3,100
419149,2,6,13,14,0,14,118
419157,2,6,13,3,0,3,97
419160,2,6,13,7,5,12,73
419165,2,6,13,3,0,3,72
501218,2,6,13,1,0,1,116
501221,2,6,13,6,2,8,94
501235,2,6,13,7,2,9,75
501248,2,6,13,11,1,12,119
501251,2,6,13,15,0,15,91
501258,2,6,13,9,0,9,90
501262,2,6,13,14,1,15,89
548315,2,6,13,4,0,4,80
548321,2,6,13,10,0,10,108
548326,2,6,13,21,0,21,104
548330,2,6,13,6,0,6,80
548334,2,6,13,9,0,9,138
548338,2,6,13,6,0,6,120
548342,2,6,13,8,1,9,124
548354,2,6,13,11,1,12,122
548374,2,6,13,6,0,6,88
548377,2,6,13,13,0,13,129
548379,2,6,13,7,0,7,113
548383,2,6,13,5,0,5,100
548385,2,6,13,3,1,4,111
598006,2,6,13,10,0,10,100
598011,2,6,13,5,6,11,113
598025,2,6,13,4,0,4,71
598029,2,6,13,12,0,12,126
598033,2,6,13,6,0,6,72
598045,2,6,13,7,0,7,85
598059,2,6,13,3,1,4,109
598067,2,6,13,7,0,7,90
598072,2,6,13,9,0,9,92
729294,2,6,13,7,0,7,104
729298,2,6,13,2,0,2,76
729306,2,6,13,11,0,11,110
729314,2,6,13,3,0,3,76
734010,2,6,13,5,0,5,102
734016,2,6,13,9,0,9,85
734036,2,6,13,7,2,9,91
829712,2,6,13,4,1,5,87
829730,2,6,13,8,0,8,97
829766,2,6,13,10,0,10,95
829772,2,6,13,11,0,11,112
829782,2,6,13,14,0,14,101
829798,2,6,13,9,0,9,82
829806,2,6,13,10,0,10,92
980918,2,6,13,6,0,6,102
980926,2,6,13,10,1,11,116
980950,2,6,13,16,0,16,88
980966,2,6,13,9,0,9,114
980976,2,6,13,5,1,6,111
980988,2,6,13,3,0,3,94
980998,2,6,13,6,0,6,96
981008,2,6,13,9,0,9,92
1082595,2,6,13,12,1,13,107
1082611,2,6,13,10,0,10,105
1082614,2,6,13,8,1,9,78
1082630,2,6,13,16,0,16,125
1082632,2,6,13,11,1,12,165
1082635,2,6,13,2,0,2,66
1082640,2,6,13,9,0,9,119
1082646,2,6,13,3,0,3,90
335990,1,7,13,3,0,3,97
335999,1,7,13,8,0,8,69
336009,1,7,13,9,1,10,102
336029,1,7,13,4,2,6,97
336037,1,7,13,2,0,2,109
336041,1,7,13,7,1,8,83
392186,1,7,13,9,0,9,93
392202,1,7,13,8,0,8,131
392208,1,7,13,3,0,3,76
392213,1,7,13,10,0,10,77
392220,1,7,13,6,1,7,58
392223,1,7,13,3,0,3,85
392232,1,7,13,5,0,5,84
392240,1,7,13,6,5,11,101
419112,1,7,13,8,0,8,129
419119,1,7,13,11,0,11,136
419124,1,7,13,9,0,9,89
419135,1,7,13,1,0,1,93
419143,1,7,13,6,0,6,90
419151,1,7,13,5,0,5,92
419155,1,7,13,4,1,5,96
419157,1,7,13,11,0,11,91
419162,1,7,13,9,0,9,103
419166,1,7,13,3,0,3,77
419167,1,7,13,5,0,5,93
501215,1,7,13,7,1,8,99
501226,1,7,13,4,1,5,91
501229,1,7,13,9,0,9,87
501236,1,7,13,2,4,6,61
501242,1,7,13,5,0,5,97
501246,1,7,13,7,0,7,87
501251,1,7,13,10,1,11,107
501268,1,7,13,3,1,4,70
548322,1,7,13,8,1,9,105
548330,1,7,13,6,1,7,69
548339,1,7,13,12,0,12,96
548356,1,7,13,6,0,6,87
548365,1,7,13,13,0,13,73
548368,1,7,13,7,0,7,111
598007,1,7,13,7,0,7,90
598011,1,7,13,13,0,13,113
598016,1,7,13,2,0,2,92
598029,1,7,13,12,1,13,83
598038,1,7,13,9,0,9,119
598042,1,7,13,13,0,13,93
598044,1,7,13,6,0,6,80
598051,1,7,13,9,0,9,75
598055,1,7,13,9,0,9,93
598068,1,7,13,5,0,5,110
598078,1,7,13,9,1,10,84
729292,1,7,13,5,1,6,78
729308,1,7,13,15,0,15,88
729314,1,7,13,5,0,5,59
733988,1,7,13,6,0,6,101
734000,1,7,13,8,0,8,86
734014,1,7,13,6,0,6,76
734022,1,7,13,11,0,11,107
734036,1,7,13,10,0,10,130
734050,1,7,13,9,0,9,108
829710,1,7,13,7,0,7,76
829726,1,7,13,9,0,9,61
829734,1,7,13,14,0,14,98
829742,1,7,13,10,3,13,114
829756,1,7,13,12,0,12,104
829774,1,7,13,4,0,4,99
829780,1,7,13,5,0,5,115
829810,1,7,13,6,0,6,86
829822,1,7,13,9,0,9,110
829828,1,7,13,5,0,5,125
980906,1,7,13,5,0,5,62
980922,1,7,13,9,0,9,77
980928,1,7,13,4,1,5,72
980946,1,7,13,12,1,13,114
980990,1,7,13,3,0,3,56
980998,1,7,13,23,0,23,120
981012,1,7,13,11,0,11,114
1082592,1,7,13,9,2,11,106
1082614,1,7,13,1,1,2,84
1082635,1,7,13,13,0,13,122
1082638,1,7,13,8,0,8,80
1082644,1,7,13,5,0,5,99
1082650,1,7,13,10,0,10,76
335994,2,7,13,10,1,11,110
335996,2,7,13,4,0,4,94
336002,2,7,13,8,0,8,98
336013,2,7,13,11,0,11,84
336017,2,7,13,6,0,6,102
336023,2,7,13,12,0,12,132
336033,2,7,13,19,0,19,127
392197,2,7,13,6,0,6,96
392202,2,7,13,1,0,1,81
392205,2,7,13,9,2,11,67
392217,2,7,13,6,0,6,93
392227,2,7,13,7,0,7,100
392230,2,7,13,11,1,12,76
419119,2,7,13,2,0,2,115
419127,2,7,13,14,0,14,106
419130,2,7,13,13,0,13,119
419137,2,7,13,3,5,8,100
419147,2,7,13,4,0,4,86
419170,2,7,13,7,0,7,80
501206,2,7,13,3,0,3,69
501210,2,7,13,10,0,10,99
501223,2,7,13,3,0,3,81
501256,2,7,13,6,1,7,87
501261,2,7,13,8,2,10,66
501272,2,7,13,3,0,3,97
501274,2,7,13,5,0,5,104
501275,2,7,13,4,0,4,91
548311,2,7,13,5,0,5,92
548313,2,7,13,2,0,2,59
548319,2,7,13,9,0,9,69
548344,2,7,13,10,2,12,83
548347,2,7,13,3,0,3,115
548351,2,7,13,4,0,4,67
548360,2,7,13,8,0,8,106
548372,2,7,13,13,1,14,91
548375,2,7,13,2,2,4,67
548382,2,7,13,13,0,13,118
548384,2,7,13,3,1,4,101
598004,2,7,13,11,0,11,85
598024,2,7,13,5,0,5,62
598034,2,7,13,14,0,14,104
598060,2,7,13,4,0,4,67
598065,2,7,13,4,0,4,99
598071,2,7,13,5,0,5,83
598075,2,7,13,8,0,8,109
598077,2,7,13,12,1,13,112
729284,2,7,13,12,0,12,83
729322,2,7,13,19,0,19,86
733978,2,7,13,20,0,20,109
734006,2,7,13,12,0,12,105
734030,2,7,13,1,1,2,114
734046,2,7,13,13,0,13,170
829722,2,7,13,8,0,8,54
829752,2,7,13,10,1,11,100
829788,2,7,13,7,1,8,85
829794,2,7,13,5,0,5,91
829800,2,7,13,12,0,12,125
829820,2,7,13,3,0,3,105
980914,2,7,13,4,0,4,113
980932,2,7,13,12,0,12,109
980938,2,7,13,6,0,6,104
980952,2,7,13,4,0,4,106
980962,2,7,13,5,0,5,98
980978,2,7,13,8,0,8,70
980986,2,7,13,3,0,3,79
1082597,2,7,13,8,0,8,105
1082600,2,7,13,10,1,11,108
1082602,2,7,13,5,0,5,70
1082606,2,7,13,5,0,5,106
1082612,2,7,13,15,1,16,166
1082618,2,7,13,8,0,8,94
1082625,2,7,13,11,0,11,104
1082628,2,7,13,8,0,8,98
1082641,2,7,13,3,0,3,123
1082647,2,7,13,4,0,4,85
1082649,2,7,13,3,0,3,91
335991,1,8,13,3,0,3,62
335993,1,8,13,2,0,2,62
335995,1,8,13,10,0,10,118
336004,1,8,13,3,0,3,93
336007,1,8,13,1,0,1,109
336016,1,8,13,9,0,9,96
336036,1,8,13,3,0,3,91
336042,1,8,13,6,0,6,71
392193,1,8,13,20,0,20,127
392197,1,8,13,11,1,12,125
392206,1,8,13,20,0,20,97
392210,1,8,13,12,0,12,82
392217,1,8,13,4,1,5,85
392221,1,8,13,11,0,11,85
392225,1,8,13,3,0,3,89
392244,1,8,13,5,0,5,74
419115,1,8,13,5,2,7,106
419122,1,8,13,2,0,2,115
419125,1,8,13,7,0,7,102
419131,1,8,13,2,1,3,101
419156,1,8,13,4,0,4,99
419165,1,8,13,13,0,13,112
419169,1,8,13,10,0,10,62
501204,1,8,13,2,0,2,77
501213,1,8,13,8,1,9,99
501217,1,8,13,5,0,5,96
501221,1,8,13,6,0,6,112
501234,1,8,13,13,0,13,71
501248,1,8,13,4,1,5,92
501255,1,8,13,5,0,5,86
501261,1,8,13,3,0,3,71
501269,1,8,13,20,0,20,129
548319,1,8,13,2,1,3,83
548326,1,8,13,4,0,4,110
548331,1,8,13,2,1,3,108
548334,1,8,13,16,0,16,101
548340,1,8,13,3,0,3,87
548346,1,8,13,5,0,5,99
548351,1,8,13,2,0,2,66
548353,1,8,13,10,0,10,85
548361,1,8,13,6,0,6,93
548371,1,8,13,12,0,12,114
548381,1,8,13,7,1,8,61
336012,2,8,13,6,1,7,101
336019,2,8,13,8,0,8,99
336025,2,8,13,2,0,2,114
336029,2,8,13,10,0,10,82
336039,2,8,13,7,0,7,97
392189,2,8,13,8,1,9,100
392201,2,8,13,6,0,6,113
392214,2,8,13,2,0,2,97
392228,2,8,13,10,2,12,111
392233,2,8,13,2,0,2,87
392234,2,8,13,5,1,6,79
392241,2,8,13,6,1,7,105
392242,2,8,13,11,0,11,131
419111,2,8,13,2,4,6,108
419135,2,8,13,9,0,9,100
419140,2,8,13,9,0,9,107
419143,2,8,13,3,0,3,85
419146,2,8,13,7,0,7,108
419150,2,8,13,5,0,5,102
419152,2,8,13,11,1,12,80
419161,2,8,13,10,0,10,120
419168,2,8,13,3,1,4,58
501208,2,8,13,3,1,4,84
501229,2,8,13,10,0,10,91
501241,2,8,13,7,0,7,108
501244,2,8,13,11,0,11,90
501264,2,8,13,5,0,5,89
548316,2,8,13,7,0,7,95
548357,2,8,13,3,0,3,88
548364,2,8,13,6,0,6,81
548378,2,8,13,2,1,3,88
501205,1,9,13,5,6,11,110
501212,1,9,13,4,0,4,87
501224,1,9,13,13,0,13,79
501230,1,9,13,6,0,6,74
501247,1,9,13,7,0,7,89
501252,1,9,13,6,1,7,88
501259,1,9,13,4,0,4,122
501215,2,9,13,7,1,8,116
501220,2,9,13,7,0,7,110
501234,2,9,13,7,0,7,60
501238,2,9,13,15,0,15,77
501243,2,9,13,14,1,15,124
501266,2,9,13,4,0,4,79
501218,1,10,13,2,0,2,110
501223,1,10,13,7,1,8,87
501233,1,10,13,5,1,6,77
501240,1,10,13,3,0,3,94
501264,1,10,13,2,0,2,80
501267,1,10,13,2,2,4,72
548313,1,10,13,6,1,7,77
548318,1,10,13,3,3,6,92
548324,1,10,13,2,4,6,83
548332,1,10,13,5,0,5,117
548338,1,10,13,8,2,10,114
548342,1,10,13,13,0,13,74
548363,1,10,13,3,1,4,83
598008,1,10,13,6,0,6,51
598020,1,10,13,8,0,8,97
598030,1,10,13,12,0,12,103
598052,1,10,13,11,0,11,113
598060,1,10,13,6,0,6,84
598066,1,10,13,3,0,3,97
598072,1,10,13,2,0,2,93
501207,2,10,13,15,0,15,108
501212,2,10,13,9,0,9,92
501231,2,10,13,4,1,5,78
501237,2,10,13,9,0,9,92
501246,2,10,13,5,0,5,77
501253,2,10,13,1,0,1,85
501255,2,10,13,3,0,3,96
548327,2,10,13,5,0,5,90
548335,2,10,13,10,1,11,96
548346,2,10,13,3,0,3,88
548353,2,10,13,9,0,9,100
548356,2,10,13,9,0,9,66
548358,2,10,13,3,1,4,84
548367,2,10,13,6,0,6,94
548370,2,10,13,5,0,5,81
548380,2,10,13,3,1,4,72
598005,2,10,13,11,0,11,68
598014,2,10,13,5,0,5,109
598016,2,10,13,11,1,12,95
598023,2,10,13,4,0,4,77
598032,2,10,13,7,0,7,100
598040,2,10,13,11,0,11,96
598043,2,10,13,5,0,5,79
598047,2,10,13,13,0,13,98
598058,2,10,13,11,0,11,69
598005,1,11,13,1,0,1,72
598023,1,11,13,4,0,4,66
598035,1,11,13,5,0,5,82
598037,1,11,13,9,0,9,83
598053,1,11,13,12,1,13,80
598061,1,11,13,5,0,5,76
598065,1,11,13,7,0,7,111
598070,1,11,13,6,2,8,69
598076,1,11,13,5,0,5,62
729290,1,11,13,3,0,3,82
729306,1,11,13,2,0,2,92
729316,1,11,13,8,0,8,86
729322,1,11,13,5,1,6,89
733982,1,11,13,4,0,4,91
733994,1,11,13,5,0,5,91
734006,1,11,13,3,0,3,83
734012,1,11,13,16,0,16,108
734020,1,11,13,4,0,4,100
734042,1,11,13,0,0,0,89
829732,1,11,13,4,0,4,79
829748,1,11,13,7,1,8,117
829764,1,11,13,7,0,7,92
829778,1,11,13,3,0,3,131
829792,1,11,13,13,0,13,109
829798,1,11,13,7,0,7,86
829804,1,11,13,15,0,15,114
829820,1,11,13,4,0,4,65
980920,1,11,13,10,0,10,73
980948,1,11,13,8,0,8,53
980958,1,11,13,11,0,11,109
980978,1,11,13,3,0,3,96
980984,1,11,13,1,0,1,70
980988,1,11,13,4,0,4,98
981008,1,11,13,8,0,8,99
981020,1,11,13,12,0,12,94
981024,1,11,13,4,0,4,120
1082591,1,11,13,17,1,18,124
1082600,1,11,13,10,2,12,105
1082609,1,11,13,11,0,11,86
1082611,1,11,13,9,1,10,108
1082615,1,11,13,2,0,2,85
1082623,1,11,13,11,0,11,131
1082627,1,11,13,7,0,7,140
1082630,1,11,13,5,0,5,98
1082648,1,11,13,5,0,5,80
598009,2,11,13,8,0,8,77
598015,2,11,13,2,0,2,65
598018,2,11,13,7,1,8,85
598026,2,11,13,5,0,5,75
598044,2,11,13,5,0,5,84
598049,2,11,13,8,0,8,72
598056,2,11,13,9,0,9,100
598074,2,11,13,2,6,8,98
729300,2,11,13,8,0,8,92
734026,2,11,13,4,0,4,101
734034,2,11,13,6,0,6,123
829716,2,11,13,6,0,6,99
829724,2,11,13,5,1,6,119
829736,2,11,13,4,0,4,90
829756,2,11,13,13,0,13,94
829786,2,11,13,6,0,6,75
980912,2,11,13,7,0,7,113
980928,2,11,13,8,0,8,91
980934,2,11,13,4,0,4,116
980940,2,11,13,11,0,11,109
980972,2,11,13,12,0,12,81
980996,2,11,13,13,0,13,110
981014,2,11,13,2,2,4,96
981022,2,11,13,9,0,9,91
1082596,2,11,13,11,0,11,120
1082604,2,11,13,14,1,15,95
1082634,2,11,13,11,0,11,94
1082638,2,11,13,1,0,1,99
1082643,2,11,13,10,0,10,112
980916,1,12,13,11,0,11,111
980924,1,12,13,4,1,5,92
980944,1,12,13,4,0,4,83
980954,1,12,13,14,0,14,118
980962,1,12,13,2,0,2,107
980974,1,12,13,11,0,11,121
980994,1,12,13,6,0,6,84
1082594,1,12,13,9,0,9,84
1082603,1,12,13,3,1,4,110
1082607,1,12,13,5,1,6,98
1082618,1,12,13,4,0,4,104
1082620,1,12,13,9,0,9,107
1082624,1,12,13,13,0,13,98
1082634,1,12,13,13,0,13,86
1082647,1,12,13,6,0,6,89
980906,2,12,13,7,1,8,104
980936,2,12,13,8,0,8,94
980970,2,12,13,10,0,10,104
980984,2,12,13,8,0,8,76
981010,2,12,13,4,0,4,85
1082592,2,12,13,9,0,9,114
1082599,2,12,13,14,1,15,94
1082615,2,12,13,6,1,7,98
1082629,2,12,13,6,1,7,87
1082631,2,12,13,20,0,20,130
1082642,2,12,13,7,0,7,99
1082650,2,12,13,2,0,2,73
980934,1,13,13,7,1,8,91
980950,1,13,13,3,0,3,120
980966,1,13,13,6,0,6,87
980972,1,13,13,8,0,8,78
981018,1,13,13,16,1,17,89
981022,1,13,13,2,0,2,83
1082593,1,13,13,7,0,7,109
1082596,1,13,13,12,0,12,87
1082606,1,13,13,9,1,10,93
1082625,1,13,13,8,0,8,92
1082629,1,13,13,12,0,12,121
1082632,1,13,13,10,2,12,139
1082640,1,13,13,11,1,12,115
1082643,1,13,13,2,0,2,120
980910,2,13,13,4,0,4,121
980916,2,13,13,6,0,6,120
980922,2,13,13,4,0,4,87
980942,2,13,13,8,0,8,121
980954,2,13,13,7,0,7,128
980960,2,13,13,10,0,10,74
980980,2,13,13,8,0,8,111
980992,2,13,13,3,2,5,74
981006,2,13,13,6,0,6,119
981012,2,13,13,5,0,5,126
1082603,2,13,13,5,0,5,112
1082610,2,13,13,14,0,14,121
1082613,2,13,13,5,0,5,124
1082616,2,13,13,7,0,7,102
1082621,2,13,13,8,1,9,124
1082637,2,13,13,8,0,8,131
335987,1,1,14,6,0,6,130
335998,1,1,14,5,0,5,92
336002,1,1,14,0,0,0,77
336015,1,1,14,6,0,6,101
336019,1,1,14,18,1,19,108
336022,1,1,14,4,1,5,91
336026,1,1,14,8,1,9,65
336030,1,1,14,2,1,3,92
336032,1,1,14,11,0,11,93
392189,1,1,14,7,0,7,59
392204,1,1,14,9,0,9,89
392212,1,1,14,3,0,3,78
392216,1,1,14,0,0,0,98
392224,1,1,14,8,1,9,71
392226,1,1,14,6,1,7,97
392233,1,1,14,7,0,7,78
419111,1,1,14,3,0,3,81
419127,1,1,14,13,0,13,93
419132,1,1,14,9,4,13,124
419140,1,1,14,6,1,7,106
419144,1,1,14,11,0,11,133
419149,1,1,14,8,0,8,118
419153,1,1,14,16,0,16,121
419158,1,1,14,4,0,4,89
501208,1,1,14,11,1,12,103
501227,1,1,14,3,0,3,104
501235,1,1,14,5,1,6,97
501244,1,1,14,9,1,10,97
501272,1,1,14,9,0,9,113
501274,1,1,14,6,1,7,87
548320,1,1,14,3,0,3,126
548349,1,1,14,5,0,5,121
548358,1,1,14,1,0,1,115
548373,1,1,14,3,0,3,105
548375,1,1,14,2,2,4,91
548380,1,1,14,11,0,11,91
548383,1,1,14,4,0,4,92
598013,1,1,14,9,0,9,105
598018,1,1,14,8,0,8,104
598027,1,1,14,6,1,7,89
598034,1,1,14,9,0,9,111
598045,1,1,14,10,1,11,76
598058,1,1,14,5,0,5,90
598074,1,1,14,6,0,6,80
729284,1,1,14,4,0,4,90
729294,1,1,14,6,0,6,99
729304,1,1,14,4,0,4,100
734032,1,1,14,5,1,6,117
734048,1,1,14,8,0,8,104
829718,1,1,14,7,0,7,108
829766,1,1,14,10,1,11,102
829786,1,1,14,6,0,6,107
980914,1,1,14,4,0,4,122
980952,1,1,14,6,0,6,122
980968,1,1,14,7,0,7,107
980980,1,1,14,5,0,5,88
981000,1,1,14,7,4,11,118
981006,1,1,14,5,0,5,69
981014,1,1,14,19,0,19,130
1082597,1,1,14,9,0,9,107
1082604,1,1,14,9,0,9,117
1082613,1,1,14,9,1,10,132
1082617,1,1,14,2,0,2,100
1082631,1,1,14,8,0,8,103
1082649,1,1,14,11,1,12,83
335991,2,1,14,9,0,9,77
336005,2,1,14,13,0,13,120
336008,2,1,14,5,0,5,85
336040,2,1,14,9,0,9,96
392195,2,1,14,3,2,5,94
392202,2,1,14,2,0,2,83
392208,2,1,14,7,0,7,88
392236,2,1,14,10,0,10,124
392238,2,1,14,3,1,4,61
419114,2,1,14,3,0,3,112
419118,2,1,14,2,0,2,84
419123,2,1,14,8,0,8,95
419136,2,1,14,8,1,9,91
419163,2,1,14,6,0,6,107
419166,2,1,14,7,1,8,100
501203,2,1,14,6,0,6,101
501214,2,1,14,10,0,10,118
501219,2,1,14,19,2,21,85
501224,2,1,14,2,0,2,77
501239,2,1,14,3,1,4,95
501247,2,1,14,9,0,9,97
501267,2,1,14,8,0,8,106
548317,2,1,14,8,1,9,86
548325,2,1,14,13,0,13,92
548328,2,1,14,5,0,5,85
548333,2,1,14,6,0,6,97
548340,2,1,14,9,0,9,90
548352,2,1,14,6,0,6,92
548362,2,1,14,9,2,11,118
548368,2,1,14,7,0,7,102
548386,2,1,14,8,0,8,137
598003,2,1,14,5,0,5,98
598010,2,1,14,12,1,13,90
598021,2,1,14,0,1,1,107
598036,2,1,14,5,0,5,106
598039,2,1,14,12,0,12,119
598048,2,1,14,8,1,9,111
598055,2,1,14,10,0,10,89
598062,2,1,14,6,0,6,80
598066,2,1,14,9,0,9,114
729312,2,1,14,3,1,4,66
729320,2,1,14,6,1,7,92
733976,2,1,14,4,0,4,88
733984,2,1,14,7,0,7,121
733990,2,1,14,8,0,8,124
734002,2,1,14,3,0,3,113
734014,2,1,14,8,0,8,96
734020,2,1,14,4,0,4,92
734028,2,1,14,11,0,11,112
734042,2,1,14,12,0,12,154
734054,2,1,14,12,2,14,142
829710,2,1,14,10,0,10,117
829728,2,1,14,12,0,12,103
829738,2,1,14,10,0,10,113
829744,2,1,14,9,0,9,111
829770,2,1,14,3,1,4,84
829796,2,1,14,23,1,24,126
829810,2,1,14,8,2,10,116
829816,2,1,14,2,0,2,133
980908,2,1,14,13,0,13,97
980920,2,1,14,7,0,7,100
980930,2,1,14,2,0,2,112
980944,2,1,14,12,1,13,110
980956,2,1,14,11,0,11,113
980964,2,1,14,3,9,12,105
981020,2,1,14,8,0,8,100
1082593,2,1,14,9,0,9,162
1082601,2,1,14,12,0,12,148
1082608,2,1,14,15,0,15,125
1082620,2,1,14,12,0,12,147
1082622,2,1,14,13,0,13,138
1082627,2,1,14,8,0,8,118
1082636,2,1,14,4,0,4,156
1082639,2,1,14,8,1,9,106
1082644,2,1,14,2,0,2,128
335997,1,2,14,2,0,2,90
336011,1,2,14,7,5,12,84
336017,1,2,14,2,0,2,84
336021,1,2,14,6,0,6,97
336031,1,2,14,11,0,11,97
336034,1,2,14,7,0,7,65
336039,1,2,14,7,0,7,110
392187,1,2,14,6,1,7,77
392196,1,2,14,14,0,14,105
392199,1,2,14,8,0,8,94
392209,1,2,14,4,0,4,88
392218,1,2,14,8,1,9,72
392241,1,2,14,11,0,11,106
419114,1,2,14,7,0,7,85
419128,1,2,14,5,0,5,99
419138,1,2,14,10,1,11,115
419150,1,2,14,2,3,5,92
501210,1,2,14,11,0,11,82
501237,1,2,14,4,0,4,104
501249,1,2,14,14,0,14,149
501273,1,2,14,11,0,11,105
501275,1,2,14,15,0,15,145
548315,1,2,14,10,1,11,102
548323,1,2,14,13,0,13,135
548341,1,2,14,9,1,10,99
548355,1,2,14,16,0,16,117
548367,1,2,14,16,0,16,115
548372,1,2,14,6,3,9,99
548377,1,2,14,20,0,20,128
598004,1,2,14,10,1,11,93
598009,1,2,14,7,0,7,85
598017,1,2,14,12,1,13,99
598032,1,2,14,7,0,7,168
598041,1,2,14,12,1,13,112
598047,1,2,14,12,0,12,111
598050,1,2,14,10,0,10,89
598059,1,2,14,3,0,3,92
598062,1,2,14,6,0,6,76
598069,1,2,14,10,0,10,125
729310,1,2,14,7,0,7,62
729318,1,2,14,4,0,4,97
734004,1,2,14,10,0,10,94
734010,1,2,14,8,0,8,103
734026,1,2,14,7,0,7,93
734040,1,2,14,5,0,5,88
829724,1,2,14,13,0,13,110
829768,1,2,14,14,0,14,124
829790,1,2,14,7,0,7,148
829800,1,2,14,11,0,11,132
829824,1,2,14,3,3,6,94
829826,1,2,14,17,2,19,86
980912,1,2,14,14,0,14,140
980926,1,2,14,15,1,16,130
980932,1,2,14,5,0,5,103
980936,1,2,14,11,0,11,122
980942,1,2,14,12,0,12,104
980964,1,2,14,3,0,3,109
980982,1,2,14,7,0,7,102
980986,1,2,14,7,0,7,76
980992,1,2,14,7,0,7,118
981004,1,2,14,18,0,18,199
1082595,1,2,14,15,1,16,114
1082598,1,2,14,2,0,2,70
1082602,1,2,14,19,0,19,104
1082610,1,2,14,10,0,10,135
1082621,1,2,14,14,0,14,102
1082628,1,2,14,5,0,5,111
1082636,1,2,14,12,0,12,96
1082646,1,2,14,4,1,5,101
335987,2,2,14,7,0,7,77
335990,2,2,14,3,2,5,109
336001,2,2,14,8,0,8,127
336003,2,2,14,11,1,12,130
336007,2,2,14,15,0,15,103
336015,2,2,14,5,0,5,96
336028,2,2,14,4,0,4,73
392190,2,2,14,0,0,0,78
392193,2,2,14,17,0,17,98
392204,2,2,14,9,2,11,89
392213,2,2,14,15,0,15,107
392223,2,2,14,2,5,7,92
392226,2,2,14,16,0,16,110
392229,2,2,14,9,0,9,85
392237,2,2,14,12,0,12,88
392243,2,2,14,4,0,4,100
392244,2,2,14,8,0,8,99
419117,2,2,14,4,0,4,143
419124,2,2,14,5,0,5,115
419133,2,2,14,8,4,12,112
419141,2,2,14,9,0,9,110
419145,2,2,14,20,0,20,105
419153,2,2,14,9,0,9,110
419156,2,2,14,3,0,3,96
419159,2,2,14,7,0,7,123
419162,2,2,14,7,0,7,90
419167,2,2,14,3,0,3,109
419169,2,2,14,8,0,8,86
501205,2,2,14,3,0,3,103
501213,2,2,14,10,0,10,83
501216,2,2,14,12,1,13,108
501227,2,2,14,6,0,6,137
501232,2,2,14,1,1,2,110
501252,2,2,14,4,0,4,128
501257,2,2,14,3,0,3,111
501265,2,2,14,6,0,6,95
501271,2,2,14,1,0,1,96
501276,2,2,14,3,0,3,95
548320,2,2,14,8,0,8,76
548329,2,2,14,9,0,9,101
548332,2,2,14,5,0,5,112
548336,2,2,14,14,1,15,113
548349,2,2,14,7,0,7,85
548361,2,2,14,5,0,5,107
548365,2,2,14,3,0,3,97
548381,2,2,14,4,1,5,71
598013,2,2,14,4,1,5,115
598022,2,2,14,12,0,12,118
598028,2,2,14,5,0,5,90
598038,2,2,14,8,0,8,89
598053,2,2,14,11,0,11,112
729286,2,2,14,15,0,15,104
729292,2,2,14,6,1,7,82
729304,2,2,14,6,0,6,109
733982,2,2,14,10,0,10,89
733988,2,2,14,1,0,1,119
733996,2,2,14,12,0,12,100
734018,2,2,14,3,1,4,75
734032,2,2,14,6,1,7,100
829718,2,2,14,4,0,4,117
829742,2,2,14,5,0,5,124
829750,2,2,14,10,0,10,99
829754,2,2,14,16,0,16,114
829784,2,2,14,3,1,4,97
980958,2,2,14,19,0,19,122
980974,2,2,14,20,0,20,123
981000,2,2,14,13,0,13,125
981016,2,2,14,8,0,8,104
981018,2,2,14,4,0,4,96
981024,2,2,14,8,0,8,149
1082591,2,2,14,4,0,4,130
1082607,2,2,14,4,0,4,87
1082624,2,2,14,5,0,5,66
1082633,2,2,14,4,0,4,88
335988,1,3,14,9,1,10,143
335994,1,3,14,14,0,14,137
336001,1,3,14,8,0,8,94
336006,1,3,14,5,0,5,119
336010,1,3,14,3,0,3,87
336012,1,3,14,3,0,3,84
336018,1,3,14,8,0,8,132
336023,1,3,14,9,1,10,83
336045,1,3,14,12,0,12,109
392190,1,3,14,12,1,13,129
392201,1,3,14,3,0,3,106
392207,1,3,14,7,0,7,96
392211,1,3,14,9,0,9,122
392214,1,3,14,6,0,6,111
392219,1,3,14,16,0,16,121
392229,1,3,14,1,0,1,102
392236,1,3,14,9,1,10,121
392239,1,3,14,4,0,4,89
392243,1,3,14,8,0,8,104
419118,1,3,14,4,0,4,81
419130,1,3,14,7,1,8,120
419142,1,3,14,22,0,22,151
419147,1,3,14,8,0,8,119
419152,1,3,14,11,0,11,101
419160,1,3,14,6,0,6,71
419168,1,3,14,6,0,6,86
419170,1,3,14,11,0,11,91
501203,1,3,14,3,0,3,98
501211,1,3,14,9,0,9,113
501216,1,3,14,5,0,5,112
501220,1,3,14,13,0,13,107
501231,1,3,14,4,0,4,89
501241,1,3,14,4,1,5,88
501250,1,3,14,7,0,7,66
501254,1,3,14,7,1,8,125
501258,1,3,14,3,0,3,98
501266,1,3,14,8,0,8,90
501271,1,3,14,7,1,8,68
501276,1,3,14,12,0,12,143
548311,1,3,14,4,0,4,90
548316,1,3,14,18,0,18,115
548321,1,3,14,5,0,5,78
548327,1,3,14,5,1,6,106
548335,1,3,14,11,0,11,100
548352,1,3,14,3,1,4,92
548357,1,3,14,8,1,9,118
548360,1,3,14,8,0,8,114
548376,1,3,14,12,0,12,71
548384,1,3,14,8,0,8,102
548385,1,3,14,12,0,12,139
548386,1,3,14,17,0,17,128
598025,1,3,14,10,0,10,104
598039,1,3,14,12,0,12,139
598043,1,3,14,12,0,12,93
598046,1,3,14,8,0,8,107
598056,1,3,14,7,1,8,124
598063,1,3,14,4,1,5,94
598067,1,3,14,8,0,8,100
598075,1,3,14,7,0,7,114
729288,1,3,14,4,0,4,132
729298,1,3,14,9,0,9,103
729302,1,3,14,8,5,13,98
733976,1,3,14,6,0,6,114
734018,1,3,14,9,0,9,101
734028,1,3,14,19,0,19,99
734034,1,3,14,2,0,2,100
829712,1,3,14,6,0,6,111
829716,1,3,14,7,0,7,140
829728,1,3,14,11,0,11,115
829740,1,3,14,9,2,11,100
829750,1,3,14,8,0,8,132
829758,1,3,14,2,1,3,129
829770,1,3,14,4,0,4,92
829784,1,3,14,9,0,9,98
829794,1,3,14,14,0,14,98
829802,1,3,14,14,0,14,97
829806,1,3,14,7,4,11,76
335998,2,3,14,11,1,12,107
336014,2,3,14,23,0,23,138
336034,2,3,14,2,1,3,87
336038,2,3,14,3,0,3,144
336042,2,3,14,11,1,12,108
336044,2,3,14,9,1,10,100
392186,2,3,14,3,0,3,94
392194,2,3,14,7,0,7,139
392207,2,3,14,5,0,5,91
392222,2,3,14,7,0,7,87
392232,2,3,14,7,1,8,92
419115,2,3,14,10,0,10,99
419121,2,3,14,3,1,4,143
419126,2,3,14,7,0,7,104
419128,2,3,14,9,0,9,89
419134,2,3,14,8,0,8,105
419138,2,3,14,7,0,7,118
419158,2,3,14,7,0,7,143
419164,2,3,14,6,1,7,123
501226,2,3,14,6,2,8,110
501233,2,3,14,12,0,12,101
501245,2,3,14,5,0,5,114
501273,2,3,14,5,0,5,99
548323,2,3,14,14,1,15,127
548337,2,3,14,5,0,5,93
548348,2,3,14,7,0,7,95
548366,2,3,14,8,0,8,69
548369,2,3,14,8,0,8,101
548373,2,3,14,2,0,2,110
598007,2,3,14,10,0,10,80
598012,2,3,14,9,0,9,97
598017,2,3,14,12,1,13,95
598020,2,3,14,9,0,9,95
598027,2,3,14,4,2,6,66
598031,2,3,14,13,1,14,128
598035,2,3,14,5,0,5,103
598051,2,3,14,14,6,20,75
598078,2,3,14,6,0,6,73
729308,2,3,14,9,0,9,104
729316,2,3,14,12,0,12,114
733986,2,3,14,13,0,13,116
733992,2,3,14,11,0,11,114
734000,2,3,14,11,1,12,104
734008,2,3,14,5,0,5,100
734040,2,3,14,4,0,4,103
734050,2,3,14,9,0,9,118
734052,2,3,14,5,0,5,148
829734,2,3,14,12,0,12,158
829778,2,3,14,1,0,1,116
829814,2,3,14,4,1,5,102
829822,2,3,14,11,0,11,110
829826,2,3,14,3,0,3,85
829828,2,3,14,4,0,4,102
335992,1,4,14,11,0,11,112
335996,1,4,14,6,0,6,122
336008,1,4,14,3,4,7,111
336024,1,4,14,13,0,13,135
336033,1,4,14,10,1,11,125
336040,1,4,14,13,0,13,121
336044,1,4,14,2,0,2,63
392191,1,4,14,3,0,3,104
392200,1,4,14,10,0,10,86
392205,1,4,14,4,1,5,80
392227,1,4,14,4,0,4,87
392234,1,4,14,4,0,4,78
419113,1,4,14,7,0,7,110
419117,1,4,14,10,0,10,129
419126,1,4,14,4,1,5,92
419137,1,4,14,10,0,10,111
419141,1,4,14,8,0,8,105
419148,1,4,14,5,0,5,117
419161,1,4,14,3,1,4,92
419164,1,4,14,14,0,14,121
501207,1,4,14,4,0,4,61
501225,1,4,14,21,0,21,153
501239,1,4,14,8,0,8,80
501253,1,4,14,7,0,7,89
501256,1,4,14,11,0,11,119
501262,1,4,14,7,1,8,119
501265,1,4,14,10,1,11,143
548328,1,4,14,8,2,10,85
548333,1,4,14,3,0,3,86
548336,1,4,14,5,0,5,94
548344,1,4,14,5,6,11,91
548348,1,4,14,8,0,8,113
548364,1,4,14,9,0,9,117
548374,1,4,14,7,0,7,96
548379,1,4,14,4,0,4,77
598012,1,4,14,9,0,9,106
598019,1,4,14,4,0,4,79
598021,1,4,14,9,1,10,96
598026,1,4,14,8,1,9,88
598033,1,4,14,9,0,9,97
598036,1,4,14,5,0,5,103
598057,1,4,14,4,0,4,104
598071,1,4,14,9,2,11,119
729300,1,4,14,15,1,16,139
729312,1,4,14,4,0,4,103
733978,1,4,14,16,0,16,117
733992,1,4,14,18,0,18,139
733996,1,4,14,5,0,5,136
734002,1,4,14,10,0,10,112
734030,1,4,14,3,0,3,104
734038,1,4,14,5,0,5,118
734052,1,4,14,9,0,9,157
734054,1,4,14,19,0,19,111
829722,1,4,14,11,0,11,116
829730,1,4,14,5,0,5,105
829738,1,4,14,8,4,12,107
829772,1,4,14,8,0,8,64
829796,1,4,14,14,0,14,113
829814,1,4,14,2,5,7,78
980910,1,4,14,7,0,7,114
980918,1,4,14,3,0,3,68
980930,1,4,14,6,1,7,85
980940,1,4,14,1,0,1,90
980960,1,4,14,5,0,5,105
980976,1,4,14,5,0,5,106
980996,1,4,14,13,0,13,115
981010,1,4,14,9,0,9,111
1082601,1,4,14,12,3,15,119
1082612,1,4,14,11,0,11,111
1082616,1,4,14,14,0,14,128
1082633,1,4,14,1,8,9,79
1082637,1,4,14,5,0,5,114
1082639,1,4,14,7,1,8,105
1082641,1,4,14,14,0,14,161
1082645,1,4,14,0,0,0,69
335988,2,4,14,9,2,11,152
336000,2,4,14,4,1,5,119
336004,2,4,14,2,0,2,110
336011,2,4,14,3,1,4,103
336018,2,4,14,10,0,10,107
336021,2,4,14,12,1,13,123
336036,2,4,14,4,0,4,123
392196,2,4,14,9,0,9,103
392209,2,4,14,7,0,7,91
392212,2,4,14,7,0,7,109
392215,2,4,14,11,0,11,93
392219,2,4,14,18,1,19,144
392221,2,4,14,4,0,4,115
392231,2,4,14,6,0,6,73
392239,2,4,14,5,0,5,54
419122,2,4,14,9,4,13,84
419129,2,4,14,7,0,7,122
419132,2,4,14,8,0,8,97
419144,2,4,14,5,0,5,149
419151,2,4,14,10,0,10,112
419154,2,4,14,12,2,14,85
501211,2,4,14,5,0,5,136
501217,2,4,14,4,0,4,136
501228,2,4,14,11,0,11,138
501242,2,4,14,7,0,7,89
501249,2,4,14,4,0,4,78
501259,2,4,14,11,0,11,142
501269,2,4,14,3,0,3,93
548314,2,4,14,13,0,13,112
548318,2,4,14,9,0,9,84
548324,2,4,14,3,0,3,78
548339,2,4,14,6,1,7,103
548355,2,4,14,7,0,7,122
548359,2,4,14,6,1,7,89
548371,2,4,14,6,1,7,109
548376,2,4,14,11,0,11,92
598030,2,4,14,10,0,10,121
598042,2,4,14,1,0,1,111
598046,2,4,14,9,0,9,112
598050,2,4,14,12,0,12,123
598061,2,4,14,18,0,18,89
598064,2,4,14,4,0,4,101
598069,2,4,14,16,1,17,112
729288,2,4,14,9,0,9,147
729296,2,4,14,7,0,7,127
729318,2,4,14,5,0,5,93
734012,2,4,14,7,0,7,166
734024,2,4,14,6,1,7,121
734044,2,4,14,8,0,8,119
734048,2,4,14,2,0,2,88
829714,2,4,14,9,0,9,101
829746,2,4,14,14,0,14,114
829758,2,4,14,2,0,2,74
829764,2,4,14,4,0,4,79
829780,2,4,14,8,0,8,105
829790,2,4,14,6,0,6,88
829804,2,4,14,16,0,16,99
980924,2,4,14,3,0,3,103
980946,2,4,14,10,0,10,112
980968,2,4,14,10,1,11,109
980982,2,4,14,9,1,10,114
980990,2,4,14,14,0,14,102
981004,2,4,14,11,0,11,120
1082594,2,4,14,11,2,13,116
1082598,2,4,14,16,0,16,143
1082605,2,4,14,5,0,5,90
1082609,2,4,14,4,0,4,84
1082623,2,4,14,6,0,6,121
335989,1,5,14,7,0,7,83
336005,1,5,14,12,0,12,131
336013,1,5,14,1,0,1,95
336028,1,5,14,7,5,12,126
336038,1,5,14,10,0,10,150
336043,1,5,14,10,0,10,130
392195,1,5,14,4,0,4,97
392215,1,5,14,9,0,9,128
392222,1,5,14,17,0,17,92
392230,1,5,14,19,0,19,112
392238,1,5,14,3,0,3,72
419116,1,5,14,5,0,5,84
419120,1,5,14,7,0,7,75
419123,1,5,14,12,0,12,117
419129,1,5,14,12,0,12,123
419134,1,5,14,7,0,7,125
419146,1,5,14,14,1,15,122
419159,1,5,14,5,0,5,77
419163,1,5,14,5,0,5,101
501214,1,5,14,10,2,12,95
501219,1,5,14,1,0,1,79
501245,1,5,14,11,0,11,106
501257,1,5,14,11,1,12,106
501263,1,5,14,1,0,1,82
548314,1,5,14,16,0,16,118
548317,1,5,14,17,0,17,105
548325,1,5,14,3,0,3,80
548329,1,5,14,24,0,24,106
548337,1,5,14,4,0,4,85
548354,1,5,14,4,0,4,99
548359,1,5,14,3,0,3,119
548366,1,5,14,3,0,3,78
548370,1,5,14,9,0,9,118
548378,1,5,14,4,1,5,85
548382,1,5,14,11,3,14,105
598006,1,5,14,3,2,5,108
598010,1,5,14,7,0,7,86
598014,1,5,14,4,0,4,92
598024,1,5,14,3,0,3,117
598028,1,5,14,9,0,9,90
598031,1,5,14,8,0,8,120
598048,1,5,14,7,0,7,97
598077,1,5,14,8,0,8,101
729296,1,5,14,3,0,3,131
729320,1,5,14,17,0,17,99
733984,1,5,14,3,2,5,106
734008,1,5,14,4,0,4,106
734016,1,5,14,9,0,9,124
734046,1,5,14,15,0,15,121
829714,1,5,14,16,0,16,104
829746,1,5,14,9,0,9,123
829754,1,5,14,4,0,4,93
829782,1,5,14,7,0,7,104
829816,1,5,14,13,1,14,136
335992,2,5,14,12,1,13,127
335995,2,5,14,5,0,5,139
335997,2,5,14,26,0,26,117
336010,2,5,14,4,0,4,108
336016,2,5,14,3,0,3,114
336020,2,5,14,3,0,3,105
336024,2,5,14,23,0,23,132
336032,2,5,14,7,1,8,113
336041,2,5,14,5,0,5,85
336045,2,5,14,5,0,5,107
392187,2,5,14,1,1,2,54
392200,2,5,14,5,0,5,75
392203,2,5,14,4,2,6,92
392210,2,5,14,4,0,4,93
392218,2,5,14,6,0,6,91
392225,2,5,14,4,0,4,86
392235,2,5,14,5,0,5,86
419112,2,5,14,7,0,7,138
419131,2,5,14,9,5,14,135
419139,2,5,14,6,0,6,99
419142,2,5,14,8,1,9,152
419148,2,5,14,3,0,3,143
419155,2,5,14,13,0,13,87
501204,2,5,14,1,0,1,84
501209,2,5,14,8,0,8,117
501225,2,5,14,3,0,3,102
501230,2,5,14,11,0,11,103
501236,2,5,14,5,0,5,65
501240,2,5,14,11,0,11,92
501254,2,5,14,9,0,9,105
501268,2,5,14,4,0,4,134
548322,2,5,14,19,0,19,134
548331,2,5,14,3,1,4,123
548341,2,5,14,2,0,2,93
548350,2,5,14,4,2,6,100
548363,2,5,14,3,0,3,106
598019,2,5,14,9,0,9,88
598037,2,5,14,7,0,7,89
598041,2,5,14,10,0,10,115
598052,2,5,14,21,0,21,127
598054,2,5,14,8,0,8,113
598057,2,5,14,3,0,3,98
598063,2,5,14,22,0,22,114
598068,2,5,14,6,0,6,98
598070,2,5,14,6,0,6,65
598076,2,5,14,18,0,18,91
729290,2,5,14,8,0,8,89
729302,2,5,14,9,0,9,84
733980,2,5,14,9,1,10,111
733994,2,5,14,6,0,6,79
734004,2,5,14,9,0,9,108
734022,2,5,14,4,0,4,84
734038,2,5,14,1,0,1,84
829720,2,5,14,11,0,11,115
829726,2,5,14,15,0,15,107
829732,2,5,14,10,0,10,90
829740,2,5,14,13,0,13,128
829774,2,5,14,9,0,9,124
829792,2,5,14,9,1,10,117
829802,2,5,14,5,0,5,90
829824,2,5,14,4,0,4,87
336000,1,6,14,3,1,4,98
336003,1,6,14,19,0,19,138
336014,1,6,14,12,1,13,119
336020,1,6,14,2,3,5,94
336025,1,6,14,18,0,18,130
392194,1,6,14,4,1,5,114
392203,1,6,14,4,0,4,98
392228,1,6,14,8,1,9,103
392231,1,6,14,14,0,14,85
392235,1,6,14,10,1,11,89
392237,1,6,14,4,0,4,81
392242,1,6,14,10,0,10,104
419121,1,6,14,12,0,12,127
419133,1,6,14,4,0,4,116
419136,1,6,14,17,1,18,128
419139,1,6,14,9,2,11,111
419145,1,6,14,6,1,7,122
419154,1,6,14,3,1,4,79
501206,1,6,14,8,0,8,81
501209,1,6,14,6,0,6,76
501228,1,6,14,13,0,13,164
501232,1,6,14,6,2,8,105
501238,1,6,14,4,0,4,79
501243,1,6,14,8,0,8,93
548347,1,6,14,1,0,1,136
548350,1,6,14,3,0,3,102
548362,1,6,14,5,0,5,100
548369,1,6,14,3,0,3,74
598003,1,6,14,4,1,5,92
598015,1,6,14,3,0,3,67
598022,1,6,14,7,0,7,91
598040,1,6,14,5,0,5,97
598049,1,6,14,5,0,5,66
598054,1,6,14,8,1,9,93
598064,1,6,14,3,1,4,86
729286,1,6,14,5,0,5,79
733980,1,6,14,3,0,3,89
733986,1,6,14,9,2,11,119
733990,1,6,14,5,0,5,99
733998,1,6,14,13,0,13,115
734024,1,6,14,5,0,5,104
734044,1,6,14,1,5,6,98
829720,1,6,14,6,1,7,113
829736,1,6,14,2,1,3,106
829744,1,6,14,8,1,9,96
829752,1,6,14,18,0,18,130
829762,1,6,14,8,0,8,75
829788,1,6,14,2,0,2,90
829818,1,6,14,20,0,20,138
980908,1,6,14,5,0,5,89
980938,1,6,14,11,0,11,103
980956,1,6,14,7,0,7,106
980970,1,6,14,6,0,6,107
981002,1,6,14,6,0,6,68
981016,1,6,14,4,0,4,93
1082599,1,6,14,4,0,4,112
1082605,1,6,14,7,0,7,110
1082608,1,6,14,5,0,5,109
1082622,1,6,14,15,0,15,123
1082626,1,6,14,1,0,1,59
1082642,1,6,14,8,0,8,117
335989,2,6,14,4,0,4,115
335993,2,6,14,0,1,1,143
336006,2,6,14,11,0,11,134
336009,2,6,14,8,0,8,109
336022,2,6,14,11,0,11,91
336031,2,6,14,5,0,5,123
336037,2,6,14,9,0,9,120
336043,2,6,14,2,0,2,79
392199,2,6,14,5,0,5,89
392206,2,6,14,5,0,5,98
392211,2,6,14,11,0,11,111
392216,2,6,14,7,0,7,105
392220,2,6,14,7,0,7,69
392224,2,6,14,7,0,7,94
392240,2,6,14,14,1,15,143
419113,2,6,14,16,0,16,101
419116,2,6,14,8,3,11,126
419119,2,6,14,1,0,1,116
419125,2,6,14,5,0,5,105
419149,2,6,14,6,1,7,125
419157,2,6,14,6,0,6,103
419160,2,6,14,3,0,3,76
419165,2,6,14,10,1,11,83
501218,2,6,14,4,0,4,120
501221,2,6,14,5,0,5,99
501235,2,6,14,2,0,2,77
501248,2,6,14,10,0,10,129
501251,2,6,14,4,0,4,95
501258,2,6,14,6,1,7,97
501262,2,6,14,2,0,2,91
548315,2,6,14,5,0,5,85
548321,2,6,14,2,1,3,111
548326,2,6,14,9,0,9,113
548330,2,6,14,7,0,7,87
548334,2,6,14,16,0,16,154
548338,2,6,14,5,0,5,125
548342,2,6,14,6,0,6,130
548354,2,6,14,6,0,6,128
548374,2,6,14,7,0,7,95
548377,2,6,14,10,3,13,142
548379,2,6,14,2,2,4,117
548383,2,6,14,5,0,5,105
548385,2,6,14,9,0,9,120
598006,2,6,14,9,3,12,112
598011,2,6,14,5,0,5,118
598025,2,6,14,2,0,2,73
598029,2,6,14,7,0,7,133
598033,2,6,14,14,0,14,86
598045,2,6,14,10,1,11,96
598059,2,6,14,4,5,9,118
598067,2,6,14,7,0,7,97
598072,2,6,14,7,1,8,100
729294,2,6,14,13,0,13,117
729298,2,6,14,5,0,5,81
729306,2,6,14,3,1,4,114
729314,2,6,14,5,0,5,81
734010,2,6,14,8,0,8,110
734016,2,6,14,5,0,5,90
734036,2,6,14,9,1,10,101
829712,2,6,14,10,0,10,97
829730,2,6,14,4,1,5,102
829766,2,6,14,2,0,2,97
829772,2,6,14,6,1,7,119
829782,2,6,14,8,2,10,111
829798,2,6,14,15,0,15,97
829806,2,6,14,3,0,3,95
980918,2,6,14,11,0,11,113
980926,2,6,14,19,1,20,136
980950,2,6,14,11,0,11,99
980966,2,6,14,4,0,4,118
980976,2,6,14,15,2,17,128
980988,2,6,14,14,0,14,108
980998,2,6,14,9,0,9,105
981008,2,6,14,11,0,11,103
1082595,2,6,14,5,0,5,112
1082611,2,6,14,6,0,6,111
1082614,2,6,14,5,0,5,83
1082630,2,6,14,12,0,12,137
1082632,2,6,14,12,0,12,177
1082635,2,6,14,0,0,0,66
1082640,2,6,14,2,0,2,121
1082646,2,6,14,11,0,11,101
335990,1,7,14,1,1,2,99
335999,1,7,14,15,0,15,84
336009,1,7,14,8,0,8,110
336029,1,7,14,7,0,7,104
336037,1,7,14,5,0,5,114
336041,1,7,14,9,0,9,92
392186,1,7,14,8,0,8,101
392202,1,7,14,16,0,16,147
392208,1,7,14,7,0,7,83
392213,1,7,14,6,0,6,83
392220,1,7,14,5,0,5,63
392223,1,7,14,7,0,7,92
392232,1,7,14,3,0,3,87
392240,1,7,14,4,0,4,105
419112,1,7,14,11,0,11,140
419119,1,7,14,14,1,15,151
419124,1,7,14,2,0,2,91
419135,1,7,14,4,0,4,97
419143,1,7,14,14,0,14,104
419151,1,7,14,5,0,5,97
419155,1,7,14,5,0,5,101
419157,1,7,14,12,0,12,103
419162,1,7,14,11,2,13,116
419166,1,7,14,2,2,4,81
419167,1,7,14,10,0,10,103
501215,1,7,14,14,0,14,113
501226,1,7,14,5,0,5,96
501229,1,7,14,10,0,10,97
501236,1,7,14,2,0,2,63
501242,1,7,14,8,0,8,105
501246,1,7,14,9,0,9,96
501251,1,7,14,3,1,4,111
501268,1,7,14,15,0,15,85
548322,1,7,14,22,1,23,128
548330,1,7,14,6,0,6,75
548339,1,7,14,12,0,12,108
548356,1,7,14,2,0,2,89
548365,1,7,14,12,0,12,85
548368,1,7,14,2,0,2,113
598007,1,7,14,2,0,2,92
598011,1,7,14,11,0,11,124
598016,1,7,14,12,0,12,104
598029,1,7,14,8,0,8,91
598038,1,7,14,6,0,6,125
598042,1,7,14,5,0,5,98
598044,1,7,14,2,2,4,84
598051,1,7,14,3,0,3,78
598055,1,7,14,8,0,8,101
598068,1,7,14,13,0,13,123
598078,1,7,14,6,0,6,90
729292,1,7,14,9,0,9,87
729308,1,7,14,6,0,6,94
729314,1,7,14,4,0,4,63
733988,1,7,14,8,1,9,110
734000,1,7,14,7,0,7,93
734014,1,7,14,17,0,17,93
734022,1,7,14,12,0,12,119
734036,1,7,14,6,0,6,136
734050,1,7,14,9,0,9,117
829710,1,7,14,4,0,4,80
829726,1,7,14,13,0,13,74
829734,1,7,14,24,2,26,124
829742,1,7,14,5,1,6,120
829756,1,7,14,4,0,4,108
829774,1,7,14,12,1,13,112
829780,1,7,14,3,0,3,118
829810,1,7,14,4,1,5,91
829822,1,7,14,9,0,9,119
829828,1,7,14,9,0,9,134
980906,1,7,14,3,0,3,65
980922,1,7,14,1,0,1,78
980928,1,7,14,26,0,26,98
980946,1,7,14,11,0,11,125
980990,1,7,14,3,4,7,63
980998,1,7,14,12,0,12,132
981012,1,7,14,6,0,6,120
1082592,1,7,14,5,0,5,111
1082614,1,7,14,10,0,10,94
1082635,1,7,14,17,0,17,139
1082638,1,7,14,15,0,15,95
1082644,1,7,14,6,0,6,105
1082650,1,7,14,3,0,3,79
335994,2,7,14,20,0,20,130
335996,2,7,14,4,0,4,98
336002,2,7,14,4,0,4,102
336013,2,7,14,7,0,7,91
336017,2,7,14,7,1,8,110
336023,2,7,14,26,0,26,158
336033,2,7,14,3,4,7,134
392197,2,7,14,6,1,7,103
392202,2,7,14,5,0,5,88
392205,2,7,14,5,1,6,73
392217,2,7,14,4,0,4,97
392227,2,7,14,9,0,9,109
392230,2,7,14,4,0,4,80
419119,2,7,14,1,0,1,117
419127,2,7,14,11,0,11,117
419130,2,7,14,7,0,7,126
419137,2,7,14,5,0,5,105
419147,2,7,14,3,0,3,89
419170,2,7,14,13,2,15,95
501206,2,7,14,7,1,8,77
501210,2,7,14,9,0,9,108
501223,2,7,14,2,0,2,83
501261,2,7,14,3,0,3,69
501272,2,7,14,5,0,5,102
501274,2,7,14,10,0,10,114
501275,2,7,14,1,0,1,92
548311,2,7,14,4,0,4,96
548313,2,7,14,3,0,3,62
548319,2,7,14,14,0,14,83
548344,2,7,14,14,0,14,97
548347,2,7,14,9,0,9,124
548351,2,7,14,8,0,8,75
548360,2,7,14,10,0,10,116
548372,2,7,14,4,0,4,95
548375,2,7,14,10,0,10,77
548382,2,7,14,10,2,12,130
548384,2,7,14,2,0,2,103
598004,2,7,14,6,0,6,91
598024,2,7,14,2,0,2,64
598034,2,7,14,8,0,8,112
598060,2,7,14,5,1,6,73
598065,2,7,14,1,0,1,100
598071,2,7,14,7,1,8,91
598075,2,7,14,4,0,4,113
598077,2,7,14,13,0,13,125
729284,2,7,14,3,0,3,86
729322,2,7,14,13,0,13,99
733978,2,7,14,6,0,6,115
734006,2,7,14,12,0,12,117
734030,2,7,14,4,0,4,118
734046,2,7,14,11,0,11,181
829722,2,7,14,6,0,6,60
829752,2,7,14,15,0,15,115
829788,2,7,14,6,0,6,91
829794,2,7,14,3,0,3,94
829800,2,7,14,4,0,4,129
829820,2,7,14,9,0,9,114
980914,2,7,14,9,0,9,122
980932,2,7,14,6,0,6,115
980938,2,7,14,5,0,5,109
980952,2,7,14,10,0,10,116
980962,2,7,14,5,1,6,104
980978,2,7,14,6,2,8,78
980986,2,7,14,5,0,5,84
1082597,2,7,14,3,0,3,108
1082600,2,7,14,3,1,4,112
1082602,2,7,14,10,0,10,80
1082606,2,7,14,13,0,13,119
1082612,2,7,14,3,1,4,170
1082618,2,7,14,11,0,11,105
1082625,2,7,14,5,0,5,109
1082628,2,7,14,6,0,6,104
1082641,2,7,14,14,0,14,137
1082647,2,7,14,12,1,13,98
1082649,2,7,14,12,2,14,105
335991,1,8,14,2,1,3,65
335993,1,8,14,6,0,6,68
335995,1,8,14,11,0,11,129
336004,1,8,14,5,0,5,98
336007,1,8,14,6,2,8,117
336016,1,8,14,3,1,4,100
336036,1,8,14,18,0,18,109
336042,1,8,14,14,0,14,85
392193,1,8,14,5,0,5,132
392197,1,8,14,5,1,6,131
392206,1,8,14,15,0,15,112
392210,1,8,14,5,2,7,89
392217,1,8,14,8,0,8,93
392221,1,8,14,4,0,4,89
392225,1,8,14,6,0,6,95
392244,1,8,14,7,0,7,81
419115,1,8,14,9,0,9,115
419122,1,8,14,4,0,4,119
419125,1,8,14,6,0,6,108
419131,1,8,14,4,0,4,105
419156,1,8,14,3,0,3,102
419165,1,8,14,2,0,2,114
419169,1,8,14,10,0,10,72
501204,1,8,14,5,0,5,82
501213,1,8,14,13,0,13,112
501217,1,8,14,10,0,10,106
501221,1,8,14,14,0,14,126
501234,1,8,14,12,0,12,83
501248,1,8,14,13,0,13,105
501255,1,8,14,12,0,12,98
501261,1,8,14,5,0,5,76
501269,1,8,14,5,0,5,134
548319,1,8,14,3,0,3,86
548326,1,8,14,3,0,3,113
548331,1,8,14,2,0,2,110
548334,1,8,14,11,0,11,112
548340,1,8,14,8,0,8,95
548346,1,8,14,12,0,12,111
548351,1,8,14,8,0,8,74
548353,1,8,14,6,0,6,91
548361,1,8,14,12,0,12,105
548371,1,8,14,3,4,7,121
548381,1,8,14,5,1,6,67
336012,2,8,14,11,0,11,112
336019,2,8,14,22,0,22,121
336025,2,8,14,6,0,6,120
336029,2,8,14,10,0,10,92
336039,2,8,14,8,0,8,105
392189,2,8,14,4,0,4,104
392201,2,8,14,2,0,2,115
392214,2,8,14,1,1,2,99
392228,2,8,14,13,0,13,124
392233,2,8,14,12,0,12,99
392234,2,8,14,2,0,2,81
392241,2,8,14,11,0,11,116
392242,2,8,14,6,0,6,137
419111,2,8,14,8,0,8,116
419135,2,8,14,14,0,14,114
419140,2,8,14,14,0,14,121
419143,2,8,14,5,0,5,90
419146,2,8,14,4,1,5,113
419150,2,8,14,10,0,10,112
419152,2,8,14,10,0,10,90
419161,2,8,14,3,0,3,123
419168,2,8,14,6,0,6,64
501208,2,8,14,4,0,4,88
501229,2,8,14,4,0,4,95
501241,2,8,14,7,0,7,115
501244,2,8,14,6,0,6,96
501264,2,8,14,7,0,7,96
548316,2,8,14,4,0,4,99
548357,2,8,14,4,0,4,92
548364,2,8,14,11,0,11,92
548378,2,8,14,5,1,6,94
501205,1,9,14,6,0,6,116
501212,1,9,14,10,2,12,99
501224,1,9,14,11,0,11,90
501230,1,9,14,5,0,5,79
501247,1,9,14,3,1,4,93
501252,1,9,14,1,0,1,89
501259,1,9,14,2,0,2,124
501215,2,9,14,9,4,13,129
501220,2,9,14,13,1,14,124
501234,2,9,14,4,2,6,66
501238,2,9,14,3,0,3,80
501243,2,9,14,3,0,3,127
501266,2,9,14,6,0,6,85
501218,1,10,14,9,0,9,119
501223,1,10,14,10,0,10,97
501233,1,10,14,7,0,7,84
501240,1,10,14,3,0,3,97
501264,1,10,14,4,1,5,85
501267,1,10,14,7,0,7,79
548313,1,10,14,4,0,4,81
548318,1,10,14,9,0,9,101
548324,1,10,14,7,0,7,90
548332,1,10,14,12,0,12,129
548338,1,10,14,3,1,4,118
548342,1,10,14,7,0,7,81
548363,1,10,14,4,0,4,87
598008,1,10,14,5,0,5,56
598020,1,10,14,4,0,4,101
598030,1,10,14,12,1,13,116
598052,1,10,14,11,0,11,124
598060,1,10,14,1,0,1,85
598066,1,10,14,1,0,1,98
598072,1,10,14,4,0,4,97
501207,2,10,14,4,1,5,113
501212,2,10,14,14,0,14,106
501231,2,10,14,7,0,7,85
501237,2,10,14,9,0,9,101
501246,2,10,14,7,0,7,84
501253,2,10,14,7,0,7,92
501255,2,10,14,9,1,10,106
548327,2,10,14,10,0,10,100
548335,2,10,14,4,0,4,100
548346,2,10,14,3,0,3,91
548353,2,10,14,10,0,10,110
548356,2,10,14,7,0,7,73
548358,2,10,14,6,0,6,90
548367,2,10,14,8,0,8,102
548370,2,10,14,8,0,8,89
548380,2,10,14,4,0,4,76
598005,2,10,14,4,0,4,72
598014,2,10,14,3,0,3,112
598016,2,10,14,10,0,10,105
598023,2,10,14,3,0,3,80
598032,2,10,14,1,0,1,101
598040,2,10,14,8,0,8,104
598043,2,10,14,13,0,13,92
598047,2,10,14,14,0,14,112
598058,2,10,14,9,0,9,78
598005,1,11,14,11,0,11,83
598023,1,11,14,5,0,5,71
598035,1,11,14,6,0,6,88
598037,1,11,14,4,0,4,87
598053,1,11,14,4,0,4,84
598061,1,11,14,13,0,13,89
598065,1,11,14,5,0,5,116
598070,1,11,14,14,0,14,83
598076,1,11,14,4,1,5,67
729290,1,11,14,3,0,3,85
729306,1,11,14,6,1,7,99
729316,1,11,14,5,1,6,92
729322,1,11,14,10,0,10,99
733982,1,11,14,2,0,2,93
733994,1,11,14,3,1,4,95
734006,1,11,14,8,0,8,91
734012,1,11,14,3,0,3,111
734020,1,11,14,7,1,8,108
734042,1,11,14,13,0,13,102
829732,1,11,14,8,0,8,87
829748,1,11,14,9,0,9,126
829764,1,11,14,6,0,6,98
829778,1,11,14,1,0,1,132
829792,1,11,14,16,1,17,126
829798,1,11,14,6,0,6,92
829804,1,11,14,9,0,9,123
829820,1,11,14,5,0,5,70
980920,1,11,14,13,0,13,86
980948,1,11,14,6,0,6,59
980958,1,11,14,13,0,13,122
980978,1,11,14,6,0,6,102
980984,1,11,14,12,0,12,82
980988,1,11,14,7,1,8,106
981008,1,11,14,9,0,9,108
981020,1,11,14,4,0,4,98
981024,1,11,14,7,0,7,127
1082591,1,11,14,8,0,8,132
1082600,1,11,14,4,1,5,110
1082609,1,11,14,10,0,10,96
1082611,1,11,14,19,0,19,127
1082615,1,11,14,11,1,12,97
1082623,1,11,14,11,1,12,143
1082627,1,11,14,6,0,6,146
1082630,1,11,14,8,0,8,106
1082648,1,11,14,5,0,5,85
598009,2,11,14,5,0,5,82
598015,2,11,14,4,0,4,69
598018,2,11,14,14,0,14,99
598026,2,11,14,6,1,7,82
598044,2,11,14,10,0,10,94
598049,2,11,14,8,1,9,81
598056,2,11,14,4,0,4,104
598074,2,11,14,5,0,5,103
729300,2,11,14,2,1,3,95
734026,2,11,14,10,0,10,111
734034,2,11,14,14,0,14,137
829716,2,11,14,3,0,3,102
829724,2,11,14,3,2,5,124
829736,2,11,14,11,0,11,101
829756,2,11,14,5,0,5,99
829786,2,11,14,6,0,6,81
980912,2,11,14,12,0,12,125
980928,2,11,14,8,0,8,99
980934,2,11,14,9,0,9,125
980940,2,11,14,6,0,6,115
980972,2,11,14,0,0,0,81
980996,2,11,14,9,0,9,119
981014,2,11,14,13,0,13,109
981022,2,11,14,6,0,6,97
1082596,2,11,14,6,0,6,126
1082604,2,11,14,3,0,3,98
1082634,2,11,14,2,0,2,96
1082638,2,11,14,9,1,10,109
1082643,2,11,14,5,0,5,117
980916,1,12,14,2,0,2,113
980924,1,12,14,9,0,9,101
980944,1,12,14,6,1,7,90
980954,1,12,14,7,1,8,126
980962,1,12,14,6,0,6,113
980974,1,12,14,8,1,9,130
980994,1,12,14,3,2,5,89
1082594,1,12,14,14,0,14,98
1082603,1,12,14,10,0,10,120
1082607,1,12,14,8,3,11,109
1082618,1,12,14,7,0,7,111
1082620,1,12,14,7,0,7,114
1082624,1,12,14,11,0,11,109
1082634,1,12,14,11,1,12,98
1082647,1,12,14,7,0,7,96
980906,2,12,14,10,0,10,114
980936,2,12,14,7,1,8,102
980970,2,12,14,2,0,2,106
980984,2,12,14,4,0,4,80
981010,2,12,14,5,0,5,90
1082592,2,12,14,14,1,15,129
1082599,2,12,14,6,0,6,100
1082615,2,12,14,3,0,3,101
1082629,2,12,14,3,0,3,90
1082631,2,12,14,1,0,1,131
1082642,2,12,14,12,0,12,111
1082650,2,12,14,4,0,4,77
980934,1,13,14,4,0,4,95
980950,1,13,14,8,0,8,128
980966,1,13,14,5,0,5,92
980972,1,13,14,1,0,1,79
981018,1,13,14,5,0,5,94
981022,1,13,14,17,0,17,100
1082593,1,13,14,7,0,7,116
1082596,1,13,14,9,0,9,96
1082606,1,13,14,7,5,12,105
1082625,1,13,14,3,0,3,95
1082629,1,13,14,6,1,7,128
1082632,1,13,14,19,0,19,158
1082640,1,13,14,11,0,11,126
1082643,1,13,14,3,0,3,123
980910,2,13,14,9,0,9,130
980916,2,13,14,8,1,9,129
980922,2,13,14,3,0,3,90
980942,2,13,14,9,0,9,130
980954,2,13,14,10,0,10,138
980960,2,13,14,8,0,8,82
980980,2,13,14,9,0,9,120
980992,2,13,14,11,2,13,87
981006,2,13,14,6,0,6,125
981012,2,13,14,12,0,12,138
1082603,2,13,14,11,0,11,123
1082610,2,13,14,13,0,13,134
1082613,2,13,14,9,0,9,133
1082616,2,13,14,4,0,4,106
1082621,2,13,14,11,0,11,135
1082637,2,13,14,6,0,6,137
335987,1,1,15,22,2,24,154
335998,1,1,15,12,0,12,104
336002,1,1,15,10,0,10,87
336015,1,1,15,14,0,14,115
336019,1,1,15,10,0,10,118
336022,1,1,15,4,0,4,95
336026,1,1,15,2,0,2,67
336030,1,1,15,8,1,9,101
336032,1,1,15,9,0,9,102
392189,1,1,15,5,0,5,64
392204,1,1,15,5,0,5,94
392212,1,1,15,14,0,14,92
392216,1,1,15,5,0,5,103
392224,1,1,15,5,1,6,77
392226,1,1,15,5,0,5,102
392233,1,1,15,11,0,11,89
419111,1,1,15,10,1,11,92
419127,1,1,15,8,1,9,102
419132,1,1,15,2,0,2,126
419140,1,1,15,10,0,10,116
419144,1,1,15,16,0,16,149
419149,1,1,15,7,1,8,126
419153,1,1,15,3,0,3,124
419158,1,1,15,4,0,4,93
501208,1,1,15,15,0,15,118
501227,1,1,15,10,0,10,114
501235,1,1,15,8,0,8,105
501244,1,1,15,13,0,13,110
501272,1,1,15,8,0,8,121
501274,1,1,15,15,0,15,102
548320,1,1,15,2,0,2,128
548349,1,1,15,13,0,13,134
548358,1,1,15,5,1,6,121
548373,1,1,15,7,0,7,112
548375,1,1,15,3,0,3,94
548380,1,1,15,9,1,10,101
548383,1,1,15,7,0,7,99
598013,1,1,15,8,0,8,113
598018,1,1,15,5,0,5,109
598027,1,1,15,0,0,0,89
598034,1,1,15,1,0,1,112
598045,1,1,15,7,0,7,83
598058,1,1,15,5,1,6,96
598074,1,1,15,8,1,9,89
729284,1,1,15,20,0,20,110
729294,1,1,15,13,0,13,112
729304,1,1,15,6,0,6,106
734032,1,1,15,24,0,24,141
734048,1,1,15,8,0,8,112
829718,1,1,15,14,0,14,122
829766,1,1,15,7,0,7,109
829786,1,1,15,4,0,4,111
980914,1,1,15,15,1,16,138
980952,1,1,15,4,0,4,126
980968,1,1,15,14,0,14,121
980980,1,1,15,9,1,10,98
981000,1,1,15,6,0,6,124
981006,1,1,15,14,0,14,83
981014,1,1,15,10,1,11,141
1082597,1,1,15,10,0,10,117
1082604,1,1,15,7,0,7,124
1082613,1,1,15,9,0,9,141
1082617,1,1,15,7,0,7,107
1082631,1,1,15,7,0,7,110
1082649,1,1,15,4,1,5,88
335991,2,1,15,3,1,4,81
336005,2,1,15,7,1,8,128
336008,2,1,15,16,0,16,101
336040,2,1,15,8,0,8,104
392195,2,1,15,4,0,4,98
392202,2,1,15,7,0,7,95
392208,2,1,15,10,0,10,98
392236,2,1,15,7,0,7,131
392238,2,1,15,4,0,4,65
419114,2,1,15,4,0,4,116
419118,2,1,15,6,0,6,90
419123,2,1,15,3,1,4,99
419136,2,1,15,7,0,7,98
419163,2,1,15,11,0,11,118
419166,2,1,15,7,0,7,107
501203,2,1,15,9,1,10,111
501214,2,1,15,11,1,12,130
501224,2,1,15,9,0,9,86
501239,2,1,15,7,0,7,102
501247,2,1,15,3,0,3,100
501267,2,1,15,8,0,8,114
548317,2,1,15,8,0,8,94
548325,2,1,15,3,0,3,95
548328,2,1,15,9,0,9,94
548333,2,1,15,10,0,10,107
548340,2,1,15,7,0,7,97
548352,2,1,15,11,0,11,103
548362,2,1,15,10,0,10,128
548368,2,1,15,3,1,4,106
548386,2,1,15,4,0,4,141
598003,2,1,15,2,0,2,100
598010,2,1,15,9,0,9,99
598021,2,1,15,8,1,9,116
598036,2,1,15,12,0,12,118
598039,2,1,15,6,1,7,126
598048,2,1,15,3,0,3,114
598055,2,1,15,3,0,3,92
598062,2,1,15,4,1,5,85
598066,2,1,15,8,0,8,122
729312,2,1,15,8,1,9,75
729320,2,1,15,8,1,9,101
733976,2,1,15,3,0,3,91
733984,2,1,15,1,0,1,122
733990,2,1,15,4,0,4,128
734002,2,1,15,10,0,10,123
734014,2,1,15,4,0,4,100
734020,2,1,15,11,0,11,103
734028,2,1,15,7,0,7,119
734042,2,1,15,6,1,7,161
734054,2,1,15,9,0,9,151
829710,2,1,15,12,0,12,129
829728,2,1,15,15,0,15,118
829738,2,1,15,12,0,12,125
829744,2,1,15,8,0,8,119
829770,2,1,15,6,0,6,90
829796,2,1,15,10,0,10,136
829810,2,1,15,6,0,6,122
829816,2,1,15,11,0,11,144
980908,2,1,15,1,1,2,99
980920,2,1,15,12,0,12,112
980930,2,1,15,5,0,5,117
980944,2,1,15,4,0,4,114
980956,2,1,15,12,2,14,127
980964,2,1,15,18,0,18,123
981020,2,1,15,10,0,10,110
1082593,2,1,15,20,2,22,184
1082601,2,1,15,9,0,9,157
1082608,2,1,15,10,0,10,135
1082620,2,1,15,10,2,12,159
1082622,2,1,15,2,0,2,140
1082627,2,1,15,4,0,4,122
1082636,2,1,15,0,1,1,157
1082639,2,1,15,12,0,12,118
1082644,2,1,15,3,0,3,131
335997,1,2,15,5,0,5,95
336011,1,2,15,13,0,13,97
336017,1,2,15,7,1,8,92
336021,1,2,15,5,0,5,102
336031,1,2,15,5,0,5,102
336034,1,2,15,11,0,11,76
336039,1,2,15,4,0,4,114
392187,1,2,15,9,1,10,87
392196,1,2,15,9,4,13,118
392199,1,2,15,6,0,6,100
392209,1,2,15,12,0,12,100
392218,1,2,15,4,0,4,76
392241,1,2,15,10,0,10,116
419114,1,2,15,4,0,4,89
419128,1,2,15,4,1,5,104
419138,1,2,15,2,0,2,117
419150,1,2,15,10,5,15,107
501210,1,2,15,8,1,9,91
501237,1,2,15,14,0,14,118
501249,1,2,15,6,0,6,155
501273,1,2,15,16,1,17,122
501275,1,2,15,5,0,5,150
548315,1,2,15,6,0,6,108
548323,1,2,15,13,1,14,149
548341,1,2,15,8,0,8,107
548355,1,2,15,5,0,5,122
548367,1,2,15,14,0,14,129
548372,1,2,15,8,0,8,107
548377,1,2,15,9,0,9,137
598004,1,2,15,6,1,7,100
598009,1,2,15,9,0,9,94
598017,1,2,15,15,1,16,115
598032,1,2,15,27,1,28,196
598041,1,2,15,4,0,4,116
598047,1,2,15,8,0,8,119
598050,1,2,15,21,1,22,111
598059,1,2,15,7,0,7,99
598062,1,2,15,8,0,8,84
598069,1,2,15,5,3,8,133
729310,1,2,15,8,0,8,70
729318,1,2,15,1,0,1,98
734004,1,2,15,10,2,12,106
734010,1,2,15,5,0,5,108
734026,1,2,15,12,0,12,105
734040,1,2,15,13,0,13,101
829724,1,2,15,3,1,4,114
829768,1,2,15,6,0,6,130
829790,1,2,15,23,0,23,171
829800,1,2,15,15,0,15,147
829824,1,2,15,19,0,19,113
829826,1,2,15,4,0,4,90
980912,1,2,15,15,1,16,156
980926,1,2,15,13,0,13,143
980932,1,2,15,9,0,9,112
980936,1,2,15,6,0,6,128
980942,1,2,15,10,1,11,115
980964,1,2,15,3,0,3,112
980982,1,2,15,11,0,11,113
980986,1,2,15,15,0,15,91
980992,1,2,15,14,0,14,132
981004,1,2,15,12,0,12,211
1082595,1,2,15,6,1,7,121
1082598,1,2,15,1,0,1,71
1082602,1,2,15,6,0,6,110
1082610,1,2,15,17,1,18,153
1082621,1,2,15,5,0,5,107
1082628,1,2,15,4,0,4,115
1082636,1,2,15,9,0,9,105
1082646,1,2,15,6,0,6,107
335987,2,2,15,2,2,4,81
335990,2,2,15,9,0,9,118
336001,2,2,15,4,1,5,132
336003,2,2,15,4,0,4,134
336007,2,2,15,3,0,3,106
336015,2,2,15,15,0,15,111
336028,2,2,15,10,0,10,83
392190,2,2,15,7,0,7,85
392193,2,2,15,11,0,11,109
392204,2,2,15,9,0,9,98
392213,2,2,15,15,0,15,122
392223,2,2,15,8,0,8,100
392226,2,2,15,8,1,9,119
392229,2,2,15,6,0,6,91
392237,2,2,15,14,0,14,102
392243,2,2,15,10,0,10,110
392244,2,2,15,4,0,4,103
419117,2,2,15,6,0,6,149
419124,2,2,15,2,0,2,117
419133,2,2,15,9,0,9,121
419141,2,2,15,12,0,12,122
419145,2,2,15,6,0,6,111
419153,2,2,15,10,0,10,120
419156,2,2,15,4,2,6,102
419159,2,2,15,1,0,1,124
419162,2,2,15,8,0,8,98
419167,2,2,15,9,0,9,118
501205,2,2,15,14,1,15,118
501213,2,2,15,9,0,9,92
501216,2,2,15,4,0,4,112
501227,2,2,15,13,2,15,152
501232,2,2,15,7,0,7,117
501257,2,2,15,11,0,11,122
501265,2,2,15,2,0,2,97
501271,2,2,15,8,0,8,104
501276,2,2,15,12,0,12,107
548320,2,2,15,4,1,5,81
548329,2,2,15,4,0,4,105
548332,2,2,15,5,0,5,117
548336,2,2,15,3,0,3,116
548349,2,2,15,2,0,2,87
548361,2,2,15,4,2,6,113
548365,2,2,15,14,0,14,111
548381,2,2,15,12,0,12,83
598013,2,2,15,2,0,2,117
598022,2,2,15,7,1,8,126
598028,2,2,15,8,0,8,98
598038,2,2,15,5,0,5,94
598053,2,2,15,5,0,5,117
729286,2,2,15,20,0,20,124
729292,2,2,15,10,0,10,92
729304,2,2,15,7,0,7,116
733982,2,2,15,8,0,8,97
733988,2,2,15,6,0,6,125
733996,2,2,15,9,0,9,109
734018,2,2,15,11,0,11,86
734032,2,2,15,6,0,6,106
829718,2,2,15,2,0,2,119
829742,2,2,15,5,0,5,129
829750,2,2,15,12,0,12,111
829754,2,2,15,10,0,10,124
829784,2,2,15,3,0,3,100
980958,2,2,15,9,1,10,132
980974,2,2,15,19,0,19,142
981000,2,2,15,10,0,10,135
981016,2,2,15,7,0,7,111
981018,2,2,15,14,0,14,110
981024,2,2,15,9,0,9,158
1082591,2,2,15,9,0,9,139
1082607,2,2,15,4,1,5,92
1082624,2,2,15,5,0,5,71
1082633,2,2,15,6,4,10,98
335988,1,3,15,18,0,18,161
335994,1,3,15,6,0,6,143
336001,1,3,15,8,0,8,102
336006,1,3,15,7,0,7,126
336010,1,3,15,4,0,4,91
336012,1,3,15,2,0,2,86
336018,1,3,15,12,0,12,144
336023,1,3,15,5,1,6,89
336045,1,3,15,8,0,8,117
392190,1,3,15,6,0,6,135
392201,1,3,15,7,0,7,113
392207,1,3,15,7,1,8,104
392211,1,3,15,4,4,8,130
392214,1,3,15,19,0,19,130
392219,1,3,15,24,0,24,145
392229,1,3,15,3,0,3,105
392236,1,3,15,2,0,2,123
392239,1,3,15,7,0,7,96
392243,1,3,15,3,0,3,107
419118,1,3,15,15,0,15,96
419130,1,3,15,6,0,6,126
419142,1,3,15,18,1,19,170
419147,1,3,15,5,0,5,124
419152,1,3,15,9,0,9,110
419160,1,3,15,3,0,3,74
419168,1,3,15,10,0,10,96
419170,1,3,15,16,1,17,108
501203,1,3,15,9,0,9,107
501211,1,3,15,13,0,13,126
501216,1,3,15,12,2,14,126
501220,1,3,15,1,1,2,109
501231,1,3,15,10,0,10,99
501241,1,3,15,7,1,8,96
501250,1,3,15,11,0,11,77
501254,1,3,15,10,1,11,136
501258,1,3,15,7,0,7,105
501266,1,3,15,11,0,11,101
501271,1,3,15,11,0,11,79
501276,1,3,15,18,0,18,161
548311,1,3,15,4,1,5,95
548316,1,3,15,4,2,6,121
548321,1,3,15,2,0,2,80
548327,1,3,15,8,0,8,114
548335,1,3,15,15,0,15,115
548352,1,3,15,5,1,6,98
548357,1,3,15,6,0,6,124
548360,1,3,15,8,1,9,123
548376,1,3,15,6,0,6,77
548384,1,3,15,12,0,12,114
548385,1,3,15,21,2,23,162
548386,1,3,15,8,0,8,136
598025,1,3,15,11,1,12,116
598039,1,3,15,12,0,12,151
598043,1,3,15,7,2,9,102
598046,1,3,15,9,0,9,116
598056,1,3,15,10,2,12,136
598063,1,3,15,6,0,6,100
598067,1,3,15,8,1,9,109
598075,1,3,15,11,0,11,125
729288,1,3,15,13,0,13,145
729298,1,3,15,8,0,8,111
729302,1,3,15,3,0,3,101
733976,1,3,15,11,1,12,126
734018,1,3,15,5,1,6,107
734028,1,3,15,7,0,7,106
734034,1,3,15,17,0,17,117
829712,1,3,15,5,0,5,116
829716,1,3,15,3,0,3,143
829728,1,3,15,6,0,6,121
829740,1,3,15,6,0,6,106
829750,1,3,15,2,0,2,134
829758,1,3,15,8,1,9,138
829770,1,3,15,7,0,7,99
829784,1,3,15,3,0,3,101
829794,1,3,15,5,0,5,103
829802,1,3,15,6,5,11,108
829806,1,3,15,6,1,7,83
335998,2,3,15,14,0,14,121
336014,2,3,15,4,0,4,142
336034,2,3,15,5,0,5,92
336038,2,3,15,13,0,13,157
336042,2,3,15,6,0,6,114
336044,2,3,15,16,0,16,116
392186,2,3,15,14,0,14,108
392194,2,3,15,8,1,9,148
392207,2,3,15,6,0,6,97
392222,2,3,15,9,1,10,97
392232,2,3,15,6,4,10,102
419115,2,3,15,9,0,9,108
419121,2,3,15,9,1,10,153
419126,2,3,15,5,0,5,109
419128,2,3,15,6,0,6,95
419134,2,3,15,13,1,14,119
419138,2,3,15,6,1,7,125
419164,2,3,15,7,0,7,130
501226,2,3,15,8,1,9,119
501233,2,3,15,3,0,3,104
501245,2,3,15,4,0,4,118
501273,2,3,15,11,0,11,110
548323,2,3,15,4,0,4,131
548337,2,3,15,11,0,11,104
548348,2,3,15,3,1,4,99
548366,2,3,15,8,0,8,77
548369,2,3,15,11,0,11,112
548373,2,3,15,5,0,5,115
598007,2,3,15,13,0,13,93
598012,2,3,15,6,0,6,103
598017,2,3,15,6,0,6,101
598020,2,3,15,3,1,4,99
598027,2,3,15,4,0,4,70
598031,2,3,15,10,2,12,140
598035,2,3,15,10,1,11,114
598051,2,3,15,3,0,3,78
598078,2,3,15,10,0,10,83
729308,2,3,15,3,0,3,107
729316,2,3,15,10,0,10,124
733986,2,3,15,11,0,11,127
733992,2,3,15,5,0,5,119
734000,2,3,15,8,0,8,112
734008,2,3,15,6,0,6,106
734040,2,3,15,8,0,8,111
734050,2,3,15,14,0,14,132
734052,2,3,15,6,1,7,155
829734,2,3,15,8,2,10,168
829778,2,3,15,14,0,14,130
829814,2,3,15,9,0,9,111
829822,2,3,15,11,0,11,121
829826,2,3,15,6,0,6,91
829828,2,3,15,10,0,10,112
335992,1,4,15,3,0,3,115
335996,1,4,15,16,0,16,138
336008,1,4,15,6,2,8,119
336024,1,4,15,9,0,9,144
336033,1,4,15,9,0,9,134
336040,1,4,15,12,0,12,133
336044,1,4,15,5,0,5,68
392191,1,4,15,11,2,13,117
392200,1,4,15,11,1,12,98
392205,1,4,15,4,2,6,86
392227,1,4,15,5,0,5,92
392234,1,4,15,16,0,16,94
419113,1,4,15,3,0,3,113
419117,1,4,15,4,0,4,133
419126,1,4,15,6,0,6,98
419137,1,4,15,7,0,7,118
419141,1,4,15,14,0,14,119
419148,1,4,15,9,0,9,126
419161,1,4,15,6,0,6,98
419164,1,4,15,9,1,10,131
501207,1,4,15,7,0,7,68
501225,1,4,15,16,0,16,169
501239,1,4,15,6,0,6,86
501253,1,4,15,6,1,7,96
501256,1,4,15,3,2,5,124
501262,1,4,15,2,1,3,122
501265,1,4,15,30,0,30,173
548328,1,4,15,2,0,2,87
548333,1,4,15,3,0,3,89
548336,1,4,15,10,1,11,105
548344,1,4,15,8,1,9,100
548348,1,4,15,8,0,8,121
548364,1,4,15,12,0,12,129
548374,1,4,15,3,0,3,99
548379,1,4,15,7,0,7,84
598012,1,4,15,9,1,10,116
598019,1,4,15,9,0,9,88
598021,1,4,15,3,0,3,99
598026,1,4,15,4,0,4,92
598033,1,4,15,5,1,6,103
598036,1,4,15,8,0,8,111
598057,1,4,15,2,1,3,107
598071,1,4,15,12,0,12,131
729300,1,4,15,12,1,13,152
729312,1,4,15,8,0,8,111
733978,1,4,15,9,0,9,126
733992,1,4,15,14,0,14,153
733996,1,4,15,4,0,4,140
734002,1,4,15,4,0,4,116
734030,1,4,15,3,0,3,107
734038,1,4,15,2,0,2,120
734052,1,4,15,10,0,10,167
734054,1,4,15,20,0,20,131
829722,1,4,15,11,0,11,127
829730,1,4,15,9,1,10,115
829738,1,4,15,5,0,5,112
829772,1,4,15,10,0,10,74
829796,1,4,15,20,1,21,134
829814,1,4,15,7,1,8,86
980910,1,4,15,9,2,11,125
980918,1,4,15,5,0,5,73
980930,1,4,15,10,0,10,95
980940,1,4,15,12,1,13,103
980960,1,4,15,5,0,5,110
980976,1,4,15,12,1,13,119
980996,1,4,15,6,0,6,121
981010,1,4,15,9,0,9,120
1082601,1,4,15,15,0,15,134
1082612,1,4,15,27,1,28,139
1082616,1,4,15,7,0,7,135
1082633,1,4,15,5,0,5,84
1082637,1,4,15,9,0,9,123
1082639,1,4,15,10,0,10,115
1082641,1,4,15,11,1,12,173
1082645,1,4,15,2,0,2,71
335988,2,4,15,13,0,13,165
336000,2,4,15,4,0,4,123
336004,2,4,15,18,1,19,129
336011,2,4,15,6,0,6,109
336018,2,4,15,8,0,8,115
336021,2,4,15,17,1,18,141
336036,2,4,15,12,0,12,135
392196,2,4,15,6,0,6,109
392209,2,4,15,3,1,4,95
392212,2,4,15,7,0,7,116
392215,2,4,15,2,1,3,96
392219,2,4,15,4,0,4,148
392221,2,4,15,4,0,4,119
392231,2,4,15,9,0,9,82
392239,2,4,15,5,0,5,59
419122,2,4,15,13,1,14,98
419129,2,4,15,5,0,5,127
419132,2,4,15,5,0,5,102
419144,2,4,15,7,0,7,156
419151,2,4,15,4,0,4,116
419154,2,4,15,2,1,3,88
501211,2,4,15,2,0,2,138
501217,2,4,15,3,0,3,139
501228,2,4,15,9,0,9,147
501242,2,4,15,11,1,12,101
501249,2,4,15,10,1,11,89
501259,2,4,15,2,1,3,145
501269,2,4,15,6,0,6,99
548314,2,4,15,5,0,5,117
548318,2,4,15,15,0,15,99
548324,2,4,15,10,0,10,88
548339,2,4,15,16,0,16,119
548355,2,4,15,9,1,10,132
548359,2,4,15,8,0,8,97
548371,2,4,15,21,0,21,130
548376,2,4,15,22,0,22,114
598030,2,4,15,8,0,8,129
598042,2,4,15,6,1,7,118
598046,2,4,15,10,0,10,122
598050,2,4,15,17,0,17,140
598061,2,4,15,3,1,4,93
598064,2,4,15,0,0,0,101
598069,2,4,15,25,1,26,138
729288,2,4,15,8,1,9,156
729296,2,4,15,4,1,5,132
729318,2,4,15,8,0,8,101
734012,2,4,15,2,1,3,169
734024,2,4,15,5,1,6,127
734048,2,4,15,4,0,4,92
829714,2,4,15,3,0,3,104
829746,2,4,15,6,0,6,120
829758,2,4,15,5,0,5,79
829764,2,4,15,14,0,14,93
829780,2,4,15,8,0,8,113
829804,2,4,15,3,2,5,104
980924,2,4,15,9,0,9,112
980946,2,4,15,9,0,9,121
980968,2,4,15,8,0,8,117
980982,2,4,15,9,0,9,123
980990,2,4,15,8,0,8,110
1082594,2,4,15,12,0,12,128
1082598,2,4,15,7,0,7,150
1082605,2,4,15,13,0,13,103
1082609,2,4,15,19,1,20,104
1082623,2,4,15,16,1,17,138
335989,1,5,15,9,0,9,92
336005,1,5,15,11,0,11,142
336013,1,5,15,7,0,7,102
336028,1,5,15,17,0,17,143
336038,1,5,15,17,0,17,167
336043,1,5,15,12,0,12,142
392195,1,5,15,10,0,10,107
392215,1,5,15,8,0,8,136
392222,1,5,15,6,1,7,99
392230,1,5,15,11,0,11,123
392238,1,5,15,5,2,7,79
419116,1,5,15,6,1,7,91
419120,1,5,15,3,0,3,78
419123,1,5,15,7,0,7,124
419129,1,5,15,10,0,10,133
419134,1,5,15,4,0,4,129
419146,1,5,15,6,0,6,128
419159,1,5,15,10,0,10,87
419163,1,5,15,0,0,0,101
501214,1,5,15,7,0,7,102
501219,1,5,15,1,0,1,80
501245,1,5,15,7,0,7,113
501257,1,5,15,6,0,6,112
501263,1,5,15,4,1,5,87
548314,1,5,15,4,5,9,127
548317,1,5,15,11,0,11,116
548325,1,5,15,5,0,5,85
548329,1,5,15,6,1,7,113
548337,1,5,15,12,10,22,107
548354,1,5,15,4,1,5,104
548359,1,5,15,7,0,7,126
548366,1,5,15,10,1,11,89
548370,1,5,15,8,0,8,126
548378,1,5,15,7,1,8,93
548382,1,5,15,1,0,1,106
598006,1,5,15,19,0,19,127
598010,1,5,15,13,1,14,100
598014,1,5,15,10,0,10,102
598024,1,5,15,7,1,8,125
598028,1,5,15,11,0,11,101
598031,1,5,15,11,0,11,131
598048,1,5,15,5,0,5,102
598077,1,5,15,3,0,3,104
729296,1,5,15,12,0,12,143
729320,1,5,15,7,0,7,106
733984,1,5,15,10,0,10,116
734008,1,5,15,8,0,8,114
734016,1,5,15,17,0,17,141
734046,1,5,15,13,0,13,134
829714,1,5,15,4,2,6,110
829746,1,5,15,13,0,13,136
829754,1,5,15,6,1,7,100
829782,1,5,15,10,0,10,114
829816,1,5,15,10,0,10,146
335992,2,5,15,15,0,15,142
335995,2,5,15,19,1,20,159
335997,2,5,15,4,0,4,121
336010,2,5,15,2,0,2,110
336016,2,5,15,10,5,15,129
336020,2,5,15,13,2,15,120
336024,2,5,15,8,0,8,140
336032,2,5,15,15,0,15,128
336041,2,5,15,5,0,5,90
336045,2,5,15,5,0,5,112
392187,2,5,15,4,0,4,58
392200,2,5,15,6,1,7,82
392203,2,5,15,3,1,4,96
392207,2,5,15,1,0,1,98
392210,2,5,15,5,0,5,98
392218,2,5,15,15,1,16,107
392225,2,5,15,8,1,9,95
392235,2,5,15,7,0,7,93
419112,2,5,15,5,0,5,143
419131,2,5,15,4,0,4,139
419139,2,5,15,8,0,8,107
419142,2,5,15,23,0,23,175
419148,2,5,15,13,1,14,157
419155,2,5,15,2,0,2,89
501204,2,5,15,9,0,9,93
501209,2,5,15,3,1,4,121
501225,2,5,15,11,0,11,113
501230,2,5,15,4,0,4,107
501236,2,5,15,8,0,8,73
501240,2,5,15,0,0,0,92
501254,2,5,15,9,0,9,114
548322,2,5,15,2,0,2,136
548331,2,5,15,11,0,11,134
548341,2,5,15,9,1,10,103
548350,2,5,15,8,0,8,108
548363,2,5,15,6,0,6,112
598019,2,5,15,6,0,6,94
598037,2,5,15,20,0,20,109
598041,2,5,15,3,2,5,120
598052,2,5,15,1,0,1,128
598054,2,5,15,13,0,13,126
598057,2,5,15,7,0,7,105
598063,2,5,15,16,0,16,130
598068,2,5,15,7,1,8,106
598070,2,5,15,7,1,8,73
598076,2,5,15,8,0,8,99
729290,2,5,15,13,0,13,102
729302,2,5,15,3,0,3,87
733980,2,5,15,4,0,4,115
733994,2,5,15,2,0,2,81
734004,2,5,15,14,0,14,122
734022,2,5,15,12,0,12,96
734038,2,5,15,6,2,8,92
829720,2,5,15,15,0,15,130
829726,2,5,15,5,1,6,113
829732,2,5,15,6,0,6,96
829740,2,5,15,9,1,10,138
829774,2,5,15,2,1,3,127
829792,2,5,15,8,1,9,126
829802,2,5,15,3,0,3,93
829824,2,5,15,4,1,5,92
336000,1,6,15,7,2,9,107
336003,1,6,15,13,0,13,151
336014,1,6,15,14,0,14,133
336020,1,6,15,2,0,2,96
336025,1,6,15,7,1,8,138
392194,1,6,15,9,0,9,123
392203,1,6,15,3,0,3,101
392228,1,6,15,6,0,6,109
392231,1,6,15,11,1,12,97
392235,1,6,15,6,0,6,95
392237,1,6,15,7,1,8,89
392242,1,6,15,5,0,5,109
419121,1,6,15,12,0,12,139
419133,1,6,15,12,0,12,128
419136,1,6,15,7,0,7,135
419139,1,6,15,9,0,9,120
419145,1,6,15,3,0,3,125
419154,1,6,15,2,0,2,81
501206,1,6,15,6,0,6,87
501209,1,6,15,13,0,13,89
501228,1,6,15,9,0,9,173
501232,1,6,15,9,1,10,115
501238,1,6,15,15,0,15,94
501243,1,6,15,4,1,5,98
548347,1,6,15,16,1,17,153
548350,1,6,15,3,0,3,105
548362,1,6,15,8,0,8,108
548369,1,6,15,4,0,4,78
598003,1,6,15,4,0,4,96
598015,1,6,15,5,0,5,72
598022,1,6,15,3,0,3,94
598040,1,6,15,4,0,4,101
598049,1,6,15,4,0,4,70
598054,1,6,15,8,0,8,101
598064,1,6,15,4,0,4,90
729286,1,6,15,3,0,3,82
733980,1,6,15,5,0,5,94
733986,1,6,15,3,0,3,122
733990,1,6,15,4,0,4,103
733998,1,6,15,6,0,6,121
734024,1,6,15,17,0,17,121
734044,1,6,15,5,0,5,103
829720,1,6,15,6,0,6,119
829736,1,6,15,15,0,15,121
829744,1,6,15,7,0,7,103
829752,1,6,15,7,0,7,137
829762,1,6,15,10,0,10,85
829788,1,6,15,5,0,5,95
829818,1,6,15,2,1,3,141
980908,1,6,15,3,0,3,92
980938,1,6,15,6,1,7,110
980956,1,6,15,13,1,14,120
980970,1,6,15,5,0,5,112
981002,1,6,15,5,0,5,73
981016,1,6,15,4,1,5,98
1082599,1,6,15,11,0,11,123
1082605,1,6,15,10,0,10,120
1082608,1,6,15,1,0,1,110
1082622,1,6,15,8,0,8,131
1082626,1,6,15,1,0,1,60
1082642,1,6,15,5,1,6,123
335989,2,6,15,12,1,13,128
336006,2,6,15,8,0,8,142
336009,2,6,15,5,0,5,114
336022,2,6,15,6,0,6,97
336031,2,6,15,4,0,4,127
336037,2,6,15,8,2,10,130
336043,2,6,15,3,0,3,82
392199,2,6,15,8,2,10,99
392206,2,6,15,2,1,3,101
392211,2,6,15,9,0,9,120
392216,2,6,15,9,0,9,114
392220,2,6,15,5,0,5,74
392224,2,6,15,6,0,6,100
392240,2,6,15,3,0,3,146
419113,2,6,15,4,0,4,105
419116,2,6,15,5,0,5,131
419119,2,6,15,0,0,0,117
419125,2,6,15,11,0,11,116
419149,2,6,15,10,0,10,135
419157,2,6,15,5,0,5,108
419160,2,6,15,4,0,4,80
419165,2,6,15,3,0,3,86
501218,2,6,15,8,0,8,128
501221,2,6,15,7,1,8,107
501235,2,6,15,9,0,9,86
501248,2,6,15,20,0,20,149
501251,2,6,15,3,1,4,99
501258,2,6,15,8,2,10,107
501262,2,6,15,6,0,6,97
548315,2,6,15,6,0,6,91
548326,2,6,15,2,0,2,115
548330,2,6,15,3,3,6,93
548334,2,6,15,13,0,13,167
548338,2,6,15,5,1,6,131
548342,2,6,15,4,0,4,134
548354,2,6,15,4,2,6,134
548374,2,6,15,8,0,8,103
548377,2,6,15,7,0,7,149
548379,2,6,15,1,0,1,118
548383,2,6,15,4,0,4,109
548385,2,6,15,8,0,8,128
598006,2,6,15,8,0,8,120
598011,2,6,15,8,0,8,126
598025,2,6,15,7,0,7,80
598029,2,6,15,11,0,11,144
598033,2,6,15,11,3,14,100
598045,2,6,15,4,0,4,100
598059,2,6,15,5,0,5,123
598067,2,6,15,6,0,6,103
598072,2,6,15,3,1,4,104
729294,2,6,15,6,0,6,123
729298,2,6,15,0,1,1,82
729306,2,6,15,5,0,5,119
729314,2,6,15,17,0,17,98
734010,2,6,15,9,0,9,119
734016,2,6,15,3,0,3,93
734036,2,6,15,4,0,4,105
829712,2,6,15,4,1,5,102
829730,2,6,15,17,1,18,120
829766,2,6,15,7,2,9,106
829782,2,6,15,9,0,9,120
829798,2,6,15,7,0,7,104
829806,2,6,15,2,0,2,97
980926,2,6,15,8,2,10,146
980950,2,6,15,17,0,17,116
980966,2,6,15,3,0,3,121
980976,2,6,15,4,0,4,132
980988,2,6,15,6,0,6,114
980998,2,6,15,3,0,3,108
981008,2,6,15,4,0,4,107
1082595,2,6,15,1,0,1,113
1082611,2,6,15,15,1,16,127
1082614,2,6,15,8,0,8,91
1082630,2,6,15,5,0,5,142
1082632,2,6,15,4,1,5,182
1082640,2,6,15,17,0,17,138
1082646,2,6,15,3,0,3,104
335990,1,7,15,6,0,6,105
335999,1,7,15,15,0,15,99
336009,1,7,15,2,0,2,112
336029,1,7,15,10,0,10,114
336037,1,7,15,9,0,9,123
336041,1,7,15,4,1,5,97
392186,1,7,15,4,0,4,105
392202,1,7,15,4,0,4,151
392208,1,7,15,5,0,5,88
392213,1,7,15,3,0,3,86
392220,1,7,15,10,1,11,74
392223,1,7,15,12,0,12,104
392232,1,7,15,9,0,9,96
392240,1,7,15,3,1,4,109
419112,1,7,15,19,0,19,159
419119,1,7,15,14,0,14,165
419124,1,7,15,10,1,11,102
419135,1,7,15,2,1,3,100
419143,1,7,15,9,1,10,114
419151,1,7,15,11,1,12,109
419155,1,7,15,5,0,5,106
419157,1,7,15,4,0,4,107
419162,1,7,15,21,1,22,138
419166,1,7,15,5,0,5,86
419167,1,7,15,4,0,4,107
501215,1,7,15,12,0,12,125
501226,1,7,15,11,0,11,107
501229,1,7,15,5,0,5,102
501236,1,7,15,3,1,4,67
501242,1,7,15,9,0,9,114
501246,1,7,15,1,0,1,97
501251,1,7,15,18,0,18,129
501268,1,7,15,9,0,9,94
548322,1,7,15,9,0,9,137
548330,1,7,15,4,0,4,79
548339,1,7,15,21,0,21,129
548356,1,7,15,3,0,3,92
548365,1,7,15,10,0,10,95
548368,1,7,15,19,0,19,132
598007,1,7,15,4,0,4,96
598011,1,7,15,14,0,14,138
598016,1,7,15,11,0,11,115
598029,1,7,15,11,1,12,103
598038,1,7,15,18,0,18,143
598042,1,7,15,3,1,4,102
598044,1,7,15,5,0,5,89
598051,1,7,15,4,0,4,82
598055,1,7,15,5,0,5,106
598068,1,7,15,8,1,9,132
598078,1,7,15,10,0,10,100
729292,1,7,15,5,0,5,92
729308,1,7,15,14,0,14,108
729314,1,7,15,6,0,6,69
733988,1,7,15,8,1,9,119
734000,1,7,15,6,0,6,99
734014,1,7,15,6,0,6,99
734022,1,7,15,3,0,3,122
734036,1,7,15,13,0,13,149
734050,1,7,15,10,0,10,127
829710,1,7,15,21,0,21,101
829726,1,7,15,8,1,9,83
829734,1,7,15,8,0,8,132
829742,1,7,15,12,1,13,133
829756,1,7,15,4,0,4,112
829774,1,7,15,8,0,8,120
829780,1,7,15,4,1,5,123
829810,1,7,15,8,0,8,99
829822,1,7,15,16,0,16,135
829828,1,7,15,12,0,12,146
980906,1,7,15,3,0,3,68
980922,1,7,15,4,0,4,82
980928,1,7,15,13,0,13,111
980946,1,7,15,15,0,15,140
980990,1,7,15,17,0,17,80
980998,1,7,15,7,5,12,144
981012,1,7,15,14,0,14,134
1082592,1,7,15,9,0,9,120
1082614,1,7,15,8,0,8,102
1082635,1,7,15,9,0,9,148
1082638,1,7,15,4,0,4,99
1082644,1,7,15,13,0,13,118
1082650,1,7,15,2,0,2,81
335994,2,7,15,4,0,4,134
335996,2,7,15,3,0,3,101
336002,2,7,15,8,0,8,110
336013,2,7,15,8,3,11,102
336017,2,7,15,7,0,7,117
336033,2,7,15,9,1,10,144
392197,2,7,15,4,1,5,108
392205,2,7,15,8,0,8,81
392217,2,7,15,3,0,3,100
392227,2,7,15,4,0,4,113
392230,2,7,15,16,2,18,98
419119,2,7,15,1,1,2,119
419127,2,7,15,5,0,5,122
419130,2,7,15,6,1,7,133
419137,2,7,15,13,0,13,118
419147,2,7,15,2,1,3,92
419170,2,7,15,5,1,6,101
501206,2,7,15,8,0,8,85
501210,2,7,15,8,0,8,116
501223,2,7,15,5,1,6,89
501261,2,7,15,6,1,7,76
501272,2,7,15,8,0,8,110
501274,2,7,15,5,1,6,120
501275,2,7,15,11,0,11,103
548311,2,7,15,4,0,4,100
548313,2,7,15,6,0,6,68
548319,2,7,15,2,0,2,85
548344,2,7,15,7,2,9,106
548347,2,7,15,15,0,15,139
548351,2,7,15,2,0,2,77
548360,2,7,15,15,0,15,131
548372,2,7,15,11,0,11,106
548375,2,7,15,3,0,3,80
548382,2,7,15,9,1,10,140
548384,2,7,15,8,1,9,112
598004,2,7,15,4,1,5,96
598024,2,7,15,7,0,7,71
598034,2,7,15,4,0,4,116
598060,2,7,15,10,0,10,83
598065,2,7,15,13,0,13,113
598071,2,7,15,16,0,16,107
598075,2,7,15,14,0,14,127
598077,2,7,15,1,0,1,126
729284,2,7,15,5,4,9,95
729322,2,7,15,7,0,7,106
733978,2,7,15,3,0,3,118
734006,2,7,15,8,0,8,125
734030,2,7,15,15,0,15,133
734046,2,7,15,14,0,14,195
829722,2,7,15,17,2,19,79
829752,2,7,15,5,0,5,120
829788,2,7,15,8,0,8,99
829794,2,7,15,7,0,7,101
829800,2,7,15,6,0,6,135
980914,2,7,15,17,0,17,139
980932,2,7,15,13,0,13,128
980938,2,7,15,5,0,5,114
980952,2,7,15,10,0,10,126
980962,2,7,15,11,0,11,115
980978,2,7,15,6,1,7,85
980986,2,7,15,12,1,13,97
1082597,2,7,15,7,0,7,115
1082600,2,7,15,9,0,9,121
1082602,2,7,15,10,1,11,91
1082606,2,7,15,11,2,13,132
1082612,2,7,15,21,0,21,191
1082618,2,7,15,7,1,8,113
1082625,2,7,15,5,0,5,114
1082628,2,7,15,10,0,10,114
1082641,2,7,15,11,0,11,148
1082647,2,7,15,4,1,5,103
1082649,2,7,15,5,1,6,111
335991,1,8,15,12,0,12,77
335993,1,8,15,5,0,5,73
335995,1,8,15,18,1,19,148
336004,1,8,15,13,0,13,111
336007,1,8,15,6,0,6,123
336016,1,8,15,3,0,3,103
336036,1,8,15,2,0,2,111
336042,1,8,15,7,1,8,93
392193,1,8,15,7,0,7,139
392197,1,8,15,6,0,6,137
392206,1,8,15,6,0,6,118
392210,1,8,15,13,0,13,102
392217,1,8,15,6,0,6,99
392221,1,8,15,11,0,11,100
392225,1,8,15,13,0,13,108
392244,1,8,15,18,2,20,101
419115,1,8,15,9,3,12,127
419122,1,8,15,6,0,6,125
419125,1,8,15,7,0,7,115
419131,1,8,15,3,0,3,108
419156,1,8,15,9,0,9,111
419165,1,8,15,3,0,3,117
419169,1,8,15,6,0,6,78
501204,1,8,15,8,0,8,90
501213,1,8,15,2,0,2,114
501217,1,8,15,7,0,7,113
501221,1,8,15,2,1,3,129
501234,1,8,15,7,0,7,90
501248,1,8,15,16,4,20,125
501255,1,8,15,2,0,2,100
501261,1,8,15,5,1,6,82
501269,1,8,15,13,0,13,147
548319,1,8,15,10,0,10,96
548326,1,8,15,7,0,7,120
548331,1,8,15,9,0,9,119
548334,1,8,15,15,0,15,127
548340,1,8,15,3,0,3,98
548346,1,8,15,7,4,11,122
548351,1,8,15,8,0,8,82
548353,1,8,15,19,0,19,110
548361,1,8,15,12,0,12,117
548371,1,8,15,5,0,5,126
548381,1,8,15,8,0,8,75
336012,2,8,15,3,0,3,115
336019,2,8,15,4,0,4,125
336025,2,8,15,8,0,8,128
336029,2,8,15,14,0,14,106
336039,2,8,15,7,0,7,112
392201,2,8,15,14,0,14,129
392214,2,8,15,1,0,1,100
392228,2,8,15,8,2,10,134
392233,2,8,15,6,0,6,105
392234,2,8,15,5,0,5,86
392241,2,8,15,3,0,3,119
392242,2,8,15,9,0,9,146
419111,2,8,15,6,0,6,122
419135,2,8,15,8,0,8,122
419140,2,8,15,3,1,4,125
419143,2,8,15,8,0,8,98
419146,2,8,15,5,0,5,118
419150,2,8,15,13,0,13,125
419152,2,8,15,12,0,12,102
419161,2,8,15,6,2,8,131
419168,2,8,15,12,5,17,81
501208,2,8,15,13,0,13,101
501229,2,8,15,5,0,5,100
501241,2,8,15,3,0,3,118
501244,2,8,15,12,0,12,108
501264,2,8,15,12,0,12,108
548316,2,8,15,2,0,2,101
548357,2,8,15,10,0,10,102
548364,2,8,15,6,1,7,99
548378,2,8,15,5,0,5,99
501205,1,9,15,8,0,8,124
501212,1,9,15,12,0,12,111
501224,1,9,15,10,0,10,100
501230,1,9,15,9,0,9,88
501247,1,9,15,5,0,5,98
501252,1,9,15,6,2,8,97
501259,1,9,15,6,0,6,130
501215,2,9,15,5,0,5,134
501220,2,9,15,11,0,11,135
501234,2,9,15,7,0,7,73
501238,2,9,15,12,0,12,92
501243,2,9,15,14,0,14,141
501266,2,9,15,5,0,5,90
501218,1,10,15,8,1,9,128
501223,1,10,15,3,0,3,100
501233,1,10,15,7,0,7,91
501240,1,10,15,5,0,5,102
501264,1,10,15,7,0,7,92
501267,1,10,15,2,0,2,81
548313,1,10,15,10,0,10,91
548318,1,10,15,12,0,12,113
548324,1,10,15,6,0,6,96
548332,1,10,15,4,1,5,134
548338,1,10,15,7,0,7,125
548342,1,10,15,13,1,14,95
548363,1,10,15,4,0,4,91
598008,1,10,15,8,0,8,64
598020,1,10,15,4,1,5,106
598030,1,10,15,7,1,8,124
598052,1,10,15,1,0,1,125
598060,1,10,15,3,0,3,88
598066,1,10,15,13,1,14,112
598072,1,10,15,9,1,10,107
501212,2,10,15,8,1,9,115
501231,2,10,15,8,0,8,93
501237,2,10,15,7,0,7,108
501246,2,10,15,4,2,6,90
501253,2,10,15,21,1,22,114
501255,2,10,15,6,0,6,112
548327,2,10,15,6,0,6,106
548335,2,10,15,7,0,7,107
548346,2,10,15,10,0,10,101
548353,2,10,15,6,0,6,116
548356,2,10,15,2,1,3,76
548358,2,10,15,19,0,19,109
548367,2,10,15,3,0,3,105
548370,2,10,15,8,0,8,97
548380,2,10,15,6,0,6,82
598005,2,10,15,6,0,6,78
598014,2,10,15,5,0,5,117
598016,2,10,15,13,0,13,118
598023,2,10,15,7,0,7,87
598032,2,10,15,9,1,10,111
598040,2,10,15,6,0,6,110
598043,2,10,15,1,0,1,93
598047,2,10,15,10,0,10,122
598058,2,10,15,2,0,2,80
598005,1,11,15,4,0,4,87
598023,1,11,15,4,0,4,75
598035,1,11,15,8,0,8,96
598037,1,11,15,5,0,5,92
598053,1,11,15,14,0,14,98
598061,1,11,15,9,0,9,98
598065,1,11,15,15,0,15,131
598070,1,11,15,5,2,7,90
598076,1,11,15,10,0,10,77
729290,1,11,15,4,1,5,90
729306,1,11,15,19,0,19,118
729316,1,11,15,6,0,6,98
729322,1,11,15,13,5,18,117
733982,1,11,15,11,2,13,106
733994,1,11,15,6,1,7,102
734006,1,11,15,11,1,12,103
734012,1,11,15,16,0,16,127
734020,1,11,15,1,0,1,109
734042,1,11,15,19,0,19,121
829732,1,11,15,3,0,3,90
829748,1,11,15,7,0,7,133
829764,1,11,15,6,0,6,104
829778,1,11,15,11,0,11,143
829792,1,11,15,7,0,7,133
829798,1,11,15,7,0,7,99
829804,1,11,15,17,0,17,140
829820,1,11,15,10,0,10,80
980920,1,11,15,8,0,8,94
980948,1,11,15,12,1,13,72
980958,1,11,15,19,0,19,141
980978,1,11,15,14,0,14,116
980984,1,11,15,14,0,14,96
980988,1,11,15,7,0,7,113
981008,1,11,15,7,0,7,115
981020,1,11,15,11,0,11,109
981024,1,11,15,13,0,13,140
1082591,1,11,15,19,0,19,151
1082600,1,11,15,8,0,8,118
1082609,1,11,15,10,2,12,108
1082611,1,11,15,8,0,8,135
1082615,1,11,15,15,1,16,113
1082623,1,11,15,12,0,12,155
1082627,1,11,15,7,1,8,154
1082630,1,11,15,7,1,8,114
1082648,1,11,15,13,0,13,98
598009,2,11,15,4,5,9,91
598015,2,11,15,7,0,7,76
598018,2,11,15,5,0,5,104
598026,2,11,15,5,0,5,87
598044,2,11,15,12,0,12,106
598056,2,11,15,5,0,5,109
598074,2,11,15,2,1,3,106
729300,2,11,15,4,0,4,99
734026,2,11,15,5,0,5,116
734034,2,11,15,11,0,11,148
829716,2,11,15,13,0,13,115
829724,2,11,15,12,1,13,137
829736,2,11,15,9,0,9,110
829756,2,11,15,5,0,5,104
829786,2,11,15,7,0,7,88
980912,2,11,15,14,0,14,139
980928,2,11,15,8,1,9,108
980934,2,11,15,12,0,12,137
980940,2,11,15,4,0,4,119
980972,2,11,15,10,0,10,91
980996,2,11,15,11,0,11,130
981014,2,11,15,5,0,5,114
981022,2,11,15,19,0,19,116
1082596,2,11,15,5,0,5,131
1082604,2,11,15,13,2,15,113
1082634,2,11,15,5,0,5,101
1082638,2,11,15,3,1,4,113
1082643,2,11,15,10,0,10,127
980916,1,12,15,8,0,8,121
980924,1,12,15,8,0,8,109
980944,1,12,15,10,0,10,100
980954,1,12,15,9,0,9,135
980962,1,12,15,6,1,7,120
980974,1,12,15,5,3,8,138
980994,1,12,15,5,0,5,94
1082594,1,12,15,10,0,10,108
1082603,1,12,15,6,0,6,126
1082607,1,12,15,8,0,8,117
1082618,1,12,15,9,0,9,120
1082620,1,12,15,15,0,15,129
1082624,1,12,15,1,1,2,111
1082634,1,12,15,2,0,2,100
1082647,1,12,15,8,0,8,104
980906,2,12,15,12,0,12,126
980936,2,12,15,13,0,13,115
980970,2,12,15,10,0,10,116
980984,2,12,15,6,0,6,86
981010,2,12,15,12,1,13,103
1082592,2,12,15,9,1,10,139
1082599,2,12,15,5,1,6,106
1082615,2,12,15,14,0,14,115
1082629,2,12,15,12,0,12,102
1082631,2,12,15,3,0,3,134
1082642,2,12,15,6,0,6,117
1082650,2,12,15,5,1,6,83
980934,1,13,15,9,0,9,104
980950,1,13,15,4,0,4,132
980966,1,13,15,7,0,7,99
980972,1,13,15,6,0,6,85
981018,1,13,15,10,0,10,104
981022,1,13,15,9,0,9,109
1082593,1,13,15,9,0,9,125
1082596,1,13,15,6,0,6,102
1082606,1,13,15,15,0,15,120
1082625,1,13,15,4,1,5,100
1082629,1,13,15,7,0,7,135
1082632,1,13,15,5,1,6,164
1082640,1,13,15,8,0,8,134
1082643,1,13,15,3,0,3,126
980910,2,13,15,2,2,4,134
980916,2,13,15,3,0,3,132
980922,2,13,15,9,0,9,99
980942,2,13,15,6,0,6,136
980954,2,13,15,9,0,9,147
980960,2,13,15,5,0,5,87
980980,2,13,15,15,0,15,135
980992,2,13,15,5,2,7,94
981012,2,13,15,9,0,9,147
1082603,2,13,15,9,1,10,133
1082610,2,13,15,5,0,5,139
1082613,2,13,15,12,1,13,146
1082616,2,13,15,15,0,15,121
1082637,2,13,15,10,1,11,148
335987,1,1,16,4,0,4,158
335998,1,1,16,2,2,4,108
336002,1,1,16,5,1,6,93
336015,1,1,16,13,1,14,129
336019,1,1,16,18,0,18,136
336022,1,1,16,9,0,9,104
336026,1,1,16,0,0,0,67
336030,1,1,16,13,0,13,114
336032,1,1,16,4,0,4,106
392189,1,1,16,10,0,10,74
392204,1,1,16,13,0,13,107
392212,1,1,16,10,3,13,105
392216,1,1,16,8,0,8,111
392224,1,1,16,11,0,11,88
392226,1,1,16,11,0,11,113
392233,1,1,16,14,1,15,104
419111,1,1,16,11,0,11,103
419127,1,1,16,15,1,16,118
419132,1,1,16,4,0,4,130
419140,1,1,16,9,0,9,125
419144,1,1,16,10,0,10,159
419149,1,1,16,4,0,4,130
419153,1,1,16,9,0,9,133
419158,1,1,16,5,0,5,98
501208,1,1,16,8,1,9,127
501227,1,1,16,14,0,14,128
501235,1,1,16,4,0,4,109
501244,1,1,16,11,0,11,121
501272,1,1,16,3,0,3,124
501274,1,1,16,6,2,8,110
548320,1,1,16,7,0,7,135
548349,1,1,16,10,0,10,144
548358,1,1,16,3,1,4,125
548373,1,1,16,10,0,10,122
548375,1,1,16,6,0,6,100
548380,1,1,16,6,0,6,107
548383,1,1,16,7,0,7,106
598013,1,1,16,10,0,10,123
598018,1,1,16,13,0,13,122
598027,1,1,16,2,0,2,91
598034,1,1,16,12,1,13,125
598045,1,1,16,7,1,8,91
598058,1,1,16,2,1,3,99
598074,1,1,16,2,4,6,95
729284,1,1,16,15,0,15,125
729294,1,1,16,12,0,12,124
729304,1,1,16,7,0,7,113
734032,1,1,16,9,0,9,150
734048,1,1,16,1,1,2,114
829718,1,1,16,9,0,9,131
829766,1,1,16,10,0,10,119
829786,1,1,16,9,1,10,121
980914,1,1,16,12,1,13,151
980952,1,1,16,4,0,4,130
980968,1,1,16,6,1,7,128
980980,1,1,16,10,0,10,108
981000,1,1,16,13,0,13,137
981006,1,1,16,10,0,10,93
981014,1,1,16,5,0,5,146
1082597,1,1,16,14,0,14,131
1082604,1,1,16,11,1,12,136
1082613,1,1,16,8,0,8,149
1082617,1,1,16,9,0,9,116
1082631,1,1,16,9,0,9,119
1082649,1,1,16,4,0,4,92
335991,2,1,16,6,0,6,87
336005,2,1,16,8,0,8,136
336008,2,1,16,12,0,12,113
336040,2,1,16,14,0,14,118
392195,2,1,16,21,1,22,120
392208,2,1,16,12,1,13,111
392236,2,1,16,6,0,6,137
392238,2,1,16,10,0,10,75
419114,2,1,16,2,0,2,118
419118,2,1,16,7,0,7,97
419123,2,1,16,10,0,10,109
419136,2,1,16,8,2,10,108
419163,2,1,16,14,0,14,132
419166,2,1,16,10,1,11,118
501203,2,1,16,7,0,7,118
501214,2,1,16,10,0,10,140
501224,2,1,16,12,0,12,98
501239,2,1,16,10,1,11,113
501247,2,1,16,6,0,6,106
501267,2,1,16,1,2,3,117
548317,2,1,16,4,0,4,98
548325,2,1,16,7,0,7,102
548328,2,1,16,5,0,5,99
548333,2,1,16,10,0,10,117
548340,2,1,16,4,0,4,101
548352,2,1,16,9,0,9,112
548362,2,1,16,5,1,6,134
548368,2,1,16,11,0,11,117
548386,2,1,16,11,0,11,152
598003,2,1,16,5,1,6,106
598010,2,1,16,5,0,5,104
598021,2,1,16,0,1,1,117
598036,2,1,16,8,1,9,127
598039,2,1,16,12,0,12,138
598048,2,1,16,7,0,7,121
598055,2,1,16,5,0,5,97
598062,2,1,16,2,0,2,87
598066,2,1,16,5,0,5,127
729312,2,1,16,10,0,10,85
729320,2,1,16,10,0,10,111
733976,2,1,16,19,0,19,110
733984,2,1,16,3,1,4,126
733990,2,1,16,10,0,10,138
734002,2,1,16,8,0,8,131
734014,2,1,16,16,0,16,116
734020,2,1,16,4,0,4,107
734028,2,1,16,9,0,9,128
734054,2,1,16,10,0,10,161
829710,2,1,16,2,0,2,131
829728,2,1,16,14,0,14,132
829738,2,1,16,14,0,14,139
829744,2,1,16,12,0,12,131
829770,2,1,16,5,0,5,95
829796,2,1,16,18,1,19,155
829810,2,1,16,8,0,8,130
829816,2,1,16,4,3,7,151
980920,2,1,16,10,1,11,123
980930,2,1,16,7,0,7,124
980944,2,1,16,5,0,5,119
980956,2,1,16,8,1,9,136
980964,2,1,16,14,2,16,139
981020,2,1,16,6,0,6,116
1082601,2,1,16,7,0,7,164
1082608,2,1,16,5,1,6,141
1082620,2,1,16,14,0,14,173
1082622,2,1,16,16,0,16,156
1082627,2,1,16,5,3,8,130
1082636,2,1,16,2,0,2,159
1082639,2,1,16,6,0,6,124
1082644,2,1,16,4,0,4,135
335997,1,2,16,13,0,13,108
336011,1,2,16,5,0,5,102
336017,1,2,16,7,5,12,104
336021,1,2,16,16,0,16,118
336031,1,2,16,3,0,3,105
336034,1,2,16,10,1,11,87
336039,1,2,16,7,1,8,122
392187,1,2,16,1,0,1,88
392196,1,2,16,13,0,13,131
392199,1,2,16,9,0,9,109
392209,1,2,16,4,0,4,104
392218,1,2,16,6,0,6,82
392241,1,2,16,16,0,16,132
419114,1,2,16,8,0,8,97
419128,1,2,16,6,0,6,110
419138,1,2,16,0,0,0,117
419150,1,2,16,8,0,8,115
501210,1,2,16,8,4,12,103
501237,1,2,16,16,0,16,134
501249,1,2,16,8,0,8,163
501273,1,2,16,9,0,9,131
501275,1,2,16,4,1,5,155
548315,1,2,16,5,0,5,113
548323,1,2,16,12,0,12,161
548341,1,2,16,15,0,15,122
548355,1,2,16,7,0,7,129
548367,1,2,16,3,0,3,132
548372,1,2,16,13,2,15,122
548377,1,2,16,22,0,22,159
598004,1,2,16,6,0,6,106
598009,1,2,16,2,0,2,96
598017,1,2,16,8,2,10,125
598032,1,2,16,5,0,5,201
598041,1,2,16,6,1,7,123
598047,1,2,16,11,0,11,130
598050,1,2,16,15,0,15,126
598059,1,2,16,7,0,7,106
598062,1,2,16,12,0,12,96
598069,1,2,16,7,0,7,140
729318,1,2,16,2,0,2,100
734004,1,2,16,17,0,17,123
734010,1,2,16,6,1,7,115
734026,1,2,16,18,1,19,124
734040,1,2,16,7,2,9,110
829724,1,2,16,11,0,11,125
829768,1,2,16,11,1,12,142
829790,1,2,16,8,0,8,179
829800,1,2,16,13,0,13,160
829824,1,2,16,11,0,11,124
829826,1,2,16,13,0,13,103
980912,1,2,16,7,1,8,164
980926,1,2,16,21,0,21,164
980932,1,2,16,6,5,11,123
980936,1,2,16,3,6,9,137
980942,1,2,16,13,0,13,128
980964,1,2,16,13,0,13,125
980982,1,2,16,16,0,16,129
980986,1,2,16,10,0,10,101
980992,1,2,16,23,0,23,155
1082595,1,2,16,13,0,13,134
1082598,1,2,16,8,1,9,80
1082602,1,2,16,3,1,4,114
1082610,1,2,16,7,0,7,160
1082621,1,2,16,4,0,4,111
1082628,1,2,16,7,0,7,122
1082636,1,2,16,3,0,3,108
1082646,1,2,16,5,0,5,112
335987,2,2,16,0,1,1,82
335990,2,2,16,8,0,8,126
336001,2,2,16,8,0,8,140
336003,2,2,16,6,0,6,140
336007,2,2,16,17,0,17,123
336015,2,2,16,13,0,13,124
336028,2,2,16,6,0,6,89
392190,2,2,16,2,0,2,87
392193,2,2,16,12,0,12,121
392204,2,2,16,9,0,9,107
392213,2,2,16,5,0,5,127
392223,2,2,16,5,1,6,106
392226,2,2,16,3,0,3,122
392229,2,2,16,2,0,2,93
392237,2,2,16,3,0,3,105
392243,2,2,16,2,0,2,112
392244,2,2,16,5,0,5,108
419117,2,2,16,10,0,10,159
419124,2,2,16,15,0,15,132
419133,2,2,16,4,1,5,126
419141,2,2,16,12,0,12,134
419145,2,2,16,8,0,8,119
419153,2,2,16,16,1,17,137
419156,2,2,16,7,0,7,109
419159,2,2,16,8,0,8,132
419162,2,2,16,9,0,9,107
419167,2,2,16,4,1,5,123
501205,2,2,16,5,0,5,123
501213,2,2,16,16,0,16,108
501216,2,2,16,8,3,11,123
501227,2,2,16,7,0,7,159
501232,2,2,16,7,5,12,129
501257,2,2,16,13,0,13,135
501265,2,2,16,13,0,13,110
501271,2,2,16,5,3,8,112
501276,2,2,16,8,0,8,115
548320,2,2,16,7,3,10,91
548329,2,2,16,3,0,3,108
548332,2,2,16,10,1,11,128
548336,2,2,16,14,2,16,132
548349,2,2,16,11,0,11,98
548361,2,2,16,16,1,17,130
548365,2,2,16,9,1,10,121
548381,2,2,16,14,0,14,97
598013,2,2,16,17,1,18,135
598022,2,2,16,3,0,3,129
598028,2,2,16,4,0,4,102
598038,2,2,16,8,0,8,102
598053,2,2,16,19,2,21,138
729286,2,2,16,8,0,8,132
729292,2,2,16,3,0,3,95
729304,2,2,16,7,0,7,123
733982,2,2,16,19,0,19,116
733988,2,2,16,9,0,9,134
733996,2,2,16,17,2,19,128
734018,2,2,16,10,0,10,96
734032,2,2,16,18,4,22,128
829718,2,2,16,13,0,13,132
829742,2,2,16,13,2,15,144
829750,2,2,16,12,0,12,123
829754,2,2,16,6,0,6,130
829784,2,2,16,9,0,9,109
980958,2,2,16,10,0,10,142
980974,2,2,16,3,0,3,145
981000,2,2,16,9,0,9,144
981016,2,2,16,8,0,8,119
981018,2,2,16,16,0,16,126
981024,2,2,16,4,0,4,162
1082591,2,2,16,12,0,12,151
1082607,2,2,16,9,1,10,102
1082624,2,2,16,2,1,3,74
1082633,2,2,16,7,1,8,106
335988,1,3,16,8,0,8,169
335994,1,3,16,14,1,15,158
336001,1,3,16,14,0,14,116
336006,1,3,16,1,0,1,127
336010,1,3,16,5,0,5,96
336012,1,3,16,8,1,9,95
336018,1,3,16,5,0,5,149
336023,1,3,16,13,0,13,102
336045,1,3,16,10,0,10,127
392190,1,3,16,9,0,9,144
392201,1,3,16,7,0,7,120
392207,1,3,16,3,1,4,108
392211,1,3,16,7,1,8,138
392214,1,3,16,7,0,7,137
392219,1,3,16,8,1,9,154
392229,1,3,16,2,0,2,107
392236,1,3,16,17,0,17,140
392239,1,3,16,4,0,4,100
392243,1,3,16,7,0,7,114
419118,1,3,16,7,0,7,103
419130,1,3,16,10,0,10,136
419142,1,3,16,26,0,26,196
419147,1,3,16,4,0,4,128
419152,1,3,16,3,1,4,114
419160,1,3,16,3,0,3,77
419168,1,3,16,6,1,7,103
419170,1,3,16,19,0,19,127
501203,1,3,16,14,0,14,121
501211,1,3,16,14,0,14,140
501216,1,3,16,11,0,11,137
501220,1,3,16,8,0,8,117
501231,1,3,16,9,1,10,109
501241,1,3,16,15,0,15,111
501250,1,3,16,4,0,4,81
501254,1,3,16,4,0,4,140
501258,1,3,16,11,1,12,117
501266,1,3,16,13,0,13,114
501271,1,3,16,3,0,3,82
501276,1,3,16,6,0,6,167
548311,1,3,16,4,0,4,99
548316,1,3,16,12,0,12,133
548321,1,3,16,3,0,3,83
548327,1,3,16,11,0,11,125
548335,1,3,16,1,0,1,116
548352,1,3,16,4,0,4,102
548357,1,3,16,5,0,5,129
548360,1,3,16,15,0,15,138
548376,1,3,16,1,0,1,78
548384,1,3,16,14,0,14,128
548385,1,3,16,4,1,5,167
548386,1,3,16,10,0,10,146
598025,1,3,16,7,0,7,123
598039,1,3,16,7,0,7,158
598043,1,3,16,12,0,12,114
598046,1,3,16,16,0,16,132
598056,1,3,16,16,0,16,152
598063,1,3,16,5,0,5,105
598067,1,3,16,15,1,16,125
598075,1,3,16,12,0,12,137
729288,1,3,16,14,1,15,160
729298,1,3,16,8,0,8,119
729302,1,3,16,5,0,5,106
733976,1,3,16,5,2,7,133
734018,1,3,16,6,1,7,114
734028,1,3,16,13,1,14,120
734034,1,3,16,10,3,13,130
829712,1,3,16,3,0,3,119
829716,1,3,16,9,0,9,152
829728,1,3,16,7,0,7,128
829740,1,3,16,7,0,7,113
829750,1,3,16,6,0,6,140
829758,1,3,16,14,1,15,153
829770,1,3,16,6,1,7,106
829784,1,3,16,12,0,12,113
829794,1,3,16,5,0,5,108
829802,1,3,16,7,0,7,115
829806,1,3,16,3,0,3,86
335998,2,3,16,13,5,18,139
336014,2,3,16,5,1,6,148
336034,2,3,16,1,0,1,93
336038,2,3,16,8,0,8,165
336042,2,3,16,3,0,3,117
392186,2,3,16,6,0,6,114
392194,2,3,16,8,0,8,156
392207,2,3,16,3,0,3,101
392222,2,3,16,20,0,20,117
392232,2,3,16,7,1,8,110
419115,2,3,16,10,0,10,118
419121,2,3,16,3,0,3,156
419126,2,3,16,3,0,3,112
419128,2,3,16,12,0,12,107
419134,2,3,16,3,3,6,125
419138,2,3,16,10,1,11,136
419164,2,3,16,8,3,11,141
501226,2,3,16,3,1,4,123
501233,2,3,16,6,0,6,110
501245,2,3,16,7,0,7,125
501273,2,3,16,8,0,8,118
548323,2,3,16,10,0,10,141
548337,2,3,16,11,1,12,116
548348,2,3,16,8,0,8,107
548366,2,3,16,3,0,3,80
548369,2,3,16,3,0,3,115
548373,2,3,16,9,0,9,124
598007,2,3,16,6,0,6,99
598012,2,3,16,15,1,16,119
598017,2,3,16,11,0,11,112
598020,2,3,16,5,0,5,104
598027,2,3,16,10,0,10,80
598031,2,3,16,14,0,14,154
598035,2,3,16,0,0,0,114
598051,2,3,16,1,0,1,79
598078,2,3,16,10,0,10,93
729308,2,3,16,7,0,7,114
729316,2,3,16,2,1,3,127
733986,2,3,16,14,0,14,141
733992,2,3,16,8,0,8,127
734000,2,3,16,12,1,13,125
734008,2,3,16,6,0,6,112
734040,2,3,16,18,4,22,133
734050,2,3,16,20,0,20,152
734052,2,3,16,9,0,9,164
829734,2,3,16,5,0,5,173
829778,2,3,16,6,0,6,136
829814,2,3,16,6,0,6,117
829822,2,3,16,6,2,8,129
829826,2,3,16,15,0,15,106
829828,2,3,16,12,1,13,125
335992,1,4,16,13,0,13,128
335996,1,4,16,8,0,8,146
336008,1,4,16,9,0,9,128
336024,1,4,16,7,0,7,151
336033,1,4,16,5,0,5,139
336040,1,4,16,7,0,7,140
336044,1,4,16,4,1,5,73
392191,1,4,16,6,0,6,123
392200,1,4,16,9,0,9,107
392205,1,4,16,6,1,7,93
392227,1,4,16,6,0,6,98
392234,1,4,16,11,0,11,105
419113,1,4,16,1,0,1,114
419117,1,4,16,9,0,9,142
419126,1,4,16,9,0,9,107
419137,1,4,16,6,0,6,124
419141,1,4,16,12,1,13,132
419148,1,4,16,6,0,6,132
419161,1,4,16,13,1,14,112
419164,1,4,16,8,0,8,139
501207,1,4,16,8,0,8,76
501225,1,4,16,3,3,6,175
501239,1,4,16,7,0,7,93
501253,1,4,16,5,1,6,102
501256,1,4,16,5,0,5,129
501262,1,4,16,6,2,8,130
501265,1,4,16,8,4,12,185
548328,1,4,16,11,0,11,98
548333,1,4,16,7,0,7,96
548336,1,4,16,7,0,7,112
548344,1,4,16,16,0,16,116
548348,1,4,16,8,0,8,129
548364,1,4,16,6,0,6,135
548374,1,4,16,7,0,7,106
548379,1,4,16,8,0,8,92
598012,1,4,16,7,0,7,123
598019,1,4,16,4,0,4,92
598021,1,4,16,10,0,10,109
598026,1,4,16,10,0,10,102
598033,1,4,16,16,0,16,119
598036,1,4,16,9,0,9,120
598057,1,4,16,13,0,13,120
598071,1,4,16,10,2,12,143
729300,1,4,16,3,0,3,155
729312,1,4,16,3,0,3,114
733978,1,4,16,5,0,5,131
733992,1,4,16,19,1,20,173
733996,1,4,16,25,1,26,166
734002,1,4,16,7,0,7,123
734030,1,4,16,9,0,9,116
734038,1,4,16,6,0,6,126
734052,1,4,16,8,1,9,176
734054,1,4,16,8,1,9,140
829722,1,4,16,12,1,13,140
829730,1,4,16,16,0,16,131
829738,1,4,16,3,0,3,115
829772,1,4,16,13,5,18,92
829796,1,4,16,7,0,7,141
829814,1,4,16,7,1,8,94
980910,1,4,16,5,0,5,130
980918,1,4,16,11,1,12,85
980930,1,4,16,7,0,7,102
980940,1,4,16,2,0,2,105
980960,1,4,16,13,0,13,123
980976,1,4,16,16,0,16,135
980996,1,4,16,13,0,13,134
981010,1,4,16,4,0,4,124
1082601,1,4,16,3,1,4,138
1082612,1,4,16,21,1,22,161
1082616,1,4,16,8,0,8,143
1082633,1,4,16,13,2,15,99
1082637,1,4,16,10,0,10,133
1082639,1,4,16,13,0,13,128
1082641,1,4,16,15,2,17,190
1082645,1,4,16,2,0,2,73
335988,2,4,16,10,1,11,176
336000,2,4,16,10,0,10,133
336004,2,4,16,10,1,11,140
336011,2,4,16,1,0,1,110
336018,2,4,16,3,1,4,119
336021,2,4,16,3,0,3,144
336036,2,4,16,3,1,4,139
392196,2,4,16,19,0,19,128
392209,2,4,16,7,0,7,102
392212,2,4,16,4,1,5,121
392215,2,4,16,17,1,18,114
392219,2,4,16,9,0,9,157
392221,2,4,16,5,0,5,124
392231,2,4,16,2,0,2,84
392239,2,4,16,2,0,2,61
419122,2,4,16,6,0,6,104
419129,2,4,16,7,0,7,134
419132,2,4,16,9,0,9,111
419144,2,4,16,12,1,13,169
419151,2,4,16,7,0,7,123
419154,2,4,16,7,0,7,95
501211,2,4,16,13,0,13,151
501217,2,4,16,11,1,12,151
501228,2,4,16,14,0,14,161
501242,2,4,16,12,0,12,113
501249,2,4,16,6,1,7,96
501259,2,4,16,4,0,4,149
501269,2,4,16,3,0,3,102
548314,2,4,16,10,0,10,127
548318,2,4,16,5,0,5,104
548324,2,4,16,11,0,11,99
548339,2,4,16,1,0,1,120
548355,2,4,16,14,0,14,146
548359,2,4,16,7,0,7,104
548371,2,4,16,11,0,11,141
548376,2,4,16,5,0,5,119
598030,2,4,16,12,0,12,141
598042,2,4,16,9,2,11,129
598046,2,4,16,11,0,11,133
598050,2,4,16,8,0,8,148
598061,2,4,16,3,0,3,96
598064,2,4,16,10,0,10,111
598069,2,4,16,15,1,16,154
729288,2,4,16,16,0,16,172
729296,2,4,16,11,0,11,143
729318,2,4,16,4,0,4,105
734012,2,4,16,6,0,6,175
734024,2,4,16,12,0,12,139
734048,2,4,16,5,0,5,97
829714,2,4,16,9,0,9,113
829746,2,4,16,17,1,18,138
829758,2,4,16,4,0,4,83
829764,2,4,16,12,0,12,105
829780,2,4,16,4,1,5,118
829804,2,4,16,10,2,12,116
980924,2,4,16,6,0,6,118
980946,2,4,16,12,0,12,133
980968,2,4,16,4,1,5,122
980982,2,4,16,13,0,13,136
980990,2,4,16,8,1,9,119
1082594,2,4,16,15,0,15,143
1082605,2,4,16,9,0,9,112
1082609,2,4,16,21,0,21,125
1082623,2,4,16,7,1,8,146
335989,1,5,16,10,0,10,102
336005,1,5,16,12,2,14,156
336013,1,5,16,1,0,1,103
336028,1,5,16,8,0,8,151
336038,1,5,16,7,0,7,174
336043,1,5,16,12,1,13,155
392195,1,5,16,4,0,4,111
392215,1,5,16,17,0,17,153
392222,1,5,16,2,0,2,101
392230,1,5,16,3,0,3,126
392238,1,5,16,5,0,5,84
419116,1,5,16,17,0,17,108
419120,1,5,16,2,0,2,80
419123,1,5,16,11,0,11,135
419129,1,5,16,11,0,11,144
419134,1,5,16,6,0,6,135
419146,1,5,16,1,1,2,130
419159,1,5,16,5,0,5,92
419163,1,5,16,3,0,3,104
501214,1,5,16,14,0,14,116
501219,1,5,16,1,0,1,81
501245,1,5,16,5,0,5,118
501257,1,5,16,7,0,7,119
501263,1,5,16,3,0,3,90
548314,1,5,16,11,0,11,138
548317,1,5,16,9,0,9,125
548325,1,5,16,15,1,16,101
548329,1,5,16,20,1,21,134
548337,1,5,16,9,0,9,116
548354,1,5,16,11,0,11,115
548359,1,5,16,7,0,7,133
548366,1,5,16,4,0,4,93
548370,1,5,16,9,1,10,136
548378,1,5,16,3,0,3,96
548382,1,5,16,13,1,14,120
598006,1,5,16,15,0,15,142
598010,1,5,16,1,0,1,101
598014,1,5,16,4,0,4,106
598024,1,5,16,7,0,7,132
598028,1,5,16,7,0,7,108
598031,1,5,16,5,2,7,138
598048,1,5,16,6,0,6,108
598077,1,5,16,6,0,6,110
729296,1,5,16,3,0,3,146
729320,1,5,16,12,0,12,118
733984,1,5,16,19,0,19,135
734008,1,5,16,5,1,6,120
734016,1,5,16,15,1,16,157
734046,1,5,16,7,0,7,141
829714,1,5,16,4,1,5,115
829746,1,5,16,6,0,6,142
829754,1,5,16,9,0,9,109
829782,1,5,16,15,1,16,130
829816,1,5,16,4,1,5,151
335992,2,5,16,10,0,10,152
335995,2,5,16,17,0,17,176
335997,2,5,16,9,0,9,130
336016,2,5,16,12,0,12,141
336020,2,5,16,18,0,18,138
336024,2,5,16,6,0,6,146
336032,2,5,16,6,0,6,134
336041,2,5,16,7,0,7,97
336045,2,5,16,13,0,13,125
392187,2,5,16,0,0,0,58
392200,2,5,16,4,0,4,86
392203,2,5,16,13,0,13,109
392207,2,5,16,6,0,6,107
392210,2,5,16,15,0,15,113
392225,2,5,16,3,0,3,98
392235,2,5,16,6,0,6,99
419112,2,5,16,11,0,11,154
419131,2,5,16,12,0,12,151
419139,2,5,16,4,0,4,111
419142,2,5,16,6,2,8,183
419155,2,5,16,2,0,2,91
501204,2,5,16,13,0,13,106
501209,2,5,16,3,0,3,124
501225,2,5,16,5,0,5,118
501236,2,5,16,6,1,7,80
501240,2,5,16,17,0,17,109
501254,2,5,16,5,0,5,119
548322,2,5,16,10,0,10,146
548331,2,5,16,8,0,8,142
548341,2,5,16,6,1,7,110
548350,2,5,16,9,0,9,117
548363,2,5,16,9,0,9,121
598019,2,5,16,7,0,7,101
598037,2,5,16,15,0,15,124
598041,2,5,16,10,0,10,130
598052,2,5,16,8,0,8,136
598054,2,5,16,7,0,7,133
598057,2,5,16,9,3,12,117
598063,2,5,16,3,0,3,133
598068,2,5,16,16,0,16,122
598070,2,5,16,2,0,2,75
598076,2,5,16,3,0,3,102
729290,2,5,16,6,0,6,108
729302,2,5,16,4,1,5,92
733980,2,5,16,9,0,9,124
733994,2,5,16,2,1,3,84
734004,2,5,16,4,0,4,126
734022,2,5,16,6,0,6,102
734038,2,5,16,11,0,11,103
829720,2,5,16,11,0,11,141
829726,2,5,16,11,2,13,126
829732,2,5,16,5,0,5,101
829740,2,5,16,6,0,6,144
829774,2,5,16,13,0,13,140
829792,2,5,16,9,0,9,135
829802,2,5,16,14,0,14,107
829824,2,5,16,3,0,3,95
336000,1,6,16,14,1,15,122
336003,1,6,16,8,0,8,159
336014,1,6,16,5,1,6,139
336020,1,6,16,4,1,5,101
336025,1,6,16,6,2,8,146
392194,1,6,16,11,0,11,134
392203,1,6,16,7,0,7,108
392228,1,6,16,10,0,10,119
392231,1,6,16,6,1,7,104
392235,1,6,16,4,0,4,99
392237,1,6,16,11,0,11,100
392242,1,6,16,11,0,11,120
419121,1,6,16,5,0,5,144
419133,1,6,16,6,0,6,134
419136,1,6,16,4,0,4,139
419139,1,6,16,11,0,11,131
419145,1,6,16,12,1,13,138
419154,1,6,16,5,2,7,88
501206,1,6,16,1,0,1,88
501209,1,6,16,17,0,17,106
501228,1,6,16,7,0,7,180
501232,1,6,16,7,0,7,122
501238,1,6,16,16,2,18,112
501243,1,6,16,10,0,10,108
548347,1,6,16,4,0,4,157
548350,1,6,16,8,1,9,114
548362,1,6,16,6,0,6,114
548369,1,6,16,6,0,6,84
598003,1,6,16,2,0,2,98
598015,1,6,16,4,0,4,76
598022,1,6,16,11,0,11,105
598040,1,6,16,9,1,10,111
598049,1,6,16,2,0,2,72
598054,1,6,16,3,0,3,104
598064,1,6,16,1,2,3,93
729286,1,6,16,11,0,11,93
733980,1,6,16,9,0,9,103
733986,1,6,16,6,2,8,130
733990,1,6,16,3,0,3,106
733998,1,6,16,7,0,7,128
734024,1,6,16,13,0,13,134
734044,1,6,16,4,0,4,107
829720,1,6,16,17,0,17,136
829736,1,6,16,11,0,11,132
829744,1,6,16,2,0,2,105
829752,1,6,16,15,0,15,152
829762,1,6,16,4,1,5,90
829788,1,6,16,11,0,11,106
829818,1,6,16,3,0,3,144
980908,1,6,16,0,0,0,92
980938,1,6,16,8,0,8,118
980956,1,6,16,10,1,11,131
980970,1,6,16,18,0,18,130
981002,1,6,16,4,0,4,77
981016,1,6,16,9,0,9,107
1082599,1,6,16,6,0,6,129
1082605,1,6,16,9,2,11,131
1082608,1,6,16,9,0,9,119
1082622,1,6,16,9,0,9,140
1082626,1,6,16,3,2,5,65
1082642,1,6,16,6,0,6,129
335989,2,6,16,4,0,4,132
336006,2,6,16,5,0,5,147
336009,2,6,16,5,0,5,119
336022,2,6,16,4,0,4,101
336031,2,6,16,6,0,6,133
336037,2,6,16,7,0,7,137
336043,2,6,16,5,0,5,87
392199,2,6,16,8,0,8,107
392206,2,6,16,8,2,10,111
392211,2,6,16,7,0,7,127
392216,2,6,16,9,0,9,123
392220,2,6,16,19,0,19,93
392224,2,6,16,10,0,10,110
392240,2,6,16,2,0,2,148
419113,2,6,16,9,0,9,114
419116,2,6,16,1,0,1,132
419119,2,6,16,1,0,1,120
419125,2,6,16,15,0,15,131
419149,2,6,16,7,0,7,142
419157,2,6,16,5,0,5,113
419160,2,6,16,10,0,10,90
419165,2,6,16,13,0,13,99
501218,2,6,16,12,0,12,140
501221,2,6,16,5,0,5,112
501235,2,6,16,11,2,13,99
501248,2,6,16,3,0,3,152
501251,2,6,16,15,0,15,114
501258,2,6,16,10,0,10,117
501262,2,6,16,5,0,5,102
548315,2,6,16,14,0,14,105
548326,2,6,16,6,0,6,121
548334,2,6,16,16,0,16,183
548338,2,6,16,8,0,8,139
548342,2,6,16,14,0,14,148
548354,2,6,16,10,0,10,144
548374,2,6,16,0,0,0,103
548377,2,6,16,9,0,9,158
548379,2,6,16,11,0,11,129
548383,2,6,16,8,0,8,117
548385,2,6,16,8,0,8,136
598006,2,6,16,11,0,11,131
598011,2,6,16,6,0,6,132
598025,2,6,16,2,0,2,82
598029,2,6,16,8,0,8,152
598033,2,6,16,11,0,11,111
598045,2,6,16,14,0,14,114
598059,2,6,16,6,0,6,129
598067,2,6,16,7,0,7,110
598072,2,6,16,11,1,12,116
729294,2,6,16,4,0,4,127
729298,2,6,16,2,0,2,84
729306,2,6,16,10,0,10,129
729314,2,6,16,2,0,2,100
734010,2,6,16,4,0,4,123
734016,2,6,16,4,2,6,99
734036,2,6,16,11,0,11,116
829712,2,6,16,8,0,8,110
829730,2,6,16,15,0,15,135
829766,2,6,16,7,0,7,113
829782,2,6,16,6,0,6,126
829798,2,6,16,21,1,22,126
829806,2,6,16,17,0,17,114
980926,2,6,16,12,0,12,158
980950,2,6,16,7,0,7,123
980966,2,6,16,8,1,9,130
980976,2,6,16,5,1,6,138
980988,2,6,16,3,0,3,117
980998,2,6,16,2,1,3,111
981008,2,6,16,9,1,10,117
1082595,2,6,16,8,0,8,121
1082611,2,6,16,8,0,8,135
1082614,2,6,16,5,1,6,97
1082630,2,6,16,6,0,6,148
1082632,2,6,16,7,0,7,189
1082640,2,6,16,14,0,14,152
1082646,2,6,16,9,0,9,113
335990,1,7,16,12,1,13,118
335999,1,7,16,14,1,15,114
336009,1,7,16,6,0,6,118
336029,1,7,16,14,0,14,128
336037,1,7,16,5,0,5,128
336041,1,7,16,7,2,9,106
392186,1,7,16,6,1,7,112
392202,1,7,16,4,0,4,155
392208,1,7,16,7,2,9,97
392213,1,7,16,8,0,8,94
392220,1,7,16,15,1,16,90
392223,1,7,16,10,0,10,114
392232,1,7,16,9,0,9,105
392240,1,7,16,10,0,10,119
419112,1,7,16,11,0,11,170
419119,1,7,16,9,0,9,174
419124,1,7,16,5,1,6,108
419135,1,7,16,10,0,10,110
419143,1,7,16,11,0,11,125
419151,1,7,16,9,0,9,118
419155,1,7,16,9,0,9,115
419157,1,7,16,15,1,16,123
419162,1,7,16,4,0,4,142
419166,1,7,16,8,0,8,94
419167,1,7,16,17,0,17,124
501215,1,7,16,18,2,20,145
501226,1,7,16,17,0,17,124
501229,1,7,16,11,1,12,114
501236,1,7,16,4,0,4,71
501242,1,7,16,10,1,11,125
501246,1,7,16,16,0,16,113
501251,1,7,16,12,0,12,141
501268,1,7,16,5,0,5,99
548322,1,7,16,11,0,11,148
548330,1,7,16,0,1,1,80
548339,1,7,16,3,0,3,132
548356,1,7,16,1,0,1,93
548365,1,7,16,6,0,6,101
548368,1,7,16,7,0,7,139
598007,1,7,16,7,0,7,103
598011,1,7,16,9,2,11,149
598016,1,7,16,2,1,3,118
598029,1,7,16,11,0,11,114
598038,1,7,16,7,1,8,151
598042,1,7,16,12,0,12,114
598044,1,7,16,6,0,6,95
598051,1,7,16,8,0,8,90
598055,1,7,16,13,0,13,119
598068,1,7,16,6,1,7,139
598078,1,7,16,6,0,6,106
729292,1,7,16,6,0,6,98
729308,1,7,16,5,0,5,113
729314,1,7,16,11,0,11,80
733988,1,7,16,10,0,10,129
734000,1,7,16,12,0,12,111
734014,1,7,16,15,1,16,115
734022,1,7,16,12,0,12,134
734036,1,7,16,4,0,4,153
734050,1,7,16,13,0,13,140
829710,1,7,16,8,0,8,109
829726,1,7,16,16,0,16,99
829734,1,7,16,6,0,6,138
829742,1,7,16,18,1,19,152
829756,1,7,16,9,0,9,121
829774,1,7,16,6,0,6,126
829780,1,7,16,13,0,13,136
829810,1,7,16,11,2,13,112
829822,1,7,16,4,0,4,139
829828,1,7,16,4,0,4,150
980906,1,7,16,7,0,7,75
980922,1,7,16,6,0,6,88
980928,1,7,16,7,0,7,118
980946,1,7,16,16,0,16,156
980990,1,7,16,17,0,17,97
980998,1,7,16,17,0,17,161
981012,1,7,16,11,0,11,145
1082592,1,7,16,7,0,7,127
1082614,1,7,16,7,1,8,110
1082635,1,7,16,6,1,7,155
1082638,1,7,16,9,2,11,110
1082644,1,7,16,12,0,12,130
1082650,1,7,16,5,0,5,86
335994,2,7,16,13,0,13,147
335996,2,7,16,4,0,4,105
336002,2,7,16,11,0,11,121
336013,2,7,16,0,2,2,104
336017,2,7,16,9,0,9,126
336033,2,7,16,11,1,12,156
392197,2,7,16,11,0,11,119
392202,2,7,16,0,0,0,95
392205,2,7,16,6,1,7,88
392217,2,7,16,2,1,3,103
392227,2,7,16,2,2,4,117
392230,2,7,16,5,4,9,107
419119,2,7,16,0,0,0,120
419127,2,7,16,7,0,7,129
419130,2,7,16,19,0,19,152
419137,2,7,16,3,2,5,123
419147,2,7,16,8,3,11,103
419170,2,7,16,7,1,8,109
501206,2,7,16,5,0,5,90
501210,2,7,16,6,0,6,122
501223,2,7,16,6,0,6,95
501261,2,7,16,7,0,7,83
501272,2,7,16,13,0,13,123
501274,2,7,16,3,0,3,123
501275,2,7,16,8,0,8,111
548311,2,7,16,3,1,4,104
548313,2,7,16,3,0,3,71
548319,2,7,16,9,0,9,94
548344,2,7,16,10,1,11,117
548347,2,7,16,3,0,3,142
548351,2,7,16,4,0,4,81
548360,2,7,16,5,0,5,136
548372,2,7,16,7,2,9,115
548375,2,7,16,10,0,10,90
548382,2,7,16,8,1,9,149
548384,2,7,16,4,1,5,117
598004,2,7,16,10,0,10,106
598024,2,7,16,12,0,12,83
598034,2,7,16,8,0,8,124
598060,2,7,16,10,0,10,93
598065,2,7,16,3,1,4,117
598071,2,7,16,5,5,10,117
598075,2,7,16,2,0,2,129
598077,2,7,16,3,0,3,129
729284,2,7,16,11,0,11,106
729322,2,7,16,8,1,9,115
733978,2,7,16,5,1,6,124
734006,2,7,16,7,0,7,132
734030,2,7,16,8,1,9,142
829722,2,7,16,17,0,17,96
829752,2,7,16,11,0,11,131
829788,2,7,16,9,2,11,110
829794,2,7,16,7,0,7,108
829800,2,7,16,16,0,16,151
980914,2,7,16,18,0,18,157
980932,2,7,16,14,1,15,143
980938,2,7,16,4,0,4,118
980952,2,7,16,21,2,23,149
980962,2,7,16,12,0,12,127
980978,2,7,16,6,1,7,92
980986,2,7,16,9,2,11,108
1082597,2,7,16,4,0,4,119
1082600,2,7,16,13,0,13,134
1082602,2,7,16,16,3,19,110
1082606,2,7,16,9,0,9,141
1082612,2,7,16,8,0,8,199
1082618,2,7,16,9,0,9,122
1082625,2,7,16,9,0,9,123
1082628,2,7,16,9,2,11,125
1082641,2,7,16,26,1,27,175
1082647,2,7,16,3,1,4,107
335991,1,8,16,4,1,5,82
335993,1,8,16,8,1,9,82
335995,1,8,16,12,0,12,160
336004,1,8,16,8,0,8,119
336007,1,8,16,8,0,8,131
336016,1,8,16,2,0,2,105
336036,1,8,16,11,0,11,122
336042,1,8,16,10,1,11,104
392193,1,8,16,10,0,10,149
392197,1,8,16,5,0,5,142
392206,1,8,16,7,2,9,127
392210,1,8,16,7,0,7,109
392217,1,8,16,3,1,4,103
392221,1,8,16,11,2,13,113
392225,1,8,16,10,0,10,118
392244,1,8,16,8,0,8,109
419115,1,8,16,10,2,12,139
419122,1,8,16,9,0,9,134
419125,1,8,16,9,0,9,124
419131,1,8,16,4,1,5,113
419156,1,8,16,11,2,13,124
419165,1,8,16,4,0,4,121
419169,1,8,16,3,0,3,81
501204,1,8,16,15,0,15,105
501213,1,8,16,16,0,16,130
501217,1,8,16,8,1,9,122
501221,1,8,16,4,0,4,133
501234,1,8,16,14,1,15,105
501248,1,8,16,9,0,9,134
501255,1,8,16,7,0,7,107
501261,1,8,16,6,1,7,89
501269,1,8,16,11,0,11,158
548319,1,8,16,11,2,13,109
548326,1,8,16,5,0,5,125
548331,1,8,16,9,4,13,132
548334,1,8,16,13,0,13,140
548340,1,8,16,4,0,4,102
548346,1,8,16,19,0,19,141
548351,1,8,16,5,0,5,87
548353,1,8,16,12,0,12,122
548361,1,8,16,9,0,9,126
548371,1,8,16,10,1,11,137
548381,1,8,16,8,1,9,84
336012,2,8,16,10,0,10,125
336019,2,8,16,12,0,12,137
336025,2,8,16,9,0,9,137
336029,2,8,16,8,0,8,114
336039,2,8,16,3,0,3,115
392201,2,8,16,2,0,2,131
392228,2,8,16,11,0,11,145
392233,2,8,16,8,0,8,113
392234,2,8,16,4,0,4,90
392241,2,8,16,6,0,6,125
392242,2,8,16,2,0,2,148
419111,2,8,16,6,0,6,128
419135,2,8,16,7,0,7,129
419140,2,8,16,3,0,3,128
419143,2,8,16,9,1,10,108
419146,2,8,16,4,0,4,122
419150,2,8,16,11,0,11,136
419152,2,8,16,4,1,5,107
419161,2,8,16,7,2,9,140
419168,2,8,16,3,0,3,84
501208,2,8,16,11,1,12,113
501229,2,8,16,1,0,1,101
501241,2,8,16,4,0,4,122
501244,2,8,16,10,1,11,119
501264,2,8,16,3,1,4,112
548316,2,8,16,16,0,16,117
548357,2,8,16,4,0,4,106
548364,2,8,16,11,0,11,110
548378,2,8,16,5,0,5,104
501205,1,9,16,2,0,2,126
501212,1,9,16,2,0,2,113
501224,1,9,16,5,1,6,106
501230,1,9,16,2,0,2,90
501247,1,9,16,4,0,4,102
501252,1,9,16,6,0,6,103
501259,1,9,16,9,0,9,139
501215,2,9,16,9,0,9,143
501234,2,9,16,1,0,1,74
501238,2,9,16,7,0,7,99
501266,2,9,16,5,0,5,95
501218,1,10,16,13,0,13,141
501223,1,10,16,11,0,11,111
501233,1,10,16,10,0,10,101
501240,1,10,16,6,0,6,108
501264,1,10,16,6,1,7,99
501267,1,10,16,5,1,6,87
548313,1,10,16,9,0,9,100
548318,1,10,16,8,0,8,121
548324,1,10,16,3,0,3,99
548332,1,10,16,7,0,7,141
548338,1,10,16,11,0,11,136
548342,1,10,16,4,0,4,99
548363,1,10,16,8,0,8,99
598008,1,10,16,13,1,14,78
598020,1,10,16,12,0,12,118
598030,1,10,16,4,0,4,128
598052,1,10,16,8,0,8,133
598060,1,10,16,5,1,6,94
598066,1,10,16,4,0,4,116
598072,1,10,16,14,0,14,121
501212,2,10,16,3,1,4,119
501231,2,10,16,5,0,5,98
501237,2,10,16,19,0,19,127
501246,2,10,16,5,1,6,96
501253,2,10,16,1,2,3,117
501255,2,10,16,7,0,7,119
548327,2,10,16,10,1,11,117
548335,2,10,16,11,6,17,124
548346,2,10,16,10,0,10,111
548353,2,10,16,9,0,9,125
548356,2,10,16,9,0,9,85
548358,2,10,16,7,0,7,116
548367,2,10,16,4,0,4,109
548370,2,10,16,8,0,8,105
548380,2,10,16,5,0,5,87
598005,2,10,16,6,0,6,84
598014,2,10,16,11,0,11,128
598016,2,10,16,3,0,3,121
598023,2,10,16,8,0,8,95
598032,2,10,16,8,0,8,119
598040,2,10,16,8,1,9,119
598043,2,10,16,2,1,3,96
598047,2,10,16,21,0,21,143
598058,2,10,16,15,0,15,95
598005,1,11,16,5,0,5,92
598023,1,11,16,5,1,6,81
598035,1,11,16,4,0,4,100
598037,1,11,16,6,1,7,99
598053,1,11,16,18,0,18,116
598061,1,11,16,6,0,6,104
598065,1,11,16,14,0,14,145
598070,1,11,16,14,0,14,104
598076,1,11,16,10,1,11,88
729290,1,11,16,9,0,9,99
729306,1,11,16,10,0,10,128
729316,1,11,16,3,1,4,102
729322,1,11,16,12,1,13,130
733982,1,11,16,8,1,9,115
733994,1,11,16,3,1,4,106
734006,1,11,16,9,0,9,112
734012,1,11,16,11,0,11,138
734020,1,11,16,5,0,5,114
734042,1,11,16,3,1,4,125
829732,1,11,16,5,0,5,95
829748,1,11,16,10,0,10,143
829764,1,11,16,10,0,10,114
829778,1,11,16,12,1,13,156
829792,1,11,16,18,0,18,151
829798,1,11,16,15,0,15,114
829804,1,11,16,6,1,7,147
829820,1,11,16,5,0,5,85
980920,1,11,16,11,0,11,105
980948,1,11,16,6,0,6,78
980958,1,11,16,12,0,12,153
980978,1,11,16,12,2,14,130
980984,1,11,16,3,0,3,99
980988,1,11,16,4,1,5,118
981008,1,11,16,5,0,5,120
981020,1,11,16,15,0,15,124
981024,1,11,16,7,0,7,147
1082591,1,11,16,4,0,4,155
1082600,1,11,16,6,2,8,126
1082609,1,11,16,6,1,7,115
1082611,1,11,16,13,0,13,148
1082615,1,11,16,8,1,9,122
1082623,1,11,16,5,0,5,160
1082627,1,11,16,15,0,15,169
1082630,1,11,16,11,1,12,126
1082648,1,11,16,2,3,5,103
598009,2,11,16,8,0,8,99
598015,2,11,16,13,0,13,89
598018,2,11,16,6,0,6,110
598026,2,11,16,6,4,10,97
598044,2,11,16,12,1,13,119
598056,2,11,16,2,0,2,111
598074,2,11,16,2,0,2,108
729300,2,11,16,9,0,9,108
734026,2,11,16,9,1,10,126
734034,2,11,16,9,0,9,157
829716,2,11,16,17,0,17,132
829724,2,11,16,5,0,5,142
829736,2,11,16,10,0,10,120
829756,2,11,16,10,0,10,114
829786,2,11,16,4,0,4,92
980912,2,11,16,8,0,8,147
980928,2,11,16,14,0,14,122
980940,2,11,16,10,0,10,129
980972,2,11,16,7,0,7,98
980996,2,11,16,9,0,9,139
981014,2,11,16,4,2,6,120
981022,2,11,16,2,0,2,118
1082596,2,11,16,9,0,9,140
1082604,2,11,16,3,0,3,116
1082634,2,11,16,7,0,7,108
1082638,2,11,16,8,0,8,121
1082643,2,11,16,8,0,8,135
980916,1,12,16,13,0,13,134
980924,1,12,16,7,0,7,116
980944,1,12,16,8,0,8,108
980954,1,12,16,9,0,9,144
980962,1,12,16,3,1,4,124
980974,1,12,16,8,0,8,146
980994,1,12,16,2,0,2,96
1082594,1,12,16,15,0,15,123
1082603,1,12,16,9,0,9,135
1082607,1,12,16,10,0,10,127
1082618,1,12,16,6,0,6,126
1082620,1,12,16,11,0,11,140
1082624,1,12,16,4,0,4,115
1082634,1,12,16,5,0,5,105
1082647,1,12,16,5,0,5,109
980936,2,12,16,5,1,6,121
980970,2,12,16,3,1,4,120
980984,2,12,16,9,1,10,96
981010,2,12,16,16,0,16,119
1082592,2,12,16,9,0,9,148
1082599,2,12,16,2,0,2,108
1082615,2,12,16,6,0,6,121
1082629,2,12,16,14,2,16,118
1082631,2,12,16,5,0,5,139
1082642,2,12,16,8,1,9,126
1082650,2,12,16,14,0,14,97
980934,1,13,16,7,2,9,113
980950,1,13,16,2,0,2,134
980966,1,13,16,11,0,11,110
980972,1,13,16,8,0,8,93
981018,1,13,16,3,1,4,108
981022,1,13,16,11,0,11,120
1082593,1,13,16,5,0,5,130
1082596,1,13,16,8,0,8,110
1082606,1,13,16,5,1,6,126
1082625,1,13,16,2,0,2,102
1082629,1,13,16,5,0,5,140
1082632,1,13,16,6,1,7,171
1082640,1,13,16,10,4,14,148
1082643,1,13,16,8,0,8,134
980910,2,13,16,7,1,8,142
980916,2,13,16,15,0,15,147
980922,2,13,16,10,0,10,109
980942,2,13,16,6,0,6,142
980954,2,13,16,14,0,14,161
980960,2,13,16,12,0,12,99
980980,2,13,16,16,0,16,151
980992,2,13,16,1,0,1,95
981012,2,13,16,9,1,10,157
1082603,2,13,16,13,0,13,146
1082610,2,13,16,7,0,7,146
1082613,2,13,16,9,0,9,155
1082616,2,13,16,6,1,7,128
1082637,2,13,16,10,0,10,158
335987,1,1,17,14,0,14,172
335998,1,1,17,10,1,11,119
336002,1,1,17,10,1,11,104
336019,1,1,17,19,0,19,155
336022,1,1,17,4,1,5,109
336030,1,1,17,4,0,4,118
336032,1,1,17,10,0,10,116
392189,1,1,17,8,0,8,82
392204,1,1,17,5,1,6,113
392212,1,1,17,8,0,8,113
392216,1,1,17,17,0,17,128
392224,1,1,17,6,0,6,94
392226,1,1,17,20,0,20,133
392233,1,1,17,6,1,7,111
419111,1,1,17,18,0,18,121
419127,1,1,17,6,1,7,125
419132,1,1,17,9,2,11,141
419140,1,1,17,18,3,21,146
419144,1,1,17,6,0,6,165
419149,1,1,17,9,0,9,139
419153,1,1,17,3,0,3,136
419158,1,1,17,14,0,14,112
501208,1,1,17,5,1,6,133
501227,1,1,17,8,2,10,138
501235,1,1,17,7,1,8,117
501244,1,1,17,13,1,14,135
501272,1,1,17,11,2,13,137
501274,1,1,17,11,0,11,121
548320,1,1,17,7,0,7,142
548349,1,1,17,16,0,16,160
548358,1,1,17,2,0,2,127
548373,1,1,17,5,0,5,127
548375,1,1,17,11,1,12,112
548380,1,1,17,6,0,6,113
548383,1,1,17,9,0,9,115
598013,1,1,17,6,1,7,130
598018,1,1,17,12,1,13,135
598027,1,1,17,9,0,9,100
598034,1,1,17,7,1,8,133
598045,1,1,17,15,0,15,106
598058,1,1,17,17,0,17,116
598074,1,1,17,5,0,5,100
729284,1,1,17,6,4,10,135
729294,1,1,17,8,0,8,132
729304,1,1,17,16,0,16,129
734032,1,1,17,8,1,9,159
734048,1,1,17,14,0,14,128
829718,1,1,17,6,0,6,137
829766,1,1,17,11,5,16,135
829786,1,1,17,10,1,11,132
980914,1,1,17,12,0,12,163
980952,1,1,17,13,0,13,143
980968,1,1,17,10,0,10,138
980980,1,1,17,10,1,11,119
981000,1,1,17,8,0,8,145
981006,1,1,17,10,0,10,103
981014,1,1,17,9,0,9,155
1082597,1,1,17,5,0,5,136
1082604,1,1,17,14,0,14,150
1082613,1,1,17,5,0,5,154
1082617,1,1,17,6,0,6,122
1082631,1,1,17,1,0,1,120
1082649,1,1,17,7,2,9,101
335991,2,1,17,3,0,3,90
336005,2,1,17,6,1,7,143
336008,2,1,17,11,0,11,124
336040,2,1,17,18,0,18,136
392195,2,1,17,8,0,8,128
392208,2,1,17,6,1,7,118
392236,2,1,17,14,0,14,151
392238,2,1,17,5,1,6,81
419114,2,1,17,8,0,8,126
419118,2,1,17,3,0,3,100
419123,2,1,17,8,0,8,117
419136,2,1,17,7,1,8,116
419163,2,1,17,1,0,1,133
419166,2,1,17,6,5,11,129
501203,2,1,17,3,0,3,121
501214,2,1,17,10,0,10,150
501224,2,1,17,2,1,3,101
501239,2,1,17,2,0,2,115
501247,2,1,17,13,0,13,119
501267,2,1,17,2,0,2,119
548317,2,1,17,13,1,14,112
548325,2,1,17,6,0,6,108
548328,2,1,17,12,0,12,111
548333,2,1,17,10,0,10,127
548340,2,1,17,6,0,6,107
548352,2,1,17,6,0,6,118
548362,2,1,17,5,7,12,146
548368,2,1,17,7,0,7,124
548386,2,1,17,12,0,12,164
598003,2,1,17,5,3,8,114
598010,2,1,17,5,0,5,109
598021,2,1,17,6,0,6,123
598036,2,1,17,7,1,8,135
598039,2,1,17,12,1,13,151
598048,2,1,17,8,0,8,129
598055,2,1,17,3,0,3,100
598062,2,1,17,14,1,15,102
598066,2,1,17,7,0,7,134
729312,2,1,17,9,1,10,95
729320,2,1,17,14,1,15,126
733976,2,1,17,4,0,4,114
733984,2,1,17,6,0,6,132
733990,2,1,17,13,0,13,151
734002,2,1,17,8,0,8,139
734014,2,1,17,11,1,12,128
734020,2,1,17,6,0,6,113
734028,2,1,17,17,0,17,145
734054,2,1,17,17,1,18,179
829710,2,1,17,19,1,20,151
829728,2,1,17,15,0,15,147
829738,2,1,17,13,0,13,152
829744,2,1,17,5,0,5,136
829770,2,1,17,5,1,6,101
829796,2,1,17,5,0,5,160
829810,2,1,17,14,0,14,144
829816,2,1,17,4,2,6,157
980920,2,1,17,5,0,5,128
980930,2,1,17,12,1,13,137
980944,2,1,17,14,3,17,136
980956,2,1,17,15,0,15,151
980964,2,1,17,24,0,24,163
981020,2,1,17,7,1,8,124
1082601,2,1,17,7,0,7,171
1082608,2,1,17,6,0,6,147
1082620,2,1,17,5,0,5,178
1082622,2,1,17,4,1,5,161
1082627,2,1,17,8,0,8,138
1082639,2,1,17,7,0,7,131
1082644,2,1,17,13,1,14,149
335997,1,2,17,4,0,4,112
336011,1,2,17,13,0,13,115
336017,1,2,17,8,3,11,115
336021,1,2,17,5,0,5,123
336031,1,2,17,14,0,14,119
336034,1,2,17,11,0,11,98
336039,1,2,17,4,0,4,126
392187,1,2,17,10,0,10,98
392196,1,2,17,4,1,5,136
392199,1,2,17,10,0,10,119
392209,1,2,17,8,0,8,112
392218,1,2,17,10,0,10,92
392241,1,2,17,2,0,2,134
419114,1,2,17,9,0,9,106
419128,1,2,17,9,0,9,119
419138,1,2,17,7,0,7,124
419150,1,2,17,22,1,23,138
501210,1,2,17,7,1,8,111
501237,1,2,17,7,0,7,141
501249,1,2,17,13,0,13,176
501273,1,2,17,4,0,4,135
501275,1,2,17,4,0,4,159
548315,1,2,17,6,2,8,121
548323,1,2,17,8,4,12,173
548341,1,2,17,13,1,14,136
548355,1,2,17,6,0,6,135
548367,1,2,17,5,1,6,138
548372,1,2,17,5,1,6,128
548377,1,2,17,16,1,17,176
598004,1,2,17,5,4,9,115
598009,1,2,17,12,0,12,108
598017,1,2,17,10,0,10,135
598032,1,2,17,17,1,18,219
598041,1,2,17,13,1,14,137
598047,1,2,17,12,0,12,142
598050,1,2,17,3,1,4,130
598059,1,2,17,18,0,18,124
598062,1,2,17,6,0,6,102
598069,1,2,17,4,1,5,145
729318,1,2,17,1,4,5,105
734004,1,2,17,12,3,15,138
734010,1,2,17,21,0,21,136
734026,1,2,17,10,0,10,134
734040,1,2,17,10,1,11,121
829724,1,2,17,8,1,9,134
829768,1,2,17,13,2,15,157
829790,1,2,17,10,1,11,190
829800,1,2,17,24,1,25,185
829824,1,2,17,12,1,13,137
829826,1,2,17,9,1,10,113
980912,1,2,17,18,1,19,183
980926,1,2,17,9,0,9,173
980932,1,2,17,11,0,11,134
980936,1,2,17,7,0,7,144
980942,1,2,17,16,0,16,144
980964,1,2,17,6,0,6,131
980982,1,2,17,14,0,14,143
980986,1,2,17,7,0,7,108
980992,1,2,17,13,1,14,169
1082595,1,2,17,8,0,8,142
1082598,1,2,17,15,1,16,96
1082602,1,2,17,5,0,5,119
1082610,1,2,17,6,0,6,166
1082621,1,2,17,4,1,5,116
1082628,1,2,17,9,1,10,132
1082636,1,2,17,7,0,7,115
1082646,1,2,17,13,1,14,126
335990,2,2,17,10,0,10,136
336001,2,2,17,8,0,8,148
336003,2,2,17,4,0,4,144
336007,2,2,17,13,1,14,137
336028,2,2,17,18,0,18,107
392193,2,2,17,10,1,11,132
392204,2,2,17,8,0,8,115
392213,2,2,17,6,1,7,134
392223,2,2,17,6,1,7,113
392226,2,2,17,12,0,12,134
392229,2,2,17,10,1,11,104
392237,2,2,17,7,0,7,112
392243,2,2,17,14,1,15,127
392244,2,2,17,5,0,5,113
419117,2,2,17,11,0,11,170
419124,2,2,17,4,0,4,136
419133,2,2,17,10,0,10,136
419141,2,2,17,20,5,25,159
419145,2,2,17,9,0,9,128
419153,2,2,17,21,0,21,158
419156,2,2,17,3,1,4,113
419162,2,2,17,7,1,8,115
419167,2,2,17,6,0,6,129
501205,2,2,17,6,0,6,129
501213,2,2,17,10,0,10,118
501216,2,2,17,5,0,5,128
501227,2,2,17,7,0,7,166
501232,2,2,17,8,2,10,139
501257,2,2,17,12,0,12,147
501265,2,2,17,11,0,11,121
501271,2,2,17,4,0,4,116
501276,2,2,17,4,0,4,119
548320,2,2,17,8,0,8,99
548329,2,2,17,12,0,12,120
548332,2,2,17,11,0,11,139
548336,2,2,17,7,1,8,140
548349,2,2,17,13,0,13,111
548361,2,2,17,13,0,13,143
548365,2,2,17,5,0,5,126
548381,2,2,17,1,0,1,98
598013,2,2,17,9,1,10,145
598022,2,2,17,1,0,1,130
598028,2,2,17,6,0,6,108
598038,2,2,17,5,1,6,108
598053,2,2,17,15,1,16,154
729286,2,2,17,13,1,14,146
729292,2,2,17,14,0,14,109
729304,2,2,17,3,0,3,126
733982,2,2,17,3,0,3,119
733988,2,2,17,10,0,10,144
733996,2,2,17,7,0,7,135
734018,2,2,17,13,1,14,110
734032,2,2,17,5,0,5,133
829718,2,2,17,14,1,15,147
829742,2,2,17,16,0,16,160
829750,2,2,17,1,0,1,124
829754,2,2,17,4,0,4,134
829784,2,2,17,2,1,3,112
980958,2,2,17,10,0,10,152
980974,2,2,17,7,0,7,152
981000,2,2,17,13,0,13,157
981016,2,2,17,7,0,7,126
981018,2,2,17,11,1,12,138
981024,2,2,17,10,0,10,172
1082591,2,2,17,3,0,3,154
1082607,2,2,17,13,0,13,115
1082624,2,2,17,8,0,8,82
1082633,2,2,17,5,0,5,111
335988,1,3,17,14,0,14,183
335994,1,3,17,10,0,10,168
336001,1,3,17,16,0,16,132
336006,1,3,17,9,1,10,137
336010,1,3,17,1,0,1,97
336012,1,3,17,12,0,12,107
336018,1,3,17,5,0,5,154
336023,1,3,17,10,1,11,113
336045,1,3,17,3,0,3,130
392190,1,3,17,7,0,7,151
392201,1,3,17,13,0,13,133
392207,1,3,17,12,0,12,120
392211,1,3,17,6,0,6,144
392214,1,3,17,11,0,11,148
392219,1,3,17,18,4,22,176
392229,1,3,17,5,0,5,112
392236,1,3,17,12,0,12,152
392239,1,3,17,2,0,2,102
392243,1,3,17,10,0,10,124
419118,1,3,17,12,0,12,115
419130,1,3,17,13,2,15,151
419142,1,3,17,12,0,12,208
419147,1,3,17,6,1,7,135
419152,1,3,17,7,0,7,121
419160,1,3,17,1,1,2,79
419168,1,3,17,8,1,9,112
419170,1,3,17,10,2,12,139
501203,1,3,17,6,0,6,127
501211,1,3,17,9,0,9,149
501216,1,3,17,16,0,16,153
501220,1,3,17,14,0,14,131
501231,1,3,17,9,0,9,118
501241,1,3,17,14,1,15,126
501250,1,3,17,12,1,13,94
501254,1,3,17,18,0,18,158
501258,1,3,17,8,1,9,126
501266,1,3,17,6,0,6,120
501271,1,3,17,9,0,9,91
501276,1,3,17,5,0,5,172
548311,1,3,17,3,0,3,102
548316,1,3,17,12,0,12,145
548321,1,3,17,6,0,6,89
548327,1,3,17,4,0,4,129
548335,1,3,17,9,0,9,125
548352,1,3,17,11,0,11,113
548357,1,3,17,3,1,4,133
548360,1,3,17,11,0,11,149
548376,1,3,17,15,0,15,93
548384,1,3,17,13,0,13,141
548385,1,3,17,16,0,16,183
548386,1,3,17,14,0,14,160
598025,1,3,17,8,0,8,131
598039,1,3,17,9,1,10,168
598043,1,3,17,6,1,7,121
598046,1,3,17,18,0,18,150
598056,1,3,17,23,2,25,177
598063,1,3,17,8,0,8,113
598067,1,3,17,6,0,6,131
598075,1,3,17,14,0,14,151
729288,1,3,17,11,1,12,172
729298,1,3,17,15,1,16,135
729302,1,3,17,7,4,11,117
733976,1,3,17,14,1,15,148
734018,1,3,17,3,0,3,117
734028,1,3,17,4,0,4,124
734034,1,3,17,10,0,10,140
829712,1,3,17,1,0,1,120
829716,1,3,17,11,1,12,164
829728,1,3,17,8,0,8,136
829740,1,3,17,9,0,9,122
829750,1,3,17,15,0,15,155
829758,1,3,17,8,0,8,161
829770,1,3,17,9,0,9,115
829784,1,3,17,9,0,9,122
829794,1,3,17,13,1,14,122
829802,1,3,17,12,1,13,128
829806,1,3,17,12,1,13,99
335998,2,3,17,13,0,13,152
336014,2,3,17,7,0,7,155
336034,2,3,17,5,0,5,98
336038,2,3,17,12,0,12,177
336042,2,3,17,3,0,3,120
392186,2,3,17,13,0,13,127
392194,2,3,17,5,0,5,161
392207,2,3,17,5,0,5,112
392222,2,3,17,8,1,9,126
392232,2,3,17,7,4,11,121
419115,2,3,17,11,0,11,129
419121,2,3,17,10,1,11,167
419126,2,3,17,5,0,5,117
419128,2,3,17,3,2,5,112
419134,2,3,17,6,0,6,131
419138,2,3,17,4,1,5,141
419164,2,3,17,8,0,8,149
501226,2,3,17,10,2,12,135
501233,2,3,17,9,1,10,120
501245,2,3,17,12,1,13,138
501273,2,3,17,20,0,20,138
548323,2,3,17,13,2,15,156
548337,2,3,17,2,0,2,118
548348,2,3,17,10,1,11,118
548366,2,3,17,16,1,17,97
548373,2,3,17,3,0,3,127
598007,2,3,17,10,0,10,109
598012,2,3,17,13,0,13,132
598017,2,3,17,13,0,13,125
598020,2,3,17,10,0,10,114
598027,2,3,17,12,1,13,93
598031,2,3,17,3,0,3,157
598035,2,3,17,14,0,14,128
598078,2,3,17,3,1,4,97
729308,2,3,17,3,3,6,120
729316,2,3,17,4,0,4,131
733986,2,3,17,5,0,5,146
733992,2,3,17,17,0,17,144
734000,2,3,17,3,3,6,131
734008,2,3,17,4,1,5,117
734040,2,3,17,10,0,10,143
734050,2,3,17,8,0,8,160
734052,2,3,17,3,0,3,167
829734,2,3,17,15,1,16,189
829778,2,3,17,8,0,8,144
829814,2,3,17,17,0,17,134
829822,2,3,17,12,0,12,141
829826,2,3,17,4,3,7,113
829828,2,3,17,7,0,7,132
335992,1,4,17,8,0,8,136
335996,1,4,17,6,0,6,152
336008,1,4,17,11,1,12,140
336024,1,4,17,23,2,25,176
336033,1,4,17,4,5,9,148
336040,1,4,17,7,0,7,147
336044,1,4,17,6,0,6,79
392191,1,4,17,7,0,7,130
392200,1,4,17,2,2,4,111
392205,1,4,17,1,4,5,98
392227,1,4,17,3,1,4,102
392234,1,4,17,11,0,11,116
419113,1,4,17,2,5,7,121
419117,1,4,17,13,1,14,156
419126,1,4,17,7,0,7,114
419137,1,4,17,8,1,9,133
419141,1,4,17,6,2,8,140
419148,1,4,17,2,0,2,134
419161,1,4,17,20,1,21,133
419164,1,4,17,7,0,7,146
501207,1,4,17,4,0,4,80
501225,1,4,17,3,0,3,178
501239,1,4,17,7,0,7,100
501253,1,4,17,7,0,7,109
501256,1,4,17,14,0,14,143
501262,1,4,17,7,0,7,137
501265,1,4,17,7,1,8,193
548328,1,4,17,3,0,3,101
548333,1,4,17,6,1,7,103
548336,1,4,17,12,1,13,125
548344,1,4,17,8,0,8,124
548348,1,4,17,8,0,8,137
548364,1,4,17,3,0,3,138
548374,1,4,17,11,0,11,117
548379,1,4,17,21,1,22,114
598012,1,4,17,8,0,8,131
598019,1,4,17,8,0,8,100
598021,1,4,17,3,0,3,112
598026,1,4,17,3,0,3,105
598033,1,4,17,11,0,11,130
598036,1,4,17,5,1,6,126
598057,1,4,17,7,0,7,127
598071,1,4,17,13,0,13,156
729300,1,4,17,7,0,7,162
729312,1,4,17,4,0,4,118
733978,1,4,17,9,0,9,140
733992,1,4,17,6,2,8,181
733996,1,4,17,7,0,7,173
734002,1,4,17,4,0,4,127
734030,1,4,17,7,0,7,123
734038,1,4,17,6,1,7,133
734052,1,4,17,17,0,17,193
734054,1,4,17,15,4,19,159
829722,1,4,17,10,0,10,150
829730,1,4,17,5,1,6,137
829738,1,4,17,14,0,14,129
829772,1,4,17,5,0,5,97
829796,1,4,17,8,0,8,149
829814,1,4,17,6,0,6,100
980910,1,4,17,5,1,6,136
980918,1,4,17,4,1,5,90
980930,1,4,17,6,0,6,108
980940,1,4,17,9,1,10,115
980960,1,4,17,14,0,14,137
980976,1,4,17,12,0,12,147
980996,1,4,17,14,0,14,148
981010,1,4,17,16,0,16,140
1082601,1,4,17,7,0,7,145
1082612,1,4,17,3,1,4,165
1082616,1,4,17,8,1,9,152
1082633,1,4,17,11,0,11,110
1082637,1,4,17,17,0,17,150
1082639,1,4,17,6,0,6,134
1082641,1,4,17,8,0,8,198
335988,2,4,17,9,1,10,186
336000,2,4,17,9,0,9,142
336004,2,4,17,8,0,8,148
336011,2,4,17,7,0,7,117
336018,2,4,17,8,0,8,127
336036,2,4,17,9,1,10,149
392196,2,4,17,13,0,13,141
392209,2,4,17,13,1,14,116
392212,2,4,17,8,0,8,129
392215,2,4,17,6,0,6,120
392219,2,4,17,4,2,6,163
392221,2,4,17,16,0,16,140
392231,2,4,17,3,0,3,87
392239,2,4,17,7,1,8,69
419122,2,4,17,21,0,21,125
419129,2,4,17,4,0,4,138
419132,2,4,17,11,0,11,122
419144,2,4,17,19,0,19,188
419151,2,4,17,8,1,9,132
419154,2,4,17,13,0,13,108
501211,2,4,17,17,0,17,168
501217,2,4,17,5,0,5,156
501228,2,4,17,14,1,15,176
501242,2,4,17,3,1,4,117
501249,2,4,17,5,0,5,101
501259,2,4,17,11,1,12,161
501269,2,4,17,1,1,2,104
548314,2,4,17,4,1,5,132
548318,2,4,17,4,0,4,108
548324,2,4,17,10,0,10,109
548339,2,4,17,10,0,10,130
548355,2,4,17,1,0,1,147
548359,2,4,17,12,0,12,116
548371,2,4,17,9,0,9,150
548376,2,4,17,4,0,4,123
598030,2,4,17,8,0,8,149
598042,2,4,17,9,0,9,138
598046,2,4,17,12,0,12,145
598050,2,4,17,14,0,14,162
598061,2,4,17,5,1,6,102
598064,2,4,17,10,0,10,121
598069,2,4,17,17,1,18,172
729288,2,4,17,18,0,18,190
729296,2,4,17,11,1,12,155
729318,2,4,17,5,0,5,110
734012,2,4,17,5,0,5,180
734024,2,4,17,5,0,5,144
734048,2,4,17,12,0,12,109
829714,2,4,17,5,0,5,118
829746,2,4,17,14,0,14,152
829758,2,4,17,4,2,6,89
829764,2,4,17,11,0,11,116
829780,2,4,17,6,0,6,124
829804,2,4,17,13,0,13,129
980924,2,4,17,13,0,13,131
980946,2,4,17,6,0,6,139
980968,2,4,17,8,0,8,130
980982,2,4,17,3,0,3,139
980990,2,4,17,8,0,8,127
1082594,2,4,17,1,1,2,145
1082605,2,4,17,12,0,12,124
1082609,2,4,17,7,0,7,132
1082623,2,4,17,12,0,12,158
335989,1,5,17,4,0,4,106
336005,1,5,17,7,1,8,164
336013,1,5,17,0,0,0,103
336028,1,5,17,16,0,16,167
336038,1,5,17,12,0,12,186
336043,1,5,17,9,0,9,164
392195,1,5,17,8,0,8,119
392215,1,5,17,11,0,11,164
392222,1,5,17,9,0,9,110
392230,1,5,17,3,1,4,130
392238,1,5,17,7,0,7,91
419116,1,5,17,6,0,6,114
419120,1,5,17,4,1,5,85
419123,1,5,17,7,0,7,142
419129,1,5,17,1,2,3,147
419134,1,5,17,15,0,15,150
419146,1,5,17,6,0,6,136
419159,1,5,17,12,0,12,104
419163,1,5,17,8,0,8,112
501214,1,5,17,8,1,9,125
501245,1,5,17,7,1,8,126
501257,1,5,17,5,0,5,124
501263,1,5,17,1,0,1,91
548314,1,5,17,14,4,18,156
548317,1,5,17,2,0,2,127
548325,1,5,17,8,0,8,109
548329,1,5,17,24,0,24,158
548337,1,5,17,13,0,13,129
548354,1,5,17,7,1,8,123
548359,1,5,17,8,0,8,141
548366,1,5,17,4,0,4,97
548370,1,5,17,9,0,9,145
548378,1,5,17,11,0,11,107
548382,1,5,17,14,2,16,136
598006,1,5,17,7,0,7,149
598010,1,5,17,4,1,5,106
598014,1,5,17,6,0,6,112
598024,1,5,17,11,1,12,144
598028,1,5,17,2,0,2,110
598031,1,5,17,16,2,18,156
598048,1,5,17,7,0,7,115
598077,1,5,17,9,0,9,119
729296,1,5,17,13,0,13,159
729320,1,5,17,9,0,9,127
733984,1,5,17,3,1,4,139
734008,1,5,17,8,1,9,129
734016,1,5,17,9,1,10,167
734046,1,5,17,2,0,2,143
829714,1,5,17,13,0,13,128
829746,1,5,17,12,0,12,154
829754,1,5,17,10,0,10,119
829782,1,5,17,19,0,19,149
829816,1,5,17,17,1,18,169
335992,2,5,17,2,0,2,154
335995,2,5,17,10,0,10,186
335997,2,5,17,4,0,4,134
336020,2,5,17,6,0,6,144
336024,2,5,17,14,1,15,161
336032,2,5,17,14,2,16,150
336041,2,5,17,6,0,6,103
336045,2,5,17,14,0,14,139
392200,2,5,17,9,1,10,96
392203,2,5,17,17,1,18,127
392207,2,5,17,1,0,1,113
392210,2,5,17,11,1,12,125
392225,2,5,17,2,0,2,100
392235,2,5,17,7,1,8,107
419112,2,5,17,19,0,19,173
419139,2,5,17,8,0,8,119
419142,2,5,17,8,1,9,192
419155,2,5,17,13,0,13,104
501204,2,5,17,2,0,2,108
501209,2,5,17,12,0,12,136
501225,2,5,17,6,0,6,124
501236,2,5,17,7,1,8,88
501240,2,5,17,6,0,6,115
501254,2,5,17,6,0,6,125
548322,2,5,17,11,0,11,157
548331,2,5,17,17,0,17,159
548341,2,5,17,11,0,11,121
548350,2,5,17,11,0,11,128
548363,2,5,17,5,0,5,126
598019,2,5,17,7,0,7,108
598037,2,5,17,6,0,6,130
598041,2,5,17,12,0,12,142
598052,2,5,17,14,0,14,150
598054,2,5,17,17,0,17,150
598057,2,5,17,13,0,13,130
598063,2,5,17,5,0,5,138
598068,2,5,17,6,1,7,129
598070,2,5,17,10,0,10,85
598076,2,5,17,6,0,6,108
729290,2,5,17,2,0,2,110
729302,2,5,17,15,0,15,107
733980,2,5,17,12,0,12,136
733994,2,5,17,5,0,5,89
734004,2,5,17,19,2,21,147
734022,2,5,17,13,1,14,116
734038,2,5,17,22,0,22,125
829720,2,5,17,7,1,8,149
829726,2,5,17,15,0,15,141
829732,2,5,17,7,0,7,108
829740,2,5,17,3,0,3,147
829774,2,5,17,13,1,14,154
829792,2,5,17,8,2,10,145
829802,2,5,17,8,0,8,115
829824,2,5,17,8,0,8,103
336000,1,6,17,5,1,6,128
336003,1,6,17,7,1,8,167
336014,1,6,17,15,0,15,154
336020,1,6,17,8,0,8,109
336025,1,6,17,12,0,12,158
392194,1,6,17,14,0,14,148
392203,1,6,17,13,0,13,121
392228,1,6,17,10,1,11,130
392231,1,6,17,0,0,0,104
392235,1,6,17,5,0,5,104
392237,1,6,17,8,2,10,110
392242,1,6,17,12,1,13,133
419121,1,6,17,6,0,6,150
419133,1,6,17,2,3,5,139
419136,1,6,17,6,0,6,145
419139,1,6,17,17,0,17,148
419145,1,6,17,7,0,7,145
419154,1,6,17,7,1,8,96
501206,1,6,17,1,1,2,90
501209,1,6,17,6,0,6,112
501228,1,6,17,4,0,4,184
501232,1,6,17,8,1,9,131
501238,1,6,17,11,0,11,123
501243,1,6,17,8,0,8,116
548347,1,6,17,18,0,18,175
548350,1,6,17,2,2,4,118
548362,1,6,17,11,0,11,125
548369,1,6,17,2,2,4,88
598003,1,6,17,10,1,11,109
598015,1,6,17,14,3,17,93
598022,1,6,17,11,0,11,116
598040,1,6,17,13,0,13,124
598049,1,6,17,2,0,2,74
598054,1,6,17,10,2,12,116
598064,1,6,17,6,0,6,99
729286,1,6,17,7,1,8,101
733980,1,6,17,9,0,9,112
733986,1,6,17,4,0,4,134
733990,1,6,17,13,0,13,119
733998,1,6,17,4,0,4,132
734024,1,6,17,9,1,10,144
734044,1,6,17,3,0,3,110
829720,1,6,17,4,1,5,141
829736,1,6,17,3,1,4,136
829744,1,6,17,11,1,12,117
829752,1,6,17,8,1,9,161
829762,1,6,17,2,0,2,92
829788,1,6,17,15,0,15,121
829818,1,6,17,7,0,7,151
980908,1,6,17,1,0,1,93
980938,1,6,17,11,1,12,130
980956,1,6,17,14,0,14,145
980970,1,6,17,8,0,8,138
981002,1,6,17,4,0,4,81
981016,1,6,17,7,1,8,115
1082599,1,6,17,11,1,12,141
1082605,1,6,17,11,2,13,144
1082608,1,6,17,26,0,26,145
1082622,1,6,17,6,0,6,146
1082626,1,6,17,2,0,2,67
1082642,1,6,17,11,1,12,141
336006,2,6,17,7,0,7,154
336009,2,6,17,8,2,10,129
336022,2,6,17,3,0,3,104
336031,2,6,17,8,1,9,142
336037,2,6,17,15,0,15,152
336043,2,6,17,0,0,0,87
392199,2,6,17,18,1,19,126
392206,2,6,17,17,0,17,128
392211,2,6,17,1,0,1,128
392216,2,6,17,11,0,11,134
392220,2,6,17,11,0,11,104
392224,2,6,17,10,1,11,121
392240,2,6,17,5,1,6,154
419113,2,6,17,3,0,3,117
419116,2,6,17,7,1,8,140
419119,2,6,17,0,0,0,120
419125,2,6,17,2,2,4,135
419149,2,6,17,5,0,5,147
419157,2,6,17,6,1,7,120
419160,2,6,17,10,0,10,100
419165,2,6,17,10,0,10,109
501218,2,6,17,7,0,7,147
501221,2,6,17,8,0,8,120
501235,2,6,17,10,0,10,109
501248,2,6,17,4,1,5,157
501251,2,6,17,9,0,9,123
501258,2,6,17,10,0,10,127
501262,2,6,17,7,1,8,110
548315,2,6,17,9,1,10,115
548326,2,6,17,15,0,15,136
548334,2,6,17,10,0,10,193
548338,2,6,17,2,1,3,142
548374,2,6,17,8,0,8,111
548377,2,6,17,7,0,7,165
548379,2,6,17,6,0,6,135
548383,2,6,17,2,1,3,120
548385,2,6,17,0,0,0,136
598006,2,6,17,13,0,13,144
598011,2,6,17,5,0,5,137
598025,2,6,17,1,0,1,83
598029,2,6,17,11,2,13,165
598033,2,6,17,11,0,11,122
598045,2,6,17,12,0,12,126
598059,2,6,17,4,0,4,133
598067,2,6,17,10,2,12,122
598072,2,6,17,3,0,3,119
729294,2,6,17,8,0,8,135
729306,2,6,17,7,0,7,136
729314,2,6,17,7,0,7,107
734010,2,6,17,16,2,18,141
734016,2,6,17,10,0,10,109
734036,2,6,17,14,0,14,130
829712,2,6,17,9,0,9,119
829730,2,6,17,13,1,14,149
829766,2,6,17,17,0,17,130
829782,2,6,17,12,0,12,138
829798,2,6,17,9,0,9,135
829806,2,6,17,6,0,6,120
980926,2,6,17,13,0,13,171
980950,2,6,17,21,0,21,144
980966,2,6,17,12,0,12,142
980976,2,6,17,3,1,4,142
980988,2,6,17,12,2,14,131
980998,2,6,17,8,0,8,119
981008,2,6,17,14,0,14,131
1082595,2,6,17,5,0,5,126
1082611,2,6,17,9,1,10,145
1082614,2,6,17,4,0,4,101
1082630,2,6,17,14,0,14,162
1082632,2,6,17,15,1,16,205
1082640,2,6,17,21,0,21,173
1082646,2,6,17,14,0,14,127
335990,1,7,17,10,1,11,129
335999,1,7,17,9,1,10,124
336009,1,7,17,6,0,6,124
336029,1,7,17,13,1,14,142
336037,1,7,17,8,1,9,137
336041,1,7,17,2,0,2,108
392186,1,7,17,14,0,14,126
392202,1,7,17,6,1,7,162
392208,1,7,17,8,1,9,106
392213,1,7,17,6,1,7,101
392220,1,7,17,1,0,1,91
392223,1,7,17,11,0,11,125
392232,1,7,17,12,0,12,117
392240,1,7,17,13,0,13,132
419112,1,7,17,9,1,10,180
419119,1,7,17,12,1,13,187
419124,1,7,17,14,1,15,123
419135,1,7,17,10,0,10,120
419143,1,7,17,10,0,10,135
419151,1,7,17,8,1,9,127
419155,1,7,17,14,1,15,130
419157,1,7,17,8,1,9,132
419162,1,7,17,10,0,10,152
419166,1,7,17,12,0,12,106
419167,1,7,17,14,3,17,141
501215,1,7,17,6,1,7,152
501226,1,7,17,11,0,11,135
501229,1,7,17,10,0,10,124
501236,1,7,17,10,0,10,81
501242,1,7,17,6,0,6,131
501246,1,7,17,1,0,1,114
501251,1,7,17,7,1,8,149
501268,1,7,17,12,0,12,111
548322,1,7,17,16,0,16,164
548330,1,7,17,1,2,3,83
548339,1,7,17,8,0,8,140
548356,1,7,17,4,0,4,97
548365,1,7,17,4,0,4,105
548368,1,7,17,16,1,17,156
598007,1,7,17,8,1,9,112
598011,1,7,17,11,0,11,160
598016,1,7,17,18,1,19,137
598029,1,7,17,2,0,2,116
598038,1,7,17,16,1,17,168
598042,1,7,17,13,1,14,128
598044,1,7,17,5,0,5,100
598051,1,7,17,9,0,9,99
598055,1,7,17,11,0,11,130
598068,1,7,17,7,1,8,147
598078,1,7,17,6,0,6,112
729292,1,7,17,3,0,3,101
729308,1,7,17,7,0,7,120
729314,1,7,17,10,4,14,94
733988,1,7,17,9,1,10,139
734000,1,7,17,7,0,7,118
734014,1,7,17,8,0,8,123
734022,1,7,17,7,0,7,141
734036,1,7,17,7,0,7,160
734050,1,7,17,5,0,5,145
829710,1,7,17,13,0,13,122
829726,1,7,17,16,1,17,116
829734,1,7,17,17,0,17,155
829742,1,7,17,24,0,24,176
829756,1,7,17,5,0,5,126
829774,1,7,17,11,2,13,139
829780,1,7,17,9,1,10,146
829810,1,7,17,18,0,18,130
829822,1,7,17,2,0,2,141
829828,1,7,17,23,0,23,173
980906,1,7,17,5,0,5,80
980922,1,7,17,10,1,11,99
980928,1,7,17,4,1,5,123
980946,1,7,17,8,1,9,165
980990,1,7,17,7,0,7,104
980998,1,7,17,10,0,10,171
981012,1,7,17,5,3,8,153
1082592,1,7,17,10,0,10,137
1082614,1,7,17,10,0,10,120
1082635,1,7,17,10,1,11,166
1082638,1,7,17,2,0,2,112
1082644,1,7,17,9,0,9,139
1082650,1,7,17,4,2,6,92
335994,2,7,17,21,0,21,168
335996,2,7,17,1,0,1,106
336002,2,7,17,7,1,8,129
336033,2,7,17,3,0,3,159
392197,2,7,17,11,1,12,131
392205,2,7,17,6,0,6,94
392217,2,7,17,5,0,5,108
392227,2,7,17,5,0,5,122
392230,2,7,17,10,1,11,118
419119,2,7,17,0,0,0,120
419127,2,7,17,10,0,10,139
419130,2,7,17,7,0,7,159
419137,2,7,17,10,0,10,133
419147,2,7,17,8,3,11,114
419170,2,7,17,5,0,5,114
501206,2,7,17,7,2,9,99
501210,2,7,17,9,0,9,131
501223,2,7,17,4,0,4,99
501261,2,7,17,3,0,3,86
501272,2,7,17,7,2,9,132
501274,2,7,17,6,1,7,130
501275,2,7,17,6,1,7,118
548311,2,7,17,11,0,11,115
548313,2,7,17,7,1,8,79
548319,2,7,17,8,0,8,102
548344,2,7,17,11,1,12,129
548347,2,7,17,5,1,6,148
548351,2,7,17,2,0,2,83
548360,2,7,17,11,0,11,147
548372,2,7,17,15,1,16,131
548375,2,7,17,7,0,7,97
548382,2,7,17,6,0,6,155
548384,2,7,17,6,2,8,125
598004,2,7,17,23,1,24,130
598024,2,7,17,0,0,0,83
598034,2,7,17,8,0,8,132
598060,2,7,17,7,0,7,100
598065,2,7,17,29,0,29,146
598071,2,7,17,3,0,3,120
598075,2,7,17,7,1,8,137
598077,2,7,17,11,0,11,140
729284,2,7,17,3,0,3,109
729322,2,7,17,26,1,27,142
733978,2,7,17,4,0,4,128
734006,2,7,17,7,3,10,142
734030,2,7,17,4,0,4,146
829722,2,7,17,19,1,20,116
829752,2,7,17,4,0,4,135
829788,2,7,17,11,0,11,121
829794,2,7,17,17,0,17,125
829800,2,7,17,15,0,15,166
980914,2,7,17,9,0,9,166
980932,2,7,17,14,0,14,157
980938,2,7,17,4,1,5,123
980952,2,7,17,7,0,7,156
980962,2,7,17,8,3,11,138
980978,2,7,17,0,0,0,92
980986,2,7,17,16,2,18,126
1082597,2,7,17,11,0,11,130
1082600,2,7,17,15,0,15,149
1082602,2,7,17,10,0,10,120
1082606,2,7,17,13,0,13,154
1082618,2,7,17,4,0,4,126
1082625,2,7,17,7,0,7,130
1082628,2,7,17,8,0,8,133
1082641,2,7,17,16,1,17,192
1082647,2,7,17,4,0,4,111
335991,1,8,17,19,1,20,102
335993,1,8,17,8,0,8,90
335995,1,8,17,11,0,11,171
336004,1,8,17,9,0,9,128
336007,1,8,17,17,1,18,149
336016,1,8,17,6,0,6,111
336036,1,8,17,21,0,21,143
336042,1,8,17,8,0,8,112
392193,1,8,17,9,0,9,158
392197,1,8,17,8,1,9,151
392206,1,8,17,7,0,7,134
392210,1,8,17,9,0,9,118
392217,1,8,17,15,0,15,118
392221,1,8,17,20,0,20,133
392225,1,8,17,12,0,12,130
392244,1,8,17,6,0,6,115
419115,1,8,17,10,0,10,149
419122,1,8,17,10,0,10,144
419125,1,8,17,18,0,18,142
419131,1,8,17,5,0,5,118
419156,1,8,17,4,1,5,129
419165,1,8,17,2,1,3,124
419169,1,8,17,1,0,1,82
501204,1,8,17,8,0,8,113
501213,1,8,17,15,0,15,145
501217,1,8,17,7,0,7,129
501221,1,8,17,13,0,13,146
501234,1,8,17,5,0,5,110
501248,1,8,17,15,0,15,149
501255,1,8,17,5,0,5,112
501261,1,8,17,8,0,8,97
501269,1,8,17,11,0,11,169
548319,1,8,17,10,0,10,119
548326,1,8,17,5,0,5,130
548331,1,8,17,11,0,11,143
548334,1,8,17,17,0,17,157
548340,1,8,17,1,0,1,103
548346,1,8,17,10,0,10,151
548351,1,8,17,3,0,3,90
548353,1,8,17,2,6,8,130
548361,1,8,17,16,0,16,142
548371,1,8,17,8,0,8,145
548381,1,8,17,15,0,15,99
336012,2,8,17,1,1,2,127
336019,2,8,17,16,1,17,154
336025,2,8,17,15,0,15,152
336029,2,8,17,14,2,16,130
336039,2,8,17,13,0,13,128
392201,2,8,17,5,5,10,141
392228,2,8,17,4,0,4,149
392233,2,8,17,14,0,14,127
392234,2,8,17,2,0,2,92
392241,2,8,17,6,0,6,131
392242,2,8,17,3,1,4,152
419111,2,8,17,5,0,5,133
419135,2,8,17,2,0,2,131
419140,2,8,17,6,0,6,134
419143,2,8,17,3,1,4,112
419146,2,8,17,15,0,15,137
419150,2,8,17,20,1,21,157
419152,2,8,17,10,0,10,117
419161,2,8,17,6,0,6,146
419168,2,8,17,17,0,17,101
501208,2,8,17,14,0,14,127
501229,2,8,17,15,0,15,116
501241,2,8,17,8,0,8,130
501244,2,8,17,7,0,7,126
501264,2,8,17,12,0,12,124
548316,2,8,17,2,0,2,119
548357,2,8,17,8,0,8,114
548364,2,8,17,10,0,10,120
548378,2,8,17,6,0,6,110
501205,1,9,17,9,0,9,135
501212,1,9,17,4,0,4,117
501224,1,9,17,5,1,6,112
501230,1,9,17,2,0,2,92
501247,1,9,17,12,0,12,114
501252,1,9,17,3,0,3,106
501259,1,9,17,13,2,15,154
501215,2,9,17,13,0,13,156
501234,2,9,17,0,0,0,74
501238,2,9,17,10,0,10,109
501266,2,9,17,7,1,8,103
501218,1,10,17,5,0,5,146
501223,1,10,17,7,0,7,118
501233,1,10,17,11,1,12,113
501240,1,10,17,5,0,5,113
501264,1,10,17,3,0,3,102
501267,1,10,17,6,0,6,93
548313,1,10,17,5,0,5,105
548318,1,10,17,1,0,1,122
548324,1,10,17,3,0,3,102
548332,1,10,17,14,0,14,155
548338,1,10,17,11,1,12,148
548342,1,10,17,11,0,11,110
548363,1,10,17,6,1,7,106
598008,1,10,17,2,0,2,80
598020,1,10,17,9,1,10,128
598030,1,10,17,13,1,14,142
598052,1,10,17,9,0,9,142
598060,1,10,17,5,0,5,99
598066,1,10,17,9,0,9,125
598072,1,10,17,9,0,9,130
501212,2,10,17,3,2,5,124
501231,2,10,17,4,0,4,102
501237,2,10,17,5,1,6,133
501246,2,10,17,10,0,10,106
501253,2,10,17,2,0,2,119
501255,2,10,17,12,1,13,132
548327,2,10,17,5,0,5,122
548335,2,10,17,6,0,6,130
548346,2,10,17,16,2,18,129
548353,2,10,17,9,1,10,135
548356,2,10,17,7,2,9,94
548358,2,10,17,4,0,4,120
548367,2,10,17,7,1,8,117
548370,2,10,17,4,0,4,109
548380,2,10,17,5,0,5,92
598005,2,10,17,10,0,10,94
598014,2,10,17,2,1,3,131
598016,2,10,17,6,0,6,127
598023,2,10,17,6,0,6,101
598032,2,10,17,5,0,5,124
598040,2,10,17,8,1,9,128
598043,2,10,17,14,0,14,110
598047,2,10,17,8,1,9,152
598058,2,10,17,3,0,3,98
598005,1,11,17,15,0,15,107
598023,1,11,17,5,0,5,86
598035,1,11,17,15,0,15,115
598037,1,11,17,9,0,9,108
598053,1,11,17,18,1,19,135
598061,1,11,17,10,0,10,114
598065,1,11,17,7,0,7,152
598070,1,11,17,6,1,7,111
598076,1,11,17,15,1,16,104
729290,1,11,17,8,1,9,108
729306,1,11,17,11,0,11,139
729316,1,11,17,5,1,6,108
729322,1,11,17,7,0,7,137
733982,1,11,17,8,1,9,124
733994,1,11,17,5,0,5,111
734006,1,11,17,6,0,6,118
734012,1,11,17,11,0,11,149
734020,1,11,17,12,0,12,126
734042,1,11,17,2,0,2,127
829732,1,11,17,3,0,3,98
829748,1,11,17,6,0,6,149
829764,1,11,17,9,0,9,123
829778,1,11,17,3,0,3,159
829792,1,11,17,18,1,19,170
829798,1,11,17,8,0,8,122
829804,1,11,17,10,0,10,157
829820,1,11,17,5,0,5,90
980920,1,11,17,9,1,10,115
980948,1,11,17,3,0,3,81
980958,1,11,17,8,0,8,161
980978,1,11,17,13,0,13,143
980984,1,11,17,12,0,12,111
980988,1,11,17,8,0,8,126
981008,1,11,17,4,0,4,124
981020,1,11,17,9,0,9,133
981024,1,11,17,7,2,9,156
1082591,1,11,17,7,0,7,162
1082600,1,11,17,13,1,14,140
1082609,1,11,17,9,0,9,124
1082611,1,11,17,10,0,10,158
1082615,1,11,17,12,0,12,134
1082623,1,11,17,11,0,11,171
1082627,1,11,17,6,0,6,175
1082630,1,11,17,7,0,7,133
1082648,1,11,17,2,0,2,105
598009,2,11,17,4,0,4,103
598015,2,11,17,7,1,8,97
598018,2,11,17,4,1,5,115
598026,2,11,17,2,0,2,99
598044,2,11,17,8,0,8,127
598056,2,11,17,4,0,4,115
598074,2,11,17,0,0,0,108
729300,2,11,17,5,0,5,113
734026,2,11,17,7,1,8,134
734034,2,11,17,11,0,11,168
829716,2,11,17,4,2,6,138
829724,2,11,17,13,7,20,162
829736,2,11,17,9,0,9,129
829756,2,11,17,9,1,10,124
829786,2,11,17,4,0,4,96
980912,2,11,17,5,0,5,152
980928,2,11,17,11,0,11,133
980940,2,11,17,8,2,10,139
980972,2,11,17,6,2,8,106
980996,2,11,17,1,1,2,141
981014,2,11,17,4,4,8,128
981022,2,11,17,11,0,11,129
1082604,2,11,17,12,1,13,129
1082634,2,11,17,9,0,9,117
1082638,2,11,17,7,1,8,129
1082643,2,11,17,5,2,7,142
980916,1,12,17,1,1,2,136
980924,1,12,17,15,0,15,131
980944,1,12,17,10,1,11,119
980954,1,12,17,14,2,16,160
980962,1,12,17,11,0,11,135
980974,1,12,17,16,0,16,162
980994,1,12,17,6,0,6,102
1082594,1,12,17,5,0,5,128
1082603,1,12,17,14,0,14,149
1082607,1,12,17,3,0,3,130
1082618,1,12,17,11,0,11,137
1082620,1,12,17,7,0,7,147
1082624,1,12,17,13,1,14,129
1082634,1,12,17,10,1,11,116
1082647,1,12,17,4,1,5,114
980936,2,12,17,13,2,15,136
980970,2,12,17,6,0,6,126
980984,2,12,17,5,0,5,101
981010,2,12,17,10,0,10,129
1082592,2,12,17,10,0,10,158
1082599,2,12,17,0,0,0,108
1082615,2,12,17,9,0,9,130
1082629,2,12,17,8,0,8,126
1082631,2,12,17,7,0,7,146
1082642,2,12,17,4,1,5,131
1082650,2,12,17,3,0,3,100
980934,1,13,17,4,0,4,117
980950,1,13,17,8,1,9,143
980966,1,13,17,12,1,13,123
980972,1,13,17,6,0,6,99
981018,1,13,17,13,0,13,121
981022,1,13,17,9,0,9,129
1082593,1,13,17,11,0,11,141
1082596,1,13,17,3,0,3,113
1082606,1,13,17,18,1,19,145
1082625,1,13,17,8,0,8,110
1082629,1,13,17,5,1,6,146
1082632,1,13,17,7,0,7,178
1082640,1,13,17,16,0,16,164
1082643,1,13,17,8,0,8,142
980910,2,13,17,13,0,13,155
980916,2,13,17,3,1,4,151
980922,2,13,17,8,4,12,121
980942,2,13,17,11,1,12,154
980954,2,13,17,9,2,11,172
980960,2,13,17,7,0,7,106
980980,2,13,17,5,0,5,156
980992,2,13,17,3,0,3,98
981012,2,13,17,9,1,10,167
1082603,2,13,17,5,0,5,151
1082610,2,13,17,10,0,10,156
1082613,2,13,17,16,0,16,171
1082616,2,13,17,14,0,14,142
1082637,2,13,17,4,0,4,162
335987,1,1,18,7,0,7,179
335998,1,1,18,7,0,7,126
336002,1,1,18,14,0,14,118
336019,1,1,18,20,0,20,175
336022,1,1,18,10,0,10,119
336030,1,1,18,11,1,12,130
336032,1,1,18,7,0,7,123
392189,1,1,18,11,0,11,93
392204,1,1,18,8,0,8,121
392212,1,1,18,8,1,9,122
392216,1,1,18,11,0,11,139
392224,1,1,18,13,0,13,107
392226,1,1,18,4,0,4,137
392233,1,1,18,7,0,7,118
419111,1,1,18,15,1,16,137
419127,1,1,18,14,0,14,139
419132,1,1,18,11,1,12,153
419140,1,1,18,12,1,13,159
419144,1,1,18,13,0,13,178
419149,1,1,18,15,0,15,154
419153,1,1,18,3,1,4,140
419158,1,1,18,4,6,10,122
501208,1,1,18,14,1,15,148
501227,1,1,18,16,0,16,154
501235,1,1,18,9,2,11,128
501244,1,1,18,11,2,13,148
501272,1,1,18,19,0,19,156
501274,1,1,18,4,0,4,125
548320,1,1,18,6,2,8,150
548349,1,1,18,6,1,7,167
548358,1,1,18,5,2,7,134
548373,1,1,18,11,0,11,138
548375,1,1,18,11,2,13,125
548380,1,1,18,4,0,4,117
548383,1,1,18,10,1,11,126
598013,1,1,18,4,1,5,135
598018,1,1,18,20,2,22,157
598027,1,1,18,7,0,7,107
598034,1,1,18,13,0,13,146
598045,1,1,18,3,1,4,110
598058,1,1,18,10,0,10,126
598074,1,1,18,10,1,11,111
729284,1,1,18,9,0,9,144
729294,1,1,18,12,0,12,144
729304,1,1,18,3,1,4,133
734032,1,1,18,15,1,16,175
734048,1,1,18,17,0,17,145
829718,1,1,18,12,0,12,149
829766,1,1,18,8,0,8,143
829786,1,1,18,13,0,13,145
980914,1,1,18,7,0,7,170
980952,1,1,18,13,0,13,156
980968,1,1,18,9,3,12,150
980980,1,1,18,14,0,14,133
981000,1,1,18,16,0,16,161
981006,1,1,18,12,1,13,116
981014,1,1,18,6,0,6,161
1082597,1,1,18,8,0,8,144
1082604,1,1,18,4,0,4,154
1082613,1,1,18,14,0,14,168
1082617,1,1,18,3,1,4,126
1082631,1,1,18,10,0,10,130
1082649,1,1,18,5,0,5,106
335991,2,1,18,12,1,13,103
336005,2,1,18,4,0,4,147
336008,2,1,18,18,0,18,142
336040,2,1,18,12,4,16,152
392195,2,1,18,7,0,7,135
392208,2,1,18,8,0,8,126
392236,2,1,18,13,0,13,164
392238,2,1,18,10,0,10,91
419114,2,1,18,7,0,7,133
419118,2,1,18,3,0,3,103
419123,2,1,18,9,1,10,127
419136,2,1,18,9,0,9,125
419166,2,1,18,6,0,6,135
501203,2,1,18,7,0,7,128
501214,2,1,18,7,0,7,157
501224,2,1,18,4,2,6,107
501239,2,1,18,5,0,5,120
501247,2,1,18,7,0,7,126
548317,2,1,18,19,0,19,131
548325,2,1,18,8,1,9,117
548328,2,1,18,11,0,11,122
548340,2,1,18,9,0,9,116
548352,2,1,18,5,1,6,124
548362,2,1,18,5,0,5,151
548368,2,1,18,15,0,15,139
548386,2,1,18,7,0,7,171
598003,2,1,18,12,0,12,126
598010,2,1,18,13,0,13,122
598021,2,1,18,5,0,5,128
598036,2,1,18,13,0,13,148
598039,2,1,18,20,1,21,172
598048,2,1,18,4,0,4,133
598055,2,1,18,1,3,4,104
598062,2,1,18,3,0,3,105
598066,2,1,18,15,0,15,149
729312,2,1,18,12,0,12,107
729320,2,1,18,11,0,11,137
733984,2,1,18,12,3,15,147
733990,2,1,18,5,0,5,156
734002,2,1,18,11,0,11,150
734014,2,1,18,8,0,8,136
734020,2,1,18,14,0,14,127
734028,2,1,18,11,0,11,156
734054,2,1,18,5,1,6,185
829710,2,1,18,14,0,14,165
829728,2,1,18,8,0,8,155
829738,2,1,18,7,0,7,159
829744,2,1,18,9,0,9,145
829770,2,1,18,3,1,4,105
829796,2,1,18,10,1,11,171
829810,2,1,18,7,0,7,151
829816,2,1,18,5,2,7,164
980920,2,1,18,14,0,14,142
980930,2,1,18,4,0,4,141
980944,2,1,18,7,0,7,143
980956,2,1,18,5,0,5,156
980964,2,1,18,6,0,6,169
981020,2,1,18,6,0,6,130
1082608,2,1,18,5,1,6,153
1082620,2,1,18,2,0,2,180
1082627,2,1,18,11,0,11,149
1082639,2,1,18,8,0,8,139
1082644,2,1,18,4,0,4,153
335997,1,2,18,8,1,9,121
336011,1,2,18,2,0,2,117
336017,1,2,18,7,0,7,122
336021,1,2,18,3,2,5,128
336031,1,2,18,5,0,5,124
336034,1,2,18,11,0,11,109
336039,1,2,18,4,0,4,130
392187,1,2,18,8,0,8,106
392196,1,2,18,8,1,9,145
392199,1,2,18,2,5,7,126
392209,1,2,18,21,0,21,133
392218,1,2,18,1,0,1,93
392241,1,2,18,5,0,5,139
419114,1,2,18,6,0,6,112
419128,1,2,18,11,0,11,130
419138,1,2,18,8,0,8,132
419150,1,2,18,16,0,16,154
501210,1,2,18,5,0,5,116
501237,1,2,18,23,1,24,165
501249,1,2,18,10,0,10,186
501273,1,2,18,13,0,13,148
501275,1,2,18,6,0,6,165
548315,1,2,18,8,0,8,129
548323,1,2,18,16,1,17,190
548341,1,2,18,12,5,17,153
548355,1,2,18,4,1,5,140
548367,1,2,18,11,0,11,149
548372,1,2,18,6,0,6,134
548377,1,2,18,13,0,13,189
598004,1,2,18,17,0,17,132
598009,1,2,18,5,1,6,114
598017,1,2,18,3,2,5,140
598032,1,2,18,15,0,15,234
598041,1,2,18,6,1,7,144
598047,1,2,18,12,0,12,154
598050,1,2,18,18,2,20,150
598059,1,2,18,24,0,24,148
598062,1,2,18,3,0,3,105
598069,1,2,18,12,0,12,157
729318,1,2,18,5,0,5,110
734004,1,2,18,13,0,13,151
734010,1,2,18,13,1,14,150
734026,1,2,18,11,1,12,146
734040,1,2,18,11,0,11,132
829724,1,2,18,12,2,14,148
829768,1,2,18,18,0,18,175
829790,1,2,18,12,0,12,202
829800,1,2,18,19,0,19,204
829824,1,2,18,17,0,17,154
829826,1,2,18,11,0,11,124
980912,1,2,18,3,0,3,186
980926,1,2,18,4,0,4,177
980932,1,2,18,9,0,9,143
980936,1,2,18,12,1,13,157
980942,1,2,18,8,0,8,152
980964,1,2,18,20,3,23,154
980982,1,2,18,12,0,12,155
980986,1,2,18,22,1,23,131
980992,1,2,18,29,1,30,199
1082595,1,2,18,2,0,2,144
1082598,1,2,18,19,0,19,115
1082602,1,2,18,6,2,8,127
1082610,1,2,18,12,0,12,178
1082621,1,2,18,3,1,4,120
1082628,1,2,18,15,0,15,147
1082636,1,2,18,10,0,10,125
1082646,1,2,18,8,1,9,135
335990,2,2,18,19,0,19,155
336001,2,2,18,6,0,6,154
336003,2,2,18,12,1,13,157
336007,2,2,18,13,0,13,150
336028,2,2,18,7,0,7,114
392193,2,2,18,8,0,8,140
392204,2,2,18,11,0,11,126
392213,2,2,18,15,0,15,149
392223,2,2,18,5,0,5,118
392226,2,2,18,18,1,19,153
392229,2,2,18,5,4,9,113
392237,2,2,18,14,0,14,126
392243,2,2,18,8,0,8,135
392244,2,2,18,3,1,4,117
419117,2,2,18,23,0,23,193
419124,2,2,18,6,0,6,142
419133,2,2,18,2,4,6,142
419141,2,2,18,11,0,11,170
419145,2,2,18,9,0,9,137
419153,2,2,18,4,0,4,162
419156,2,2,18,19,2,21,134
419162,2,2,18,4,0,4,119
419167,2,2,18,4,1,5,134
501205,2,2,18,20,0,20,149
501213,2,2,18,14,0,14,132
501216,2,2,18,15,0,15,143
501227,2,2,18,4,1,5,171
501232,2,2,18,10,0,10,149
501271,2,2,18,13,0,13,129
501276,2,2,18,8,0,8,127
548320,2,2,18,6,1,7,106
548329,2,2,18,1,0,1,121
548332,2,2,18,16,0,16,155
548336,2,2,18,15,2,17,157
548349,2,2,18,4,0,4,115
548361,2,2,18,23,0,23,166
548365,2,2,18,16,0,16,142
548381,2,2,18,7,0,7,105
598013,2,2,18,12,1,13,158
598022,2,2,18,6,0,6,136
598028,2,2,18,15,0,15,123
598038,2,2,18,2,0,2,110
598053,2,2,18,8,0,8,162
729292,2,2,18,7,0,7,116
729304,2,2,18,7,0,7,133
733982,2,2,18,9,0,9,128
733988,2,2,18,9,0,9,153
733996,2,2,18,8,0,8,143
734018,2,2,18,13,2,15,125
734032,2,2,18,8,1,9,142
829718,2,2,18,17,0,17,164
829742,2,2,18,14,1,15,175
829750,2,2,18,6,4,10,134
829784,2,2,18,5,0,5,117
980958,2,2,18,10,0,10,162
980974,2,2,18,18,0,18,170
981000,2,2,18,15,1,16,173
981016,2,2,18,7,5,12,138
981018,2,2,18,13,5,18,156
981024,2,2,18,6,1,7,179
1082591,2,2,18,2,0,2,156
1082607,2,2,18,10,0,10,125
1082624,2,2,18,4,0,4,86
1082633,2,2,18,4,0,4,115
335988,1,3,18,17,0,17,200
335994,1,3,18,14,0,14,182
336001,1,3,18,8,0,8,140
336006,1,3,18,7,0,7,144
336010,1,3,18,0,1,1,98
336012,1,3,18,14,0,14,121
336018,1,3,18,4,1,5,159
336023,1,3,18,14,0,14,127
336045,1,3,18,9,0,9,139
392190,1,3,18,7,0,7,158
392201,1,3,18,20,0,20,153
392207,1,3,18,23,1,24,144
392211,1,3,18,3,1,4,148
392214,1,3,18,5,0,5,153
392219,1,3,18,9,0,9,185
392229,1,3,18,6,0,6,118
392236,1,3,18,8,2,10,162
392239,1,3,18,6,1,7,109
392243,1,3,18,3,3,6,130
419118,1,3,18,16,0,16,131
419130,1,3,18,10,0,10,161
419142,1,3,18,18,0,18,226
419147,1,3,18,6,0,6,141
419152,1,3,18,4,0,4,125
419160,1,3,18,10,0,10,89
419168,1,3,18,3,1,4,116
419170,1,3,18,7,0,7,146
501203,1,3,18,5,0,5,132
501211,1,3,18,22,0,22,171
501216,1,3,18,15,0,15,168
501231,1,3,18,7,1,8,126
501241,1,3,18,10,0,10,136
501250,1,3,18,3,1,4,98
501254,1,3,18,17,0,17,175
501258,1,3,18,11,2,13,139
501266,1,3,18,7,0,7,127
501271,1,3,18,10,1,11,102
501276,1,3,18,15,1,16,188
548311,1,3,18,2,0,2,104
548316,1,3,18,5,3,8,153
548321,1,3,18,5,0,5,94
548327,1,3,18,11,0,11,140
548335,1,3,18,12,0,12,137
548352,1,3,18,5,0,5,118
548357,1,3,18,6,0,6,139
548360,1,3,18,11,0,11,160
548376,1,3,18,8,0,8,101
548384,1,3,18,9,0,9,150
548385,1,3,18,7,0,7,190
548386,1,3,18,11,0,11,171
598025,1,3,18,19,0,19,150
598039,1,3,18,10,1,11,179
598043,1,3,18,17,0,17,138
598046,1,3,18,11,0,11,161
598056,1,3,18,15,1,16,193
598063,1,3,18,2,1,3,116
598067,1,3,18,11,0,11,142
598075,1,3,18,10,0,10,161
729288,1,3,18,8,0,8,180
729298,1,3,18,15,0,15,150
729302,1,3,18,3,0,3,120
734018,1,3,18,6,0,6,123
734028,1,3,18,10,0,10,134
734034,1,3,18,14,0,14,154
829712,1,3,18,4,1,5,125
829716,1,3,18,20,0,20,184
829728,1,3,18,13,4,17,153
829740,1,3,18,17,0,17,139
829750,1,3,18,7,1,8,163
829758,1,3,18,10,0,10,171
829770,1,3,18,4,2,6,121
829784,1,3,18,15,0,15,137
829794,1,3,18,11,0,11,133
829802,1,3,18,4,0,4,132
829806,1,3,18,11,0,11,110
336014,2,3,18,10,1,11,166
336034,2,3,18,9,2,11,109
336038,2,3,18,8,0,8,185
336042,2,3,18,11,0,11,131
392186,2,3,18,8,0,8,135
392194,2,3,18,5,0,5,166
392207,2,3,18,2,1,3,116
392222,2,3,18,12,0,12,138
392232,2,3,18,15,2,17,138
419115,2,3,18,7,1,8,137
419121,2,3,18,3,0,3,170
419126,2,3,18,7,0,7,124
419128,2,3,18,5,0,5,117
419134,2,3,18,20,0,20,151
419138,2,3,18,3,2,5,146
419164,2,3,18,14,1,15,164
501226,2,3,18,2,0,2,137
501233,2,3,18,14,0,14,134
501245,2,3,18,4,0,4,142
501273,2,3,18,4,1,5,143
548323,2,3,18,6,1,7,163
548337,2,3,18,13,0,13,131
548348,2,3,18,7,0,7,125
548366,2,3,18,18,0,18,115
548373,2,3,18,5,0,5,132
598007,2,3,18,15,2,17,126
598012,2,3,18,7,0,7,139
598017,2,3,18,11,1,12,137
598020,2,3,18,4,0,4,118
598027,2,3,18,9,1,10,103
598031,2,3,18,12,0,12,169
598035,2,3,18,4,0,4,132
598078,2,3,18,2,0,2,99
729308,2,3,18,12,1,13,133
729316,2,3,18,5,0,5,136
733986,2,3,18,17,0,17,163
733992,2,3,18,15,0,15,159
734000,2,3,18,9,1,10,141
734008,2,3,18,5,2,7,124
734040,2,3,18,17,0,17,160
734050,2,3,18,8,2,10,170
734052,2,3,18,3,3,6,173
829778,2,3,18,11,0,11,155
829822,2,3,18,15,1,16,157
829826,2,3,18,13,1,14,127
829828,2,3,18,4,1,5,137
335992,1,4,18,2,0,2,138
335996,1,4,18,4,1,5,157
336008,1,4,18,8,2,10,150
336024,1,4,18,19,0,19,195
336033,1,4,18,10,0,10,158
336040,1,4,18,15,1,16,163
336044,1,4,18,5,0,5,84
392191,1,4,18,4,0,4,134
392200,1,4,18,12,0,12,123
392205,1,4,18,4,0,4,102
392227,1,4,18,8,3,11,113
392234,1,4,18,6,0,6,122
419113,1,4,18,5,0,5,126
419117,1,4,18,14,2,16,172
419126,1,4,18,8,0,8,122
419137,1,4,18,2,4,6,139
419141,1,4,18,12,0,12,152
419148,1,4,18,7,0,7,141
419161,1,4,18,9,0,9,142
419164,1,4,18,10,1,11,157
501207,1,4,18,5,2,7,87
501225,1,4,18,3,2,5,183
501239,1,4,18,3,0,3,103
501253,1,4,18,1,0,1,110
501256,1,4,18,5,0,5,148
501262,1,4,18,7,0,7,144
501265,1,4,18,11,5,16,209
548328,1,4,18,3,0,3,104
548333,1,4,18,4,0,4,107
548336,1,4,18,14,0,14,139
548344,1,4,18,16,0,16,140
548348,1,4,18,2,0,2,139
548364,1,4,18,10,0,10,148
548374,1,4,18,8,1,9,126
548379,1,4,18,8,0,8,122
598012,1,4,18,2,0,2,133
598019,1,4,18,11,5,16,116
598021,1,4,18,14,1,15,127
598026,1,4,18,9,1,10,115
598033,1,4,18,18,0,18,148
598036,1,4,18,3,0,3,129
598057,1,4,18,6,1,7,134
598071,1,4,18,8,0,8,164
729300,1,4,18,16,1,17,179
729312,1,4,18,8,0,8,126
733978,1,4,18,5,0,5,145
733992,1,4,18,10,0,10,191
733996,1,4,18,11,0,11,184
734002,1,4,18,4,0,4,131
734030,1,4,18,10,0,10,133
734038,1,4,18,13,0,13,146
734052,1,4,18,18,0,18,211
734054,1,4,18,11,0,11,170
829722,1,4,18,3,0,3,153
829730,1,4,18,6,0,6,143
829738,1,4,18,11,0,11,140
829772,1,4,18,5,0,5,102
829796,1,4,18,3,1,4,153
829814,1,4,18,7,1,8,108
980910,1,4,18,10,0,10,146
980918,1,4,18,6,0,6,96
980930,1,4,18,7,0,7,115
980940,1,4,18,7,0,7,122
980960,1,4,18,8,0,8,145
980976,1,4,18,4,1,5,152
980996,1,4,18,12,0,12,160
981010,1,4,18,14,0,14,154
1082601,1,4,18,11,0,11,156
1082612,1,4,18,4,1,5,170
1082616,1,4,18,6,0,6,158
1082633,1,4,18,9,0,9,119
1082637,1,4,18,9,0,9,159
1082639,1,4,18,13,1,14,148
1082641,1,4,18,9,0,9,207
335988,2,4,18,4,1,5,191
336000,2,4,18,11,2,13,155
336004,2,4,18,9,1,10,158
336011,2,4,18,2,1,3,120
336018,2,4,18,19,0,19,146
336036,2,4,18,5,1,6,155
392196,2,4,18,16,1,17,158
392209,2,4,18,7,6,13,129
392212,2,4,18,7,0,7,136
392215,2,4,18,5,2,7,127
392219,2,4,18,11,0,11,174
392221,2,4,18,9,1,10,150
392231,2,4,18,15,0,15,102
392239,2,4,18,7,1,8,77
419122,2,4,18,9,4,13,138
419129,2,4,18,3,0,3,141
419132,2,4,18,6,0,6,128
419144,2,4,18,8,0,8,196
419151,2,4,18,8,0,8,140
419154,2,4,18,3,0,3,111
501211,2,4,18,8,0,8,176
501217,2,4,18,9,1,10,166
501228,2,4,18,12,0,12,188
501242,2,4,18,9,0,9,126
501249,2,4,18,3,0,3,104
501259,2,4,18,7,1,8,169
501269,2,4,18,0,0,0,104
548314,2,4,18,10,0,10,142
548318,2,4,18,14,0,14,122
548324,2,4,18,7,0,7,116
548339,2,4,18,9,5,14,144
548355,2,4,18,5,0,5,152
548359,2,4,18,5,0,5,121
548371,2,4,18,13,4,17,167
598030,2,4,18,8,0,8,157
598042,2,4,18,11,0,11,149
598046,2,4,18,11,1,12,157
598050,2,4,18,10,0,10,172
598061,2,4,18,4,1,5,107
598069,2,4,18,21,1,22,194
729288,2,4,18,4,0,4,194
729296,2,4,18,27,0,27,182
729318,2,4,18,5,0,5,115
734012,2,4,18,22,0,22,202
734024,2,4,18,10,0,10,154
734048,2,4,18,21,0,21,130
829714,2,4,18,1,3,4,122
829746,2,4,18,15,0,15,167
829758,2,4,18,1,0,1,90
829764,2,4,18,7,0,7,123
829780,2,4,18,5,0,5,129
829804,2,4,18,18,0,18,147
980924,2,4,18,13,0,13,144
980946,2,4,18,2,0,2,141
980968,2,4,18,13,0,13,143
980982,2,4,18,13,0,13,152
1082594,2,4,18,12,0,12,157
1082605,2,4,18,6,0,6,130
1082609,2,4,18,12,0,12,144
1082623,2,4,18,9,0,9,167
335989,1,5,18,1,0,1,107
336005,1,5,18,15,1,16,180
336028,1,5,18,10,0,10,177
336038,1,5,18,12,0,12,198
336043,1,5,18,8,0,8,172
392195,1,5,18,4,2,6,125
392215,1,5,18,15,0,15,179
392222,1,5,18,10,0,10,120
392230,1,5,18,7,1,8,138
392238,1,5,18,4,0,4,95
419116,1,5,18,7,0,7,121
419120,1,5,18,3,0,3,88
419123,1,5,18,2,1,3,145
419129,1,5,18,13,0,13,160
419134,1,5,18,10,0,10,160
419146,1,5,18,4,0,4,140
419159,1,5,18,2,0,2,106
419163,1,5,18,5,0,5,117
501214,1,5,18,11,0,11,136
501245,1,5,18,9,1,10,136
501257,1,5,18,6,0,6,130
501263,1,5,18,1,0,1,92
548314,1,5,18,9,0,9,165
548317,1,5,18,14,0,14,141
548325,1,5,18,2,2,4,113
548329,1,5,18,17,0,17,175
548337,1,5,18,2,2,4,133
548354,1,5,18,5,0,5,128
548359,1,5,18,8,1,9,150
548366,1,5,18,10,0,10,107
548370,1,5,18,11,0,11,156
548378,1,5,18,7,0,7,114
548382,1,5,18,6,1,7,143
598006,1,5,18,10,0,10,159
598010,1,5,18,7,1,8,114
598014,1,5,18,12,2,14,126
598024,1,5,18,9,0,9,153
598028,1,5,18,2,0,2,112
598031,1,5,18,11,1,12,168
598048,1,5,18,4,0,4,119
598077,1,5,18,13,0,13,132
729296,1,5,18,15,0,15,174
729320,1,5,18,6,0,6,133
733984,1,5,18,10,1,11,150
734008,1,5,18,7,0,7,136
734016,1,5,18,2,0,2,169
734046,1,5,18,18,0,18,161
829714,1,5,18,9,1,10,138
829746,1,5,18,9,2,11,165
829754,1,5,18,3,0,3,122
829782,1,5,18,10,0,10,159
829816,1,5,18,11,0,11,180
335992,2,5,18,9,1,10,164
335995,2,5,18,5,1,6,192
335997,2,5,18,4,0,4,138
336020,2,5,18,6,0,6,150
336024,2,5,18,10,0,10,171
336041,2,5,18,7,4,11,114
336045,2,5,18,4,3,7,146
392200,2,5,18,6,0,6,102
392203,2,5,18,14,0,14,141
392207,2,5,18,1,0,1,117
392210,2,5,18,6,0,6,131
392225,2,5,18,5,0,5,105
392235,2,5,18,11,1,12,119
419112,2,5,18,21,0,21,194
419139,2,5,18,2,0,2,121
419142,2,5,18,13,3,16,208
419155,2,5,18,13,0,13,117
501204,2,5,18,13,2,15,123
501209,2,5,18,5,0,5,141
501225,2,5,18,6,0,6,130
501236,2,5,18,6,0,6,94
501240,2,5,18,8,2,10,125
501254,2,5,18,5,0,5,130
548322,2,5,18,6,2,8,165
548331,2,5,18,13,0,13,172
548341,2,5,18,9,0,9,130
548350,2,5,18,10,0,10,138
598019,2,5,18,11,0,11,119
598037,2,5,18,16,0,16,146
598041,2,5,18,17,0,17,159
598052,2,5,18,11,0,11,161
598054,2,5,18,5,0,5,155
598057,2,5,18,4,1,5,135
598063,2,5,18,6,0,6,144
598068,2,5,18,5,0,5,134
598070,2,5,18,2,1,3,88
598076,2,5,18,6,4,10,118
729290,2,5,18,7,0,7,117
729302,2,5,18,5,0,5,112
733980,2,5,18,12,0,12,148
733994,2,5,18,2,0,2,91
734004,2,5,18,22,1,23,170
734022,2,5,18,10,1,11,127
734038,2,5,18,6,0,6,131
829720,2,5,18,16,1,17,166
829726,2,5,18,12,0,12,153
829732,2,5,18,8,0,8,116
829740,2,5,18,9,0,9,156
829774,2,5,18,8,0,8,162
829792,2,5,18,17,0,17,162
829802,2,5,18,10,0,10,125
829824,2,5,18,1,1,2,105
336000,1,6,18,11,0,11,139
336003,1,6,18,11,0,11,178
336014,1,6,18,13,0,13,167
336020,1,6,18,13,0,13,122
336025,1,6,18,12,1,13,171
392194,1,6,18,13,0,13,161
392203,1,6,18,12,0,12,133
392228,1,6,18,10,0,10,140
392231,1,6,18,7,0,7,111
392235,1,6,18,11,0,11,115
392237,1,6,18,5,0,5,115
392242,1,6,18,3,0,3,136
419121,1,6,18,8,1,9,159
419133,1,6,18,13,1,14,153
419136,1,6,18,4,0,4,149
419139,1,6,18,14,6,20,168
419145,1,6,18,9,0,9,154
419154,1,6,18,7,0,7,103
501206,1,6,18,5,0,5,95
501209,1,6,18,10,1,11,123
501228,1,6,18,13,0,13,197
501232,1,6,18,9,0,9,140
501238,1,6,18,15,0,15,138
501243,1,6,18,10,0,10,126
548347,1,6,18,20,0,20,195
548350,1,6,18,7,0,7,125
548362,1,6,18,3,0,3,128
548369,1,6,18,5,1,6,94
598003,1,6,18,4,0,4,113
598015,1,6,18,4,0,4,97
598022,1,6,18,6,0,6,122
598040,1,6,18,5,1,6,130
598049,1,6,18,4,0,4,78
598054,1,6,18,11,1,12,128
598064,1,6,18,7,0,7,106
729286,1,6,18,14,0,14,115
733980,1,6,18,10,1,11,123
733986,1,6,18,17,0,17,151
733990,1,6,18,17,0,17,136
733998,1,6,18,5,0,5,137
734024,1,6,18,11,0,11,155
734044,1,6,18,5,0,5,115
829720,1,6,18,17,0,17,158
829736,1,6,18,6,0,6,142
829744,1,6,18,4,2,6,123
829752,1,6,18,12,1,13,174
829762,1,6,18,2,0,2,94
829788,1,6,18,15,1,16,137
829818,1,6,18,9,0,9,160
980908,1,6,18,5,0,5,98
980938,1,6,18,10,1,11,141
980956,1,6,18,18,0,18,163
980970,1,6,18,4,2,6,144
981002,1,6,18,8,2,10,91
981016,1,6,18,10,0,10,125
1082599,1,6,18,19,0,19,160
1082605,1,6,18,9,0,9,153
1082608,1,6,18,6,1,7,152
1082622,1,6,18,3,0,3,149
1082626,1,6,18,0,0,0,67
1082642,1,6,18,19,0,19,160
336006,2,6,18,2,0,2,156
336009,2,6,18,3,0,3,132
336022,2,6,18,1,5,6,110
336031,2,6,18,10,0,10,152
336037,2,6,18,9,0,9,161
392199,2,6,18,9,0,9,135
392206,2,6,18,4,0,4,132
392211,2,6,18,5,0,5,133
392216,2,6,18,10,0,10,144
392220,2,6,18,3,0,3,107
392224,2,6,18,4,0,4,125
392240,2,6,18,12,0,12,166
419113,2,6,18,9,0,9,126
419116,2,6,18,2,0,2,142
419125,2,6,18,16,1,17,152
419149,2,6,18,4,0,4,151
419157,2,6,18,5,0,5,125
419160,2,6,18,9,0,9,109
419165,2,6,18,9,1,10,119
501218,2,6,18,18,2,20,167
501221,2,6,18,11,0,11,131
501235,2,6,18,13,1,14,123
501248,2,6,18,11,0,11,168
501251,2,6,18,4,2,6,129
501258,2,6,18,6,0,6,133
501262,2,6,18,14,1,15,125
548315,2,6,18,7,1,8,123
548326,2,6,18,14,0,14,150
548338,2,6,18,10,0,10,152
548374,2,6,18,15,0,15,126
548377,2,6,18,7,0,7,172
548379,2,6,18,6,0,6,141
548383,2,6,18,10,0,10,130
598006,2,6,18,4,1,5,149
598011,2,6,18,3,0,3,140
598025,2,6,18,0,0,0,83
598033,2,6,18,9,0,9,131
598045,2,6,18,11,0,11,137
598059,2,6,18,17,0,17,150
598067,2,6,18,3,0,3,125
598072,2,6,18,3,0,3,122
729294,2,6,18,20,1,21,156
729306,2,6,18,17,1,18,154
729314,2,6,18,6,0,6,113
734010,2,6,18,6,0,6,147
734016,2,6,18,11,0,11,120
734036,2,6,18,12,0,12,142
829712,2,6,18,4,1,5,124
829730,2,6,18,8,2,10,159
829766,2,6,18,6,1,7,137
829782,2,6,18,7,0,7,145
829798,2,6,18,7,0,7,142
980926,2,6,18,11,1,12,183
980950,2,6,18,10,1,11,155
980966,2,6,18,8,0,8,150
980976,2,6,18,12,0,12,154
980988,2,6,18,13,0,13,144
980998,2,6,18,4,0,4,123
981008,2,6,18,9,3,12,143
1082595,2,6,18,11,0,11,137
1082611,2,6,18,13,0,13,158
1082614,2,6,18,12,0,12,113
1082630,2,6,18,12,0,12,174
1082632,2,6,18,6,3,9,214
1082640,2,6,18,8,0,8,181
1082646,2,6,18,8,0,8,135
335990,1,7,18,20,0,20,149
335999,1,7,18,11,0,11,135
336009,1,7,18,10,0,10,134
336029,1,7,18,14,0,14,156
336037,1,7,18,8,0,8,145
336041,1,7,18,9,1,10,118
392186,1,7,18,22,0,22,148
392202,1,7,18,7,0,7,169
392208,1,7,18,16,0,16,122
392213,1,7,18,13,1,14,115
392220,1,7,18,14,0,14,105
392223,1,7,18,9,0,9,134
392232,1,7,18,12,2,14,131
392240,1,7,18,11,1,12,144
419112,1,7,18,6,5,11,191
419119,1,7,18,10,1,11,198
419124,1,7,18,4,0,4,127
419135,1,7,18,13,0,13,133
419143,1,7,18,9,0,9,144
419151,1,7,18,8,0,8,135
419155,1,7,18,12,1,13,143
419157,1,7,18,14,0,14,146
419162,1,7,18,19,0,19,171
419166,1,7,18,10,1,11,117
419167,1,7,18,10,0,10,151
501215,1,7,18,5,0,5,157
501226,1,7,18,8,0,8,143
501229,1,7,18,8,0,8,132
501236,1,7,18,2,0,2,83
501242,1,7,18,13,0,13,144
501246,1,7,18,11,0,11,125
501251,1,7,18,14,0,14,163
501268,1,7,18,5,2,7,118
548322,1,7,18,10,1,11,175
548330,1,7,18,5,1,6,89
548339,1,7,18,6,0,6,146
548356,1,7,18,1,1,2,99
548365,1,7,18,8,0,8,113
548368,1,7,18,13,1,14,170
598007,1,7,18,8,0,8,120
598011,1,7,18,7,0,7,167
598016,1,7,18,21,0,21,158
598029,1,7,18,14,1,15,131
598038,1,7,18,2,0,2,170
598042,1,7,18,9,2,11,139
598044,1,7,18,8,0,8,108
598051,1,7,18,13,0,13,112
598055,1,7,18,5,0,5,135
598068,1,7,18,8,0,8,155
598078,1,7,18,16,1,17,129
729292,1,7,18,1,0,1,102
729308,1,7,18,5,0,5,125
729314,1,7,18,5,1,6,100
733988,1,7,18,13,0,13,152
734000,1,7,18,9,2,11,129
734014,1,7,18,5,0,5,128
734022,1,7,18,7,1,8,149
734036,1,7,18,7,0,7,167
734050,1,7,18,8,0,8,153
829710,1,7,18,10,1,11,133
829726,1,7,18,13,0,13,129
829734,1,7,18,4,1,5,160
829742,1,7,18,8,0,8,184
829756,1,7,18,12,3,15,141
829774,1,7,18,19,1,20,159
829780,1,7,18,8,0,8,154
829810,1,7,18,10,1,11,141
829822,1,7,18,15,0,15,156
829828,1,7,18,10,0,10,183
980906,1,7,18,10,0,10,90
980922,1,7,18,12,1,13,112
980928,1,7,18,6,1,7,130
980946,1,7,18,11,0,11,176
980990,1,7,18,9,0,9,113
980998,1,7,18,7,0,7,178
981012,1,7,18,7,0,7,160
1082592,1,7,18,7,1,8,145
1082614,1,7,18,3,0,3,123
1082635,1,7,18,14,2,16,182
1082638,1,7,18,12,2,14,126
1082644,1,7,18,18,0,18,157
1082650,1,7,18,12,1,13,105
335994,2,7,18,13,0,13,181
335996,2,7,18,6,1,7,113
336002,2,7,18,3,0,3,132
336033,2,7,18,3,1,4,163
392197,2,7,18,12,0,12,143
392205,2,7,18,7,0,7,101
392217,2,7,18,4,0,4,112
392230,2,7,18,14,0,14,132
419127,2,7,18,13,0,13,152
419130,2,7,18,9,0,9,168
419137,2,7,18,12,0,12,145
419147,2,7,18,14,0,14,128
419170,2,7,18,22,0,22,136
501210,2,7,18,7,0,7,138
501223,2,7,18,9,0,9,108
501261,2,7,18,8,0,8,94
501272,2,7,18,13,1,14,146
501274,2,7,18,3,0,3,133
501275,2,7,18,6,0,6,124
548313,2,7,18,6,0,6,85
548319,2,7,18,14,0,14,116
548344,2,7,18,8,0,8,137
548347,2,7,18,10,1,11,159
548351,2,7,18,12,2,14,97
548360,2,7,18,2,0,2,149
548372,2,7,18,18,0,18,149
548375,2,7,18,8,0,8,105
548382,2,7,18,7,0,7,162
548384,2,7,18,4,0,4,129
598004,2,7,18,10,0,10,140
598024,2,7,18,4,1,5,88
598034,2,7,18,10,0,10,142
598060,2,7,18,12,0,12,112
598065,2,7,18,20,1,21,167
598071,2,7,18,10,0,10,130
598075,2,7,18,3,0,3,140
598077,2,7,18,2,1,3,143
729284,2,7,18,3,1,4,113
729322,2,7,18,4,0,4,146
733978,2,7,18,16,0,16,144
734006,2,7,18,9,0,9,151
734030,2,7,18,3,1,4,150
829722,2,7,18,14,1,15,131
829752,2,7,18,8,1,9,144
829788,2,7,18,10,0,10,131
829794,2,7,18,4,0,4,129
829800,2,7,18,9,1,10,176
980914,2,7,18,4,0,4,170
980932,2,7,18,14,0,14,171
980938,2,7,18,9,1,10,133
980952,2,7,18,21,1,22,178
980962,2,7,18,14,1,15,153
980986,2,7,18,16,0,16,142
1082597,2,7,18,18,1,19,149
1082600,2,7,18,6,0,6,155
1082602,2,7,18,10,3,13,133
1082606,2,7,18,6,0,6,160
1082618,2,7,18,9,2,11,137
1082625,2,7,18,9,0,9,139
1082628,2,7,18,11,1,12,145
1082641,2,7,18,16,0,16,208
1082647,2,7,18,13,0,13,124
335991,1,8,18,3,0,3,105
335993,1,8,18,26,0,26,116
335995,1,8,18,15,0,15,186
336004,1,8,18,8,1,9,137
336007,1,8,18,9,0,9,158
336016,1,8,18,10,0,10,121
336036,1,8,18,12,0,12,155
336042,1,8,18,12,3,15,127
392193,1,8,18,12,0,12,170
392197,1,8,18,6,0,6,157
392206,1,8,18,5,0,5,139
392210,1,8,18,9,0,9,127
392217,1,8,18,4,1,5,123
392221,1,8,18,18,1,19,152
392225,1,8,18,17,0,17,147
392244,1,8,18,9,1,10,125
419115,1,8,18,11,0,11,160
419122,1,8,18,13,0,13,157
419125,1,8,18,14,0,14,156
419131,1,8,18,9,1,10,128
419156,1,8,18,4,0,4,133
419165,1,8,18,4,0,4,128
419169,1,8,18,0,0,0,82
501204,1,8,18,3,0,3,116
501213,1,8,18,11,0,11,156
501217,1,8,18,14,1,15,144
501221,1,8,18,6,1,7,153
501234,1,8,18,5,0,5,115
501248,1,8,18,11,0,11,160
501255,1,8,18,7,0,7,119
501261,1,8,18,7,0,7,104
501269,1,8,18,12,0,12,181
548319,1,8,18,4,0,4,123
548326,1,8,18,4,1,5,135
548331,1,8,18,17,0,17,160
548334,1,8,18,13,0,13,170
548340,1,8,18,8,0,8,111
548346,1,8,18,10,1,11,162
548351,1,8,18,8,1,9,99
548353,1,8,18,24,1,25,155
548361,1,8,18,14,0,14,156
548371,1,8,18,14,0,14,159
548381,1,8,18,20,0,20,119
336012,2,8,18,21,0,21,148
336019,2,8,18,7,0,7,161
336025,2,8,18,18,0,18,170
336029,2,8,18,7,0,7,137
336039,2,8,18,3,1,4,132
392201,2,8,18,8,1,9,150
392228,2,8,18,3,0,3,152
392233,2,8,18,6,1,7,134
392234,2,8,18,18,0,18,110
392241,2,8,18,7,0,7,138
392242,2,8,18,2,0,2,154
419111,2,8,18,8,0,8,141
419135,2,8,18,0,0,0,131
419140,2,8,18,7,1,8,142
419143,2,8,18,0,1,1,113
419146,2,8,18,4,0,4,141
419150,2,8,18,9,0,9,166
419152,2,8,18,9,0,9,126
419161,2,8,18,10,0,10,156
419168,2,8,18,2,0,2,103
501208,2,8,18,7,1,8,135
501229,2,8,18,2,5,7,123
501241,2,8,18,7,0,7,137
501244,2,8,18,5,0,5,131
501264,2,8,18,2,0,2,126
548316,2,8,18,0,0,0,119
548357,2,8,18,17,1,18,132
548364,2,8,18,6,0,6,126
548378,2,8,18,8,0,8,118
501205,1,9,18,12,0,12,147
501212,1,9,18,2,1,3,120
501224,1,9,18,7,0,7,119
501230,1,9,18,7,0,7,99
501247,1,9,18,9,2,11,125
501252,1,9,18,5,1,6,112
501259,1,9,18,8,2,10,164
501215,2,9,18,8,0,8,164
501238,2,9,18,9,0,9,118
501266,2,9,18,12,0,12,115
501218,1,10,18,5,0,5,151
501223,1,10,18,0,0,0,118
501233,1,10,18,8,2,10,123
501240,1,10,18,8,0,8,121
501264,1,10,18,10,0,10,112
501267,1,10,18,11,0,11,104
548313,1,10,18,11,0,11,116
548318,1,10,18,9,0,9,131
548324,1,10,18,9,1,10,112
548332,1,10,18,9,0,9,164
548338,1,10,18,22,1,23,171
548342,1,10,18,13,0,13,123
548363,1,10,18,7,0,7,113
598008,1,10,18,3,1,4,84
598020,1,10,18,3,0,3,131
598030,1,10,18,17,0,17,159
598052,1,10,18,9,0,9,151
598060,1,10,18,2,0,2,101
598066,1,10,18,18,0,18,143
598072,1,10,18,10,0,10,140
501212,2,10,18,11,0,11,135
501231,2,10,18,4,0,4,106
501237,2,10,18,3,0,3,136
501246,2,10,18,12,0,12,118
501253,2,10,18,1,0,1,120
501255,2,10,18,4,0,4,136
548327,2,10,18,12,0,12,134
548335,2,10,18,10,0,10,140
548346,2,10,18,12,0,12,141
548353,2,10,18,11,1,12,147
548356,2,10,18,10,1,11,105
548358,2,10,18,9,0,9,129
548367,2,10,18,4,1,5,122
548370,2,10,18,2,1,3,112
548380,2,10,18,3,0,3,95
598005,2,10,18,9,0,9,103
598014,2,10,18,7,0,7,138
598016,2,10,18,5,0,5,132
598023,2,10,18,5,0,5,106
598032,2,10,18,2,0,2,126
598040,2,10,18,2,0,2,130
598043,2,10,18,4,0,4,114
598047,2,10,18,8,0,8,160
598058,2,10,18,5,0,5,103
598005,1,11,18,6,0,6,113
598023,1,11,18,7,0,7,93
598035,1,11,18,11,0,11,126
598037,1,11,18,10,0,10,118
598053,1,11,18,7,2,9,144
598061,1,11,18,14,0,14,128
598065,1,11,18,12,0,12,164
598070,1,11,18,11,0,11,122
598076,1,11,18,8,1,9,113
729290,1,11,18,7,1,8,116
729306,1,11,18,21,0,21,160
729316,1,11,18,5,0,5,113
729322,1,11,18,6,0,6,143
733982,1,11,18,16,0,16,140
733994,1,11,18,4,0,4,115
734006,1,11,18,6,0,6,124
734012,1,11,18,18,0,18,167
734020,1,11,18,3,0,3,129
734042,1,11,18,3,0,3,130
829732,1,11,18,6,0,6,104
829748,1,11,18,9,0,9,158
829764,1,11,18,8,0,8,131
829778,1,11,18,11,0,11,170
829792,1,11,18,14,0,14,184
829798,1,11,18,8,1,9,131
829804,1,11,18,2,0,2,159
829820,1,11,18,3,0,3,93
980920,1,11,18,10,0,10,125
980948,1,11,18,11,0,11,92
980958,1,11,18,13,0,13,174
980978,1,11,18,14,0,14,157
980984,1,11,18,3,0,3,114
980988,1,11,18,9,1,10,136
981008,1,11,18,10,1,11,135
981020,1,11,18,9,1,10,143
981024,1,11,18,10,2,12,168
1082591,1,11,18,15,2,17,179
1082600,1,11,18,7,0,7,147
1082609,1,11,18,10,0,10,134
1082611,1,11,18,12,0,12,170
1082615,1,11,18,12,0,12,146
1082623,1,11,18,5,0,5,176
1082627,1,11,18,11,0,11,186
1082630,1,11,18,20,0,20,153
1082648,1,11,18,13,0,13,118
598009,2,11,18,14,0,14,117
598015,2,11,18,6,0,6,103
598018,2,11,18,7,0,7,122
598026,2,11,18,7,0,7,106
598044,2,11,18,2,1,3,130
598056,2,11,18,12,0,12,127
598074,2,11,18,8,0,8,116
729300,2,11,18,3,0,3,116
734026,2,11,18,7,0,7,141
734034,2,11,18,8,0,8,176
829716,2,11,18,5,2,7,145
829724,2,11,18,10,0,10,172
829736,2,11,18,16,0,16,145
829756,2,11,18,3,0,3,127
829786,2,11,18,20,1,21,117
980912,2,11,18,11,1,12,164
980928,2,11,18,12,0,12,145
980940,2,11,18,7,0,7,146
980972,2,11,18,7,0,7,113
980996,2,11,18,18,1,19,160
981014,2,11,18,8,0,8,136
981022,2,11,18,10,0,10,139
1082604,2,11,18,3,0,3,132
1082634,2,11,18,10,0,10,127
1082638,2,11,18,7,0,7,136
1082643,2,11,18,12,0,12,154
980916,1,12,18,5,0,5,141
980924,1,12,18,8,1,9,140
980944,1,12,18,14,0,14,133
980954,1,12,18,9,0,9,169
980962,1,12,18,7,0,7,142
980974,1,12,18,9,0,9,171
980994,1,12,18,1,0,1,103
1082594,1,12,18,2,3,5,133
1082603,1,12,18,5,1,6,155
1082607,1,12,18,2,0,2,132
1082618,1,12,18,5,0,5,142
1082620,1,12,18,5,0,5,152
1082624,1,12,18,10,0,10,139
1082634,1,12,18,6,1,7,123
1082647,1,12,18,6,1,7,121
980936,2,12,18,25,0,25,161
980970,2,12,18,15,5,20,146
980984,2,12,18,14,1,15,116
981010,2,12,18,13,2,15,144
1082592,2,12,18,7,0,7,165
1082615,2,12,18,17,0,17,147
1082629,2,12,18,11,0,11,137
1082631,2,12,18,2,0,2,148
1082642,2,12,18,5,0,5,136
1082650,2,12,18,7,0,7,107
980934,1,13,18,8,0,8,125
980950,1,13,18,10,1,11,154
980966,1,13,18,7,0,7,130
980972,1,13,18,7,0,7,106
981018,1,13,18,7,5,12,133
981022,1,13,18,10,0,10,139
1082593,1,13,18,11,1,12,153
1082596,1,13,18,4,0,4,117
1082606,1,13,18,9,0,9,154
1082625,1,13,18,19,0,19,129
1082629,1,13,18,2,0,2,148
1082632,1,13,18,6,0,6,184
1082640,1,13,18,11,0,11,175
1082643,1,13,18,6,2,8,150
980910,2,13,18,7,0,7,162
980916,2,13,18,10,2,12,163
980922,2,13,18,9,1,10,131
980942,2,13,18,5,1,6,160
980954,2,13,18,4,0,4,176
980960,2,13,18,11,1,12,118
980980,2,13,18,8,0,8,164
980992,2,13,18,1,1,2,100
981012,2,13,18,6,0,6,173
1082603,2,13,18,20,1,21,172
1082610,2,13,18,11,0,11,167
1082613,2,13,18,12,0,12,183
1082616,2,13,18,4,2,6,148
1082637,2,13,18,4,0,4,166
335987,1,1,19,21,0,21,200
335998,1,1,19,8,0,8,134
336002,1,1,19,4,4,8,126
336019,1,1,19,9,1,10,185
336022,1,1,19,10,0,10,129
336030,1,1,19,7,1,8,138
336032,1,1,19,13,0,13,136
392189,1,1,19,4,1,5,98
392204,1,1,19,11,1,12,133
392212,1,1,19,9,1,10,132
392216,1,1,19,8,0,8,147
392224,1,1,19,7,0,7,114
392226,1,1,19,16,0,16,153
392233,1,1,19,26,2,28,146
419111,1,1,19,12,1,13,150
419127,1,1,19,8,1,9,148
419132,1,1,19,9,0,9,162
419140,1,1,19,10,0,10,169
419144,1,1,19,10,0,10,188
419149,1,1,19,13,0,13,167
419153,1,1,19,15,0,15,155
419158,1,1,19,6,0,6,128
501208,1,1,19,7,0,7,155
501227,1,1,19,10,0,10,164
501235,1,1,19,12,0,12,140
501244,1,1,19,9,1,10,158
501272,1,1,19,10,0,10,166
501274,1,1,19,8,1,9,134
548320,1,1,19,3,0,3,153
548349,1,1,19,14,0,14,181
548358,1,1,19,7,0,7,141
548373,1,1,19,9,2,11,149
548375,1,1,19,7,1,8,133
548380,1,1,19,10,0,10,127
548383,1,1,19,15,0,15,141
598013,1,1,19,13,0,13,148
598018,1,1,19,14,1,15,172
598027,1,1,19,8,0,8,115
598034,1,1,19,10,0,10,156
598045,1,1,19,10,0,10,120
598058,1,1,19,9,2,11,137
598074,1,1,19,10,0,10,121
729284,1,1,19,4,1,5,149
729294,1,1,19,10,0,10,154
729304,1,1,19,8,1,9,142
734032,1,1,19,8,0,8,183
734048,1,1,19,3,0,3,148
829718,1,1,19,13,1,14,163
829766,1,1,19,10,0,10,153
829786,1,1,19,9,0,9,154
980914,1,1,19,9,1,10,180
980952,1,1,19,10,0,10,166
980968,1,1,19,10,0,10,160
980980,1,1,19,12,0,12,145
981000,1,1,19,9,1,10,171
981006,1,1,19,4,0,4,120
981014,1,1,19,3,0,3,164
1082597,1,1,19,11,0,11,155
1082604,1,1,19,7,2,9,163
1082613,1,1,19,12,0,12,180
1082617,1,1,19,5,0,5,131
1082631,1,1,19,21,0,21,151
1082649,1,1,19,1,0,1,107
335991,2,1,19,8,1,9,112
336005,2,1,19,3,1,4,151
336008,2,1,19,18,0,18,160
336040,2,1,19,8,0,8,160
392195,2,1,19,8,1,9,144
392208,2,1,19,4,0,4,130
392236,2,1,19,19,0,19,183
392238,2,1,19,6,1,7,98
419114,2,1,19,2,0,2,135
419118,2,1,19,6,0,6,109
419123,2,1,19,4,1,5,132
419136,2,1,19,9,0,9,134
501203,2,1,19,17,0,17,145
501214,2,1,19,3,0,3,160
501224,2,1,19,12,0,12,119
501247,2,1,19,6,0,6,132
548317,2,1,19,3,0,3,134
548325,2,1,19,12,2,14,131
548328,2,1,19,4,0,4,126
548340,2,1,19,9,1,10,126
548352,2,1,19,10,0,10,134
548362,2,1,19,1,2,3,154
548368,2,1,19,6,0,6,145
548386,2,1,19,10,1,11,182
598003,2,1,19,3,0,3,129
598010,2,1,19,3,0,3,125
598021,2,1,19,19,0,19,147
598036,2,1,19,1,1,2,150
598039,2,1,19,8,2,10,182
598055,2,1,19,1,0,1,105
598062,2,1,19,6,0,6,111
598066,2,1,19,4,0,4,153
729312,2,1,19,1,1,2,109
729320,2,1,19,3,1,4,141
733984,2,1,19,5,2,7,154
733990,2,1,19,5,0,5,161
734014,2,1,19,6,0,6,142
734020,2,1,19,6,0,6,133
734054,2,1,19,10,0,10,195
829710,2,1,19,5,0,5,170
829728,2,1,19,5,0,5,160
829744,2,1,19,2,0,2,147
829770,2,1,19,13,0,13,118
829796,2,1,19,5,0,5,176
829810,2,1,19,8,1,9,160
829816,2,1,19,19,1,20,184
980920,2,1,19,4,0,4,146
980944,2,1,19,10,1,11,154
980956,2,1,19,2,1,3,159
980964,2,1,19,16,0,16,185
981020,2,1,19,7,1,8,138
1082608,2,1,19,7,0,7,160
1082620,2,1,19,4,0,4,184
1082627,2,1,19,4,1,5,154
1082639,2,1,19,9,0,9,148
1082644,2,1,19,7,0,7,160
335997,1,2,19,9,0,9,130
336011,1,2,19,9,0,9,126
336021,1,2,19,2,1,3,131
336031,1,2,19,6,0,6,130
336034,1,2,19,13,0,13,122
336039,1,2,19,13,0,13,143
392187,1,2,19,11,0,11,117
392196,1,2,19,16,1,17,162
392199,1,2,19,13,0,13,139
392209,1,2,19,2,0,2,135
392218,1,2,19,9,0,9,102
392241,1,2,19,7,1,8,147
419114,1,2,19,9,0,9,121
419128,1,2,19,24,0,24,154
419138,1,2,19,18,0,18,150
419150,1,2,19,13,0,13,167
501210,1,2,19,8,0,8,124
501237,1,2,19,10,0,10,175
501249,1,2,19,10,1,11,197
501273,1,2,19,19,0,19,167
501275,1,2,19,11,2,13,178
548315,1,2,19,18,0,18,147
548323,1,2,19,8,0,8,198
548341,1,2,19,19,2,21,174
548355,1,2,19,13,1,14,154
548367,1,2,19,8,1,9,158
548372,1,2,19,13,0,13,147
548377,1,2,19,13,1,14,203
598004,1,2,19,6,2,8,140
598009,1,2,19,11,0,11,125
598017,1,2,19,20,0,20,160
598032,1,2,19,17,2,19,253
598041,1,2,19,5,0,5,149
598047,1,2,19,7,0,7,161
598050,1,2,19,13,1,14,164
598059,1,2,19,12,0,12,160
598062,1,2,19,4,0,4,109
598069,1,2,19,12,0,12,169
729318,1,2,19,6,4,10,120
734004,1,2,19,21,0,21,172
734010,1,2,19,8,1,9,159
734026,1,2,19,6,0,6,152
734040,1,2,19,11,0,11,143
829724,1,2,19,10,1,11,159
829768,1,2,19,12,1,13,188
829790,1,2,19,15,0,15,217
829800,1,2,19,13,1,14,218
829824,1,2,19,15,0,15,169
829826,1,2,19,7,0,7,131
980912,1,2,19,27,1,28,214
980926,1,2,19,4,2,6,183
980932,1,2,19,17,1,18,161
980936,1,2,19,15,1,16,173
980942,1,2,19,11,0,11,163
980964,1,2,19,13,0,13,167
980982,1,2,19,6,2,8,163
980986,1,2,19,5,2,7,138
980992,1,2,19,30,0,30,229
1082595,1,2,19,6,0,6,150
1082598,1,2,19,18,1,19,134
1082602,1,2,19,5,0,5,132
1082610,1,2,19,18,0,18,196
1082621,1,2,19,10,0,10,130
1082628,1,2,19,10,0,10,157
1082636,1,2,19,11,1,12,137
1082646,1,2,19,7,3,10,145
335990,2,2,19,8,0,8,163
336001,2,2,19,8,0,8,162
336003,2,2,19,5,0,5,162
336007,2,2,19,21,0,21,171
336028,2,2,19,4,0,4,118
392193,2,2,19,15,1,16,156
392204,2,2,19,3,1,4,130
392213,2,2,19,1,0,1,150
392223,2,2,19,7,0,7,125
392226,2,2,19,16,0,16,169
392229,2,2,19,12,0,12,125
392237,2,2,19,7,2,9,135
392243,2,2,19,13,1,14,149
392244,2,2,19,12,0,12,129
419117,2,2,19,10,1,11,204
419124,2,2,19,9,0,9,151
419133,2,2,19,11,0,11,153
419141,2,2,19,9,0,9,179
419145,2,2,19,6,0,6,143
419156,2,2,19,1,0,1,135
419162,2,2,19,7,1,8,127
419167,2,2,19,12,0,12,146
501205,2,2,19,12,1,13,162
501213,2,2,19,3,2,5,137
501216,2,2,19,9,1,10,153
501227,2,2,19,4,0,4,175
501232,2,2,19,8,1,9,158
501276,2,2,19,5,1,6,133
548320,2,2,19,10,2,12,118
548329,2,2,19,6,0,6,127
548332,2,2,19,7,0,7,162
548336,2,2,19,3,0,3,160
548349,2,2,19,23,0,23,138
548361,2,2,19,19,0,19,185
548381,2,2,19,8,0,8,113
598022,2,2,19,5,0,5,141
598038,2,2,19,14,0,14,124
729304,2,2,19,8,1,9,142
733982,2,2,19,23,1,24,152
733988,2,2,19,8,0,8,161
733996,2,2,19,6,0,6,149
734018,2,2,19,4,0,4,129
734032,2,2,19,12,1,13,155
829718,2,2,19,15,0,15,179
829742,2,2,19,6,1,7,182
829750,2,2,19,13,0,13,147
829784,2,2,19,7,0,7,124
980958,2,2,19,10,1,11,173
980974,2,2,19,17,1,18,188
981000,2,2,19,13,0,13,186
981016,2,2,19,1,0,1,139
981018,2,2,19,3,0,3,159
981024,2,2,19,11,1,12,191
1082591,2,2,19,8,1,9,165
1082607,2,2,19,6,0,6,131
1082624,2,2,19,2,0,2,88
1082633,2,2,19,4,0,4,119
335988,1,3,19,15,0,15,215
335994,1,3,19,11,1,12,194
336001,1,3,19,23,1,24,164
336006,1,3,19,14,0,14,158
336010,1,3,19,11,0,11,109
336012,1,3,19,3,0,3,124
336018,1,3,19,15,2,17,176
336023,1,3,19,14,0,14,141
336045,1,3,19,6,3,9,148
392190,1,3,19,7,0,7,165
392201,1,3,19,6,0,6,159
392207,1,3,19,8,1,9,153
392211,1,3,19,5,0,5,153
392214,1,3,19,12,0,12,165
392229,1,3,19,5,0,5,123
392236,1,3,19,7,0,7,169
392239,1,3,19,1,0,1,110
392243,1,3,19,10,0,10,140
419118,1,3,19,17,0,17,148
419130,1,3,19,12,0,12,173
419142,1,3,19,8,1,9,235
419147,1,3,19,11,0,11,152
419152,1,3,19,7,0,7,132
419160,1,3,19,9,2,11,100
419168,1,3,19,8,4,12,128
419170,1,3,19,11,0,11,157
501203,1,3,19,5,0,5,137
501211,1,3,19,9,1,10,181
501216,1,3,19,8,0,8,176
501231,1,3,19,7,0,7,133
501241,1,3,19,20,1,21,157
501250,1,3,19,9,0,9,107
501254,1,3,19,13,0,13,188
501258,1,3,19,20,0,20,159
501266,1,3,19,12,2,14,141
501271,1,3,19,9,0,9,111
501276,1,3,19,9,1,10,198
548311,1,3,19,5,0,5,109
548316,1,3,19,16,1,17,170
548321,1,3,19,9,0,9,103
548327,1,3,19,7,0,7,147
548335,1,3,19,8,1,9,146
548352,1,3,19,11,0,11,129
548357,1,3,19,8,0,8,147
548360,1,3,19,8,1,9,169
548376,1,3,19,12,0,12,113
548384,1,3,19,18,0,18,168
548385,1,3,19,23,2,25,215
548386,1,3,19,11,0,11,182
598025,1,3,19,9,1,10,160
598039,1,3,19,9,0,9,188
598043,1,3,19,12,0,12,150
598046,1,3,19,12,1,13,174
598056,1,3,19,10,0,10,203
598063,1,3,19,14,0,14,130
598067,1,3,19,18,0,18,160
598075,1,3,19,12,0,12,173
729288,1,3,19,7,0,7,187
729298,1,3,19,12,0,12,162
729302,1,3,19,9,2,11,131
734018,1,3,19,8,0,8,131
734028,1,3,19,8,0,8,142
734034,1,3,19,6,1,7,161
829712,1,3,19,9,0,9,134
829716,1,3,19,10,0,10,194
829728,1,3,19,7,0,7,160
829740,1,3,19,8,2,10,149
829750,1,3,19,13,1,14,177
829758,1,3,19,17,0,17,188
829770,1,3,19,3,0,3,124
829784,1,3,19,7,0,7,144
829794,1,3,19,14,0,14,147
829802,1,3,19,17,0,17,149
829806,1,3,19,3,1,4,114
336014,2,3,19,7,0,7,173
336034,2,3,19,1,1,2,111
336038,2,3,19,11,1,12,197
336042,2,3,19,10,0,10,141
392186,2,3,19,6,0,6,141
392194,2,3,19,8,1,9,175
392207,2,3,19,4,0,4,121
392222,2,3,19,3,0,3,141
392232,2,3,19,7,0,7,145
419115,2,3,19,9,0,9,146
419121,2,3,19,14,0,14,184
419126,2,3,19,2,1,3,127
419128,2,3,19,7,0,7,124
419134,2,3,19,5,0,5,156
419138,2,3,19,14,2,16,162
419164,2,3,19,13,0,13,177
501226,2,3,19,3,0,3,140
501233,2,3,19,6,0,6,140
501245,2,3,19,7,0,7,149
501273,2,3,19,21,0,21,164
548323,2,3,19,28,0,28,191
548337,2,3,19,8,0,8,139
548348,2,3,19,15,0,15,140
548366,2,3,19,6,6,12,127
548373,2,3,19,18,0,18,150
598007,2,3,19,9,2,11,137
598017,2,3,19,12,1,13,150
598020,2,3,19,6,0,6,124
598027,2,3,19,15,0,15,118
598031,2,3,19,5,1,6,175
598035,2,3,19,13,0,13,145
598078,2,3,19,7,1,8,107
729308,2,3,19,9,0,9,142
729316,2,3,19,4,0,4,140
733986,2,3,19,5,0,5,168
733992,2,3,19,9,0,9,168
734000,2,3,19,6,0,6,147
734008,2,3,19,13,0,13,137
734050,2,3,19,5,1,6,176
734052,2,3,19,10,4,14,187
829778,2,3,19,9,0,9,164
829822,2,3,19,5,0,5,162
829826,2,3,19,8,0,8,135
829828,2,3,19,3,0,3,140
335992,1,4,19,11,0,11,149
335996,1,4,19,10,2,12,169
336008,1,4,19,7,0,7,157
336024,1,4,19,13,0,13,208
336033,1,4,19,13,0,13,171
336040,1,4,19,7,0,7,170
336044,1,4,19,14,0,14,98
392191,1,4,19,7,1,8,142
392200,1,4,19,5,2,7,130
392205,1,4,19,5,0,5,107
392227,1,4,19,1,0,1,114
392234,1,4,19,5,0,5,127
419113,1,4,19,6,0,6,132
419117,1,4,19,12,0,12,184
419126,1,4,19,2,0,2,124
419137,1,4,19,11,0,11,150
419141,1,4,19,11,0,11,163
419148,1,4,19,5,1,6,147
419161,1,4,19,18,0,18,160
419164,1,4,19,19,0,19,176
501207,1,4,19,14,1,15,102
501225,1,4,19,7,0,7,190
501239,1,4,19,7,0,7,110
501253,1,4,19,6,0,6,116
501256,1,4,19,7,0,7,155
501262,1,4,19,10,0,10,154
501265,1,4,19,7,4,11,220
548328,1,4,19,19,0,19,123
548333,1,4,19,7,0,7,114
548336,1,4,19,10,0,10,149
548344,1,4,19,12,0,12,152
548348,1,4,19,10,0,10,149
548364,1,4,19,9,0,9,157
548374,1,4,19,5,0,5,131
548379,1,4,19,4,0,4,126
598012,1,4,19,3,1,4,137
598019,1,4,19,8,0,8,124
598021,1,4,19,22,1,23,150
598026,1,4,19,2,0,2,117
598033,1,4,19,17,0,17,165
598036,1,4,19,2,0,2,131
598057,1,4,19,3,0,3,137
598071,1,4,19,10,0,10,174
729300,1,4,19,4,2,6,185
729312,1,4,19,1,0,1,127
733978,1,4,19,16,4,20,165
733992,1,4,19,17,0,17,208
733996,1,4,19,4,0,4,188
734002,1,4,19,6,1,7,138
734030,1,4,19,14,0,14,147
734038,1,4,19,22,1,23,169
734052,1,4,19,7,0,7,218
734054,1,4,19,16,1,17,187
829722,1,4,19,11,0,11,164
829730,1,4,19,19,0,19,162
829738,1,4,19,6,0,6,146
829772,1,4,19,6,0,6,108
829796,1,4,19,7,2,9,162
829814,1,4,19,14,0,14,122
980910,1,4,19,9,0,9,155
980918,1,4,19,3,0,3,99
980930,1,4,19,5,0,5,120
980940,1,4,19,15,0,15,137
980960,1,4,19,6,0,6,151
980976,1,4,19,15,1,16,168
980996,1,4,19,8,0,8,168
981010,1,4,19,6,0,6,160
1082601,1,4,19,10,0,10,166
1082612,1,4,19,8,2,10,180
1082616,1,4,19,18,0,18,176
1082633,1,4,19,0,0,0,119
1082637,1,4,19,16,0,16,175
1082639,1,4,19,10,0,10,158
1082641,1,4,19,6,1,7,214
335988,2,4,19,7,0,7,198
336000,2,4,19,3,0,3,158
336004,2,4,19,8,1,9,167
336011,2,4,19,6,1,7,127
336018,2,4,19,9,0,9,155
336036,2,4,19,16,0,16,171
392196,2,4,19,14,1,15,173
392209,2,4,19,4,0,4,133
392212,2,4,19,11,0,11,147
392215,2,4,19,1,0,1,128
392221,2,4,19,10,1,11,161
392231,2,4,19,9,4,13,115
392239,2,4,19,8,0,8,85
419122,2,4,19,14,0,14,152
419129,2,4,19,10,1,11,152
419132,2,4,19,8,1,9,137
419144,2,4,19,8,0,8,204
419151,2,4,19,12,0,12,152
419154,2,4,19,1,0,1,112
501211,2,4,19,11,0,11,187
501228,2,4,19,7,0,7,195
501242,2,4,19,5,1,6,132
501249,2,4,19,1,0,1,105
501259,2,4,19,12,0,12,181
501269,2,4,19,12,0,12,116
548314,2,4,19,10,0,10,152
548318,2,4,19,8,1,9,131
548339,2,4,19,11,0,11,155
548355,2,4,19,2,0,2,154
548359,2,4,19,4,0,4,125
548371,2,4,19,8,0,8,175
598030,2,4,19,13,0,13,170
598042,2,4,19,9,0,9,158
598046,2,4,19,11,0,11,168
598050,2,4,19,4,0,4,176
598061,2,4,19,4,0,4,111
729288,2,4,19,12,0,12,206
729296,2,4,19,11,0,11,193
729318,2,4,19,11,1,12,127
734012,2,4,19,9,0,9,211
734024,2,4,19,2,0,2,156
734048,2,4,19,4,0,4,134
829714,2,4,19,8,1,9,131
829746,2,4,19,10,1,11,178
829758,2,4,19,4,0,4,94
829764,2,4,19,2,1,3,126
829780,2,4,19,9,2,11,140
829804,2,4,19,11,0,11,158
980924,2,4,19,9,0,9,153
980946,2,4,19,7,3,10,151
980968,2,4,19,10,0,10,153
980982,2,4,19,7,0,7,159
1082594,2,4,19,6,1,7,164
1082605,2,4,19,4,0,4,134
1082609,2,4,19,4,1,5,149
1082623,2,4,19,8,0,8,175
335989,1,5,19,10,0,10,117
336005,1,5,19,7,2,9,189
336028,1,5,19,9,0,9,186
336038,1,5,19,5,0,5,203
336043,1,5,19,16,0,16,188
392195,1,5,19,4,3,7,132
392215,1,5,19,21,2,23,202
392222,1,5,19,4,2,6,126
392230,1,5,19,2,2,4,142
392238,1,5,19,4,0,4,99
419116,1,5,19,7,0,7,128
419120,1,5,19,3,0,3,91
419123,1,5,19,6,0,6,151
419129,1,5,19,10,0,10,170
419134,1,5,19,10,0,10,170
419146,1,5,19,9,3,12,152
419159,1,5,19,9,0,9,115
419163,1,5,19,6,2,8,125
501214,1,5,19,8,3,11,147
501245,1,5,19,4,0,4,140
501257,1,5,19,5,6,11,141
501263,1,5,19,5,0,5,97
548314,1,5,19,12,1,13,178
548317,1,5,19,14,1,15,156
548325,1,5,19,3,0,3,116
548329,1,5,19,5,4,9,184
548337,1,5,19,9,0,9,142
548354,1,5,19,6,0,6,134
548359,1,5,19,15,1,16,166
548366,1,5,19,9,0,9,116
548370,1,5,19,5,0,5,161
548378,1,5,19,5,1,6,120
548382,1,5,19,6,2,8,151
598006,1,5,19,2,0,2,161
598010,1,5,19,17,1,18,132
598014,1,5,19,4,0,4,130
598024,1,5,19,6,1,7,160
598028,1,5,19,2,0,2,114
598031,1,5,19,7,0,7,175
598048,1,5,19,4,0,4,123
598077,1,5,19,11,4,15,147
729296,1,5,19,6,3,9,183
729320,1,5,19,10,0,10,143
733984,1,5,19,9,0,9,159
734008,1,5,19,4,0,4,140
734016,1,5,19,17,0,17,186
734046,1,5,19,11,1,12,173
829714,1,5,19,20,0,20,158
829746,1,5,19,9,1,10,175
829754,1,5,19,5,0,5,127
829782,1,5,19,14,1,15,174
829816,1,5,19,11,0,11,191
335992,2,5,19,4,0,4,168
335995,2,5,19,4,2,6,198
336020,2,5,19,5,0,5,155
336024,2,5,19,6,1,7,178
336041,2,5,19,16,1,17,131
336045,2,5,19,10,0,10,156
392200,2,5,19,4,0,4,106
392203,2,5,19,6,0,6,147
392207,2,5,19,0,0,0,121
392210,2,5,19,8,1,9,140
392225,2,5,19,5,0,5,110
392235,2,5,19,4,0,4,123
419112,2,5,19,6,1,7,201
419142,2,5,19,4,0,4,212
419155,2,5,19,12,0,12,129
501204,2,5,19,18,0,18,141
501209,2,5,19,11,0,11,152
501225,2,5,19,9,1,10,140
501236,2,5,19,1,0,1,95
501240,2,5,19,12,1,13,138
501254,2,5,19,3,0,3,133
548322,2,5,19,1,0,1,166
548331,2,5,19,13,1,14,186
548341,2,5,19,5,0,5,135
548350,2,5,19,3,0,3,141
598019,2,5,19,1,0,1,120
598041,2,5,19,7,0,7,166
598052,2,5,19,13,0,13,174
598057,2,5,19,12,0,12,147
598068,2,5,19,10,0,10,144
598070,2,5,19,14,0,14,102
598076,2,5,19,5,0,5,123
729290,2,5,19,9,0,9,126
729302,2,5,19,5,0,5,117
733980,2,5,19,8,0,8,156
733994,2,5,19,7,2,9,100
734004,2,5,19,19,2,21,191
734022,2,5,19,17,1,18,145
734038,2,5,19,18,0,18,149
829720,2,5,19,7,0,7,173
829726,2,5,19,11,0,11,164
829732,2,5,19,7,0,7,123
829740,2,5,19,1,0,1,157
829774,2,5,19,6,0,6,168
829792,2,5,19,22,0,22,184
829802,2,5,19,4,2,6,131
829824,2,5,19,4,0,4,109
336000,1,6,19,13,0,13,152
336003,1,6,19,6,0,6,184
336014,1,6,19,9,0,9,176
336020,1,6,19,27,0,27,149
336025,1,6,19,9,0,9,180
392194,1,6,19,22,0,22,183
392203,1,6,19,0,2,2,135
392228,1,6,19,10,0,10,150
392231,1,6,19,3,0,3,114
392235,1,6,19,24,1,25,140
392237,1,6,19,7,0,7,122
392242,1,6,19,8,1,9,145
419121,1,6,19,14,0,14,173
419133,1,6,19,17,1,18,171
419136,1,6,19,16,0,16,165
419139,1,6,19,9,0,9,177
419145,1,6,19,19,0,19,173
419154,1,6,19,4,0,4,107
501209,1,6,19,15,1,16,139
501228,1,6,19,12,0,12,209
501232,1,6,19,8,3,11,151
501238,1,6,19,9,0,9,147
501243,1,6,19,9,0,9,135
548347,1,6,19,2,0,2,197
548350,1,6,19,5,2,7,132
548362,1,6,19,12,1,13,141
548369,1,6,19,12,1,13,107
598003,1,6,19,12,0,12,125
598015,1,6,19,3,1,4,101
598022,1,6,19,15,0,15,137
598040,1,6,19,21,0,21,151
598049,1,6,19,2,0,2,80
598054,1,6,19,12,0,12,140
598064,1,6,19,9,0,9,115
729286,1,6,19,13,0,13,128
733980,1,6,19,11,0,11,134
733986,1,6,19,9,0,9,160
733990,1,6,19,8,4,12,148
733998,1,6,19,2,0,2,139
734024,1,6,19,4,0,4,159
734044,1,6,19,0,0,0,115
829720,1,6,19,9,0,9,167
829736,1,6,19,16,0,16,158
829744,1,6,19,20,0,20,143
829752,1,6,19,5,1,6,180
829762,1,6,19,1,0,1,95
829788,1,6,19,5,1,6,143
829818,1,6,19,15,1,16,176
980938,1,6,19,4,3,7,148
980956,1,6,19,12,1,13,176
980970,1,6,19,5,0,5,149
981002,1,6,19,8,0,8,99
981016,1,6,19,9,0,9,134
1082599,1,6,19,22,0,22,182
1082605,1,6,19,16,0,16,169
1082608,1,6,19,4,1,5,157
1082622,1,6,19,5,0,5,154
1082642,1,6,19,1,2,3,163
336006,2,6,19,15,1,16,172
336009,2,6,19,1,0,1,133
336031,2,6,19,6,0,6,158
336037,2,6,19,8,0,8,169
392199,2,6,19,12,0,12,147
392206,2,6,19,16,2,18,150
392211,2,6,19,2,0,2,135
392216,2,6,19,13,0,13,157
392220,2,6,19,11,0,11,118
419113,2,6,19,13,0,13,139
419125,2,6,19,6,0,6,158
419149,2,6,19,4,1,5,156
419157,2,6,19,7,0,7,132
419160,2,6,19,4,0,4,113
419165,2,6,19,10,0,10,129
501218,2,6,19,13,0,13,180
501221,2,6,19,11,1,12,143
501235,2,6,19,2,0,2,125
501248,2,6,19,11,0,11,179
501251,2,6,19,7,1,8,137
501258,2,6,19,15,0,15,148
501262,2,6,19,3,0,3,128
548315,2,6,19,8,0,8,131
548326,2,6,19,6,0,6,156
548338,2,6,19,15,0,15,167
548374,2,6,19,14,0,14,140
548377,2,6,19,13,1,14,186
548379,2,6,19,4,0,4,145
548383,2,6,19,7,0,7,137
598006,2,6,19,7,1,8,157
598011,2,6,19,14,0,14,154
598033,2,6,19,19,0,19,150
598059,2,6,19,13,2,15,165
598067,2,6,19,5,0,5,130
598072,2,6,19,6,0,6,128
729294,2,6,19,1,4,5,161
729306,2,6,19,11,0,11,165
729314,2,6,19,8,0,8,121
734010,2,6,19,13,1,14,161
734016,2,6,19,6,0,6,126
734036,2,6,19,6,1,7,149
829712,2,6,19,7,1,8,132
829730,2,6,19,3,1,4,163
829766,2,6,19,6,0,6,143
829782,2,6,19,12,3,15,160
829798,2,6,19,4,2,6,148
980926,2,6,19,7,1,8,191
980950,2,6,19,4,0,4,159
980976,2,6,19,3,0,3,157
980988,2,6,19,6,0,6,150
980998,2,6,19,3,0,3,126
981008,2,6,19,5,0,5,148
1082595,2,6,19,2,0,2,139
1082611,2,6,19,9,1,10,168
1082614,2,6,19,5,0,5,118
1082630,2,6,19,11,0,11,185
1082640,2,6,19,6,0,6,187
1082646,2,6,19,13,1,14,149
335990,1,7,19,9,0,9,158
335999,1,7,19,11,1,12,147
336009,1,7,19,20,2,22,156
336029,1,7,19,9,6,15,171
336037,1,7,19,16,1,17,162
336041,1,7,19,1,1,2,120
392186,1,7,19,9,0,9,157
392202,1,7,19,8,0,8,177
392208,1,7,19,8,2,10,132
392213,1,7,19,18,0,18,133
392220,1,7,19,8,1,9,114
392223,1,7,19,9,0,9,143
392232,1,7,19,5,0,5,136
392240,1,7,19,11,0,11,155
419112,1,7,19,9,0,9,200
419119,1,7,19,7,1,8,206
419124,1,7,19,8,0,8,135
419135,1,7,19,19,0,19,152
419143,1,7,19,19,1,20,164
419151,1,7,19,15,0,15,150
419155,1,7,19,11,0,11,154
419157,1,7,19,11,0,11,157
419162,1,7,19,8,0,8,179
419166,1,7,19,9,0,9,126
419167,1,7,19,17,0,17,168
501215,1,7,19,14,0,14,171
501226,1,7,19,17,0,17,160
501229,1,7,19,16,0,16,148
501236,1,7,19,2,0,2,85
501242,1,7,19,4,0,4,148
501246,1,7,19,24,3,27,152
501251,1,7,19,10,0,10,173
501268,1,7,19,7,0,7,125
548322,1,7,19,9,0,9,184
548330,1,7,19,3,0,3,92
548339,1,7,19,8,0,8,154
548356,1,7,19,16,1,17,116
548365,1,7,19,10,0,10,123
548368,1,7,19,4,0,4,174
598007,1,7,19,11,2,13,133
598011,1,7,19,22,0,22,189
598016,1,7,19,9,0,9,167
598029,1,7,19,14,0,14,145
598038,1,7,19,16,0,16,186
598042,1,7,19,8,0,8,147
598044,1,7,19,5,0,5,113
598051,1,7,19,7,1,8,120
598055,1,7,19,9,1,10,145
598068,1,7,19,7,0,7,162
598078,1,7,19,6,0,6,135
729292,1,7,19,8,1,9,111
729308,1,7,19,2,0,2,127
729314,1,7,19,13,0,13,113
733988,1,7,19,24,0,24,176
734000,1,7,19,10,0,10,139
734014,1,7,19,9,0,9,137
734022,1,7,19,10,2,12,161
734036,1,7,19,4,0,4,171
734050,1,7,19,11,0,11,164
829710,1,7,19,15,0,15,148
829726,1,7,19,20,0,20,149
829734,1,7,19,15,0,15,175
829742,1,7,19,9,0,9,193
829756,1,7,19,7,1,8,149
829774,1,7,19,16,0,16,175
829780,1,7,19,9,0,9,163
829810,1,7,19,16,1,17,158
829822,1,7,19,12,3,15,171
829828,1,7,19,8,0,8,191
980906,1,7,19,13,1,14,104
980922,1,7,19,14,3,17,129
980928,1,7,19,5,1,6,136
980946,1,7,19,9,0,9,185
980990,1,7,19,3,0,3,116
980998,1,7,19,16,0,16,194
981012,1,7,19,4,2,6,166
1082592,1,7,19,9,0,9,154
1082614,1,7,19,8,1,9,132
1082635,1,7,19,5,2,7,189
1082638,1,7,19,6,0,6,132
1082644,1,7,19,11,0,11,168
1082650,1,7,19,10,0,10,115
335994,2,7,19,9,0,9,190
335996,2,7,19,2,1,3,116
336002,2,7,19,6,0,6,138
336033,2,7,19,8,0,8,171
392197,2,7,19,4,0,4,147
392205,2,7,19,7,0,7,108
392217,2,7,19,9,0,9,121
392230,2,7,19,9,1,10,142
419127,2,7,19,4,0,4,156
419130,2,7,19,13,0,13,181
419137,2,7,19,13,0,13,158
419147,2,7,19,4,0,4,132
419170,2,7,19,6,0,6,142
501210,2,7,19,5,0,5,143
501223,2,7,19,6,0,6,114
501261,2,7,19,16,0,16,110
501272,2,7,19,7,2,9,155
501274,2,7,19,8,0,8,141
501275,2,7,19,4,1,5,129
548313,2,7,19,5,0,5,90
548319,2,7,19,4,1,5,121
548344,2,7,19,27,0,27,164
548347,2,7,19,8,0,8,167
548351,2,7,19,3,1,4,101
548360,2,7,19,8,1,9,158
548372,2,7,19,9,0,9,158
548375,2,7,19,3,0,3,108
548382,2,7,19,0,1,1,163
548384,2,7,19,13,0,13,142
598004,2,7,19,7,0,7,147
598024,2,7,19,4,0,4,92
598034,2,7,19,8,0,8,150
598060,2,7,19,4,0,4,116
598065,2,7,19,5,0,5,172
598071,2,7,19,3,0,3,133
598075,2,7,19,4,0,4,144
598077,2,7,19,14,1,15,158
729284,2,7,19,4,0,4,117
729322,2,7,19,6,1,7,153
733978,2,7,19,19,1,20,164
734006,2,7,19,9,0,9,160
734030,2,7,19,9,0,9,159
829722,2,7,19,17,0,17,148
829752,2,7,19,2,2,4,148
829788,2,7,19,14,0,14,145
829794,2,7,19,24,1,25,154
829800,2,7,19,6,0,6,182
980914,2,7,19,17,0,17,187
980938,2,7,19,10,1,11,144
980962,2,7,19,8,0,8,161
980986,2,7,19,9,2,11,153
1082597,2,7,19,18,1,19,168
1082600,2,7,19,4,0,4,159
1082602,2,7,19,11,1,12,145
1082606,2,7,19,8,1,9,169
1082618,2,7,19,5,2,7,144
1082625,2,7,19,4,0,4,143
1082628,2,7,19,11,0,11,156
1082641,2,7,19,6,1,7,215
1082647,2,7,19,9,0,9,133
335991,1,8,19,5,0,5,110
335993,1,8,19,12,0,12,128
335995,1,8,19,15,2,17,203
336004,1,8,19,17,0,17,154
336007,1,8,19,5,1,6,164
336016,1,8,19,8,0,8,129
336036,1,8,19,8,1,9,164
336042,1,8,19,12,1,13,140
392193,1,8,19,4,0,4,174
392197,1,8,19,6,0,6,163
392206,1,8,19,1,0,1,140
392210,1,8,19,4,0,4,131
392217,1,8,19,12,1,13,136
392221,1,8,19,6,1,7,159
392225,1,8,19,9,0,9,156
392244,1,8,19,9,0,9,134
419115,1,8,19,8,0,8,168
419122,1,8,19,5,0,5,162
419125,1,8,19,8,0,8,164
419131,1,8,19,16,0,16,144
419156,1,8,19,8,0,8,141
419165,1,8,19,10,0,10,138
419169,1,8,19,0,0,0,82
501204,1,8,19,14,0,14,130
501213,1,8,19,11,0,11,167
501217,1,8,19,11,1,12,156
501221,1,8,19,5,0,5,158
501234,1,8,19,9,1,10,125
501248,1,8,19,5,0,5,165
501255,1,8,19,6,0,6,125
501261,1,8,19,5,3,8,112
501269,1,8,19,9,0,9,190
548319,1,8,19,7,0,7,130
548326,1,8,19,15,1,16,151
548331,1,8,19,18,0,18,178
548334,1,8,19,7,1,8,178
548340,1,8,19,4,0,4,115
548346,1,8,19,6,0,6,168
548351,1,8,19,1,0,1,100
548353,1,8,19,24,1,25,180
548361,1,8,19,11,0,11,167
548371,1,8,19,19,1,20,179
548381,1,8,19,3,4,7,126
336019,2,8,19,9,2,11,172
336025,2,8,19,10,0,10,180
336029,2,8,19,10,0,10,147
336039,2,8,19,4,1,5,137
392201,2,8,19,7,1,8,158
392228,2,8,19,8,0,8,160
392233,2,8,19,6,0,6,140
392234,2,8,19,12,2,14,124
392241,2,8,19,7,0,7,145
419111,2,8,19,3,1,4,145
419140,2,8,19,6,0,6,148
419143,2,8,19,2,0,2,115
419146,2,8,19,13,0,13,154
419150,2,8,19,10,0,10,176
419152,2,8,19,10,1,11,137
419161,2,8,19,17,1,18,174
419168,2,8,19,1,0,1,104
501208,2,8,19,8,1,9,144
501229,2,8,19,5,1,6,129
501241,2,8,19,6,0,6,143
501244,2,8,19,11,0,11,142
501264,2,8,19,7,0,7,133
548357,2,8,19,8,1,9,141
548364,2,8,19,6,4,10,136
548378,2,8,19,10,0,10,128
501205,1,9,19,6,0,6,153
501212,1,9,19,9,0,9,129
501224,1,9,19,9,0,9,128
501230,1,9,19,6,1,7,106
501247,1,9,19,8,1,9,134
501252,1,9,19,7,0,7,119
501259,1,9,19,7,0,7,171
501215,2,9,19,20,0,20,184
501238,2,9,19,1,0,1,119
501266,2,9,19,19,0,19,134
501218,1,10,19,9,1,10,161
501233,1,10,19,3,0,3,126
501240,1,10,19,5,2,7,128
501264,1,10,19,8,1,9,121
501267,1,10,19,6,1,7,111
548313,1,10,19,8,0,8,124
548318,1,10,19,24,3,27,158
548324,1,10,19,1,2,3,115
548332,1,10,19,10,1,11,175
548338,1,10,19,9,0,9,180
548342,1,10,19,9,0,9,132
548363,1,10,19,8,1,9,122
598008,1,10,19,5,0,5,89
598020,1,10,19,16,0,16,147
598030,1,10,19,18,2,20,179
598052,1,10,19,14,0,14,165
598060,1,10,19,5,1,6,107
598066,1,10,19,11,0,11,154
598072,1,10,19,23,1,24,164
501212,2,10,19,16,0,16,151
501231,2,10,19,6,1,7,113
501237,2,10,19,1,1,2,138
501246,2,10,19,10,0,10,128
501255,2,10,19,1,0,1,137
548327,2,10,19,12,0,12,146
548335,2,10,19,4,0,4,144
548346,2,10,19,10,1,11,152
548353,2,10,19,17,0,17,164
548356,2,10,19,4,0,4,109
548358,2,10,19,4,0,4,133
548367,2,10,19,6,0,6,128
548370,2,10,19,4,0,4,116
548380,2,10,19,4,0,4,99
598005,2,10,19,1,0,1,104
598014,2,10,19,10,0,10,148
598016,2,10,19,6,0,6,138
598023,2,10,19,2,0,2,108
598032,2,10,19,2,0,2,128
598040,2,10,19,7,0,7,137
598043,2,10,19,7,0,7,121
598047,2,10,19,4,0,4,164
598058,2,10,19,2,0,2,105
598005,1,11,19,4,0,4,117
598023,1,11,19,12,0,12,105
598035,1,11,19,17,0,17,143
598037,1,11,19,9,0,9,127
598053,1,11,19,10,1,11,155
598061,1,11,19,14,0,14,142
598065,1,11,19,4,1,5,169
598070,1,11,19,6,1,7,129
598076,1,11,19,9,0,9,122
729290,1,11,19,6,3,9,125
729306,1,11,19,14,0,14,174
729316,1,11,19,19,1,20,133
729322,1,11,19,16,2,18,161
733982,1,11,19,8,1,9,149
733994,1,11,19,7,0,7,122
734006,1,11,19,14,1,15,139
734012,1,11,19,24,2,26,193
734020,1,11,19,6,1,7,136
734042,1,11,19,16,1,17,147
829732,1,11,19,11,0,11,115
829748,1,11,19,6,0,6,164
829764,1,11,19,5,0,5,136
829778,1,11,19,15,0,15,185
829792,1,11,19,10,1,11,195
829798,1,11,19,21,0,21,152
829804,1,11,19,11,0,11,170
829820,1,11,19,10,1,11,104
980920,1,11,19,9,1,10,135
980948,1,11,19,11,2,13,105
980958,1,11,19,14,0,14,188
980978,1,11,19,13,0,13,170
980984,1,11,19,15,0,15,129
980988,1,11,19,2,0,2,138
981008,1,11,19,14,0,14,149
981020,1,11,19,3,2,5,148
981024,1,11,19,11,5,16,184
1082591,1,11,19,12,0,12,191
1082600,1,11,19,5,1,6,153
1082609,1,11,19,10,0,10,144
1082611,1,11,19,4,0,4,174
1082615,1,11,19,14,1,15,161
1082623,1,11,19,20,0,20,196
1082627,1,11,19,15,1,16,202
1082630,1,11,19,13,0,13,166
1082648,1,11,19,3,0,3,121
598009,2,11,19,7,0,7,124
598015,2,11,19,6,0,6,109
598018,2,11,19,4,0,4,126
598026,2,11,19,20,1,21,127
598056,2,11,19,7,0,7,134
598074,2,11,19,16,0,16,132
729300,2,11,19,4,0,4,120
734026,2,11,19,15,1,16,157
734034,2,11,19,7,1,8,184
829716,2,11,19,5,0,5,150
829736,2,11,19,13,0,13,158
829756,2,11,19,0,1,1,128
829786,2,11,19,14,0,14,131
980912,2,11,19,9,0,9,173
980972,2,11,19,15,1,16,129
980996,2,11,19,11,0,11,171
981014,2,11,19,7,1,8,144
981022,2,11,19,19,0,19,158
1082604,2,11,19,10,1,11,143
1082634,2,11,19,8,1,9,136
1082638,2,11,19,4,0,4,140
1082643,2,11,19,4,0,4,158
980916,1,12,19,2,0,2,143
980924,1,12,19,9,0,9,149
980944,1,12,19,6,4,10,143
980954,1,12,19,14,0,14,183
980962,1,12,19,5,1,6,148
980974,1,12,19,3,1,4,175
1082594,1,12,19,14,0,14,147
1082603,1,12,19,11,1,12,167
1082607,1,12,19,18,1,19,151
1082618,1,12,19,6,2,8,150
1082620,1,12,19,17,1,18,170
1082624,1,12,19,8,0,8,147
1082634,1,12,19,18,1,19,142
1082647,1,12,19,23,3,26,147
980936,2,12,19,4,0,4,165
980970,2,12,19,14,0,14,160
980984,2,12,19,8,0,8,124
981010,2,12,19,6,0,6,150
1082592,2,12,19,7,0,7,172
1082615,2,12,19,18,1,19,166
1082629,2,12,19,17,0,17,154
1082631,2,12,19,2,1,3,151
1082642,2,12,19,8,0,8,144
1082650,2,12,19,11,1,12,119
980934,1,13,19,4,0,4,129
980950,1,13,19,8,0,8,162
980966,1,13,19,8,0,8,138
980972,1,13,19,8,0,8,114
981018,1,13,19,20,1,21,154
981022,1,13,19,14,1,15,154
1082593,1,13,19,16,0,16,169
1082596,1,13,19,13,0,13,130
1082606,1,13,19,11,1,12,166
1082625,1,13,19,12,3,15,144
1082629,1,13,19,7,0,7,155
1082632,1,13,19,7,0,7,191
1082640,1,13,19,8,0,8,183
1082643,1,13,19,3,1,4,154
980916,2,13,19,0,1,1,164
980922,2,13,19,2,0,2,133
980942,2,13,19,14,0,14,174
980954,2,13,19,11,0,11,187
980960,2,13,19,7,0,7,125
980992,2,13,19,4,0,4,104
1082610,2,13,19,20,1,21,188
1082613,2,13,19,5,0,5,188
1082616,2,13,19,3,2,5,153
1082637,2,13,19,16,0,16,182
335987,1,1,20,22,0,22,222
335998,1,1,20,12,1,13,147
336002,1,1,20,9,2,11,137
336019,1,1,20,13,0,13,198
336022,1,1,20,4,0,4,133
336030,1,1,20,10,1,11,149
336032,1,1,20,11,0,11,147
392189,1,1,20,3,0,3,101
392204,1,1,20,5,1,6,139
392212,1,1,20,21,0,21,153
392216,1,1,20,7,0,7,154
392224,1,1,20,9,0,9,123
392226,1,1,20,17,3,20,173
392233,1,1,20,14,0,14,160
419111,1,1,20,10,1,11,161
419127,1,1,20,7,0,7,155
419132,1,1,20,21,0,21,183
419140,1,1,20,12,0,12,181
419144,1,1,20,10,2,12,200
419149,1,1,20,14,0,14,181
419153,1,1,20,4,1,5,160
419158,1,1,20,9,2,11,139
501208,1,1,20,8,0,8,163
501227,1,1,20,6,1,7,171
501235,1,1,20,8,0,8,148
501244,1,1,20,10,1,11,169
501272,1,1,20,9,0,9,175
501274,1,1,20,13,0,13,147
548320,1,1,20,12,0,12,165
548349,1,1,20,8,1,9,190
548358,1,1,20,9,0,9,150
548373,1,1,20,9,0,9,158
548375,1,1,20,5,2,7,140
548380,1,1,20,8,1,9,136
548383,1,1,20,21,0,21,162
598013,1,1,20,6,0,6,154
598018,1,1,20,8,0,8,180
598027,1,1,20,4,0,4,119
598034,1,1,20,2,1,3,159
598045,1,1,20,16,0,16,136
598058,1,1,20,15,0,15,152
598074,1,1,20,8,1,9,130
729284,1,1,20,14,0,14,163
729294,1,1,20,10,2,12,166
729304,1,1,20,5,3,8,150
734032,1,1,20,11,1,12,195
734048,1,1,20,15,0,15,163
829718,1,1,20,13,1,14,177
829766,1,1,20,18,0,18,171
829786,1,1,20,13,0,13,167
980914,1,1,20,7,0,7,187
980952,1,1,20,8,0,8,174
980968,1,1,20,4,0,4,164
980980,1,1,20,11,2,13,158
981000,1,1,20,10,2,12,183
981006,1,1,20,4,0,4,124
981014,1,1,20,7,0,7,171
1082597,1,1,20,21,2,23,178
1082604,1,1,20,9,0,9,172
1082613,1,1,20,7,0,7,187
1082617,1,1,20,0,0,0,131
1082631,1,1,20,4,0,4,155
336005,2,1,20,0,0,0,151
336008,2,1,20,8,1,9,169
336040,2,1,20,15,0,15,175
392195,2,1,20,3,3,6,150
392208,2,1,20,9,0,9,139
392236,2,1,20,6,0,6,189
392238,2,1,20,3,1,4,102
419114,2,1,20,1,0,1,136
419118,2,1,20,0,0,0,109
419123,2,1,20,2,0,2,134
419136,2,1,20,3,0,3,137
501203,2,1,20,5,1,6,151
501224,2,1,20,7,0,7,126
501247,2,1,20,7,0,7,139
548317,2,1,20,8,0,8,142
548325,2,1,20,6,0,6,137
548328,2,1,20,5,1,6,132
548340,2,1,20,0,1,1,127
548352,2,1,20,6,0,6,140
548368,2,1,20,10,0,10,155
548386,2,1,20,10,0,10,192
598021,2,1,20,2,4,6,153
598039,2,1,20,4,0,4,186
598062,2,1,20,5,0,5,116
598066,2,1,20,10,0,10,163
729320,2,1,20,10,1,11,152
733984,2,1,20,4,2,6,160
734020,2,1,20,13,0,13,146
734054,2,1,20,5,0,5,200
829728,2,1,20,5,4,9,169
829770,2,1,20,14,0,14,132
829796,2,1,20,7,1,8,184
829810,2,1,20,5,1,6,166
829816,2,1,20,6,0,6,190
980944,2,1,20,8,0,8,162
980964,2,1,20,4,0,4,189
981020,2,1,20,1,1,2,140
1082608,2,1,20,9,0,9,169
1082627,2,1,20,7,0,7,161
1082639,2,1,20,5,0,5,153
1082644,2,1,20,4,0,4,164
335997,1,2,20,4,1,5,135
336011,1,2,20,0,0,0,126
336021,1,2,20,7,5,12,143
336031,1,2,20,24,0,24,154
336034,1,2,20,4,0,4,126
336039,1,2,20,13,0,13,156
392187,1,2,20,15,1,16,133
392196,1,2,20,6,0,6,168
392199,1,2,20,9,1,10,149
392209,1,2,20,8,2,10,145
392218,1,2,20,3,0,3,105
392241,1,2,20,23,0,23,170
419114,1,2,20,13,1,14,135
419128,1,2,20,17,0,17,171
419138,1,2,20,11,0,11,161
419150,1,2,20,17,0,17,184
501210,1,2,20,15,1,16,140
501237,1,2,20,6,0,6,181
501249,1,2,20,7,1,8,205
501273,1,2,20,6,2,8,175
501275,1,2,20,7,0,7,185
548315,1,2,20,10,0,10,157
548323,1,2,20,7,0,7,205
548341,1,2,20,13,2,15,189
548355,1,2,20,3,1,4,158
548367,1,2,20,15,0,15,173
548372,1,2,20,24,0,24,171
548377,1,2,20,12,0,12,215
598004,1,2,20,15,1,16,156
598009,1,2,20,5,0,5,130
598017,1,2,20,5,0,5,165
598032,1,2,20,10,0,10,263
598041,1,2,20,22,0,22,171
598047,1,2,20,26,0,26,187
598050,1,2,20,10,0,10,174
598059,1,2,20,23,0,23,183
598062,1,2,20,5,1,6,115
598069,1,2,20,21,0,21,190
729318,1,2,20,3,1,4,124
734004,1,2,20,17,1,18,190
734010,1,2,20,25,2,27,186
734026,1,2,20,8,0,8,160
734040,1,2,20,9,2,11,154
829724,1,2,20,7,0,7,166
829768,1,2,20,11,1,12,200
829790,1,2,20,8,1,9,226
829800,1,2,20,17,0,17,235
829824,1,2,20,10,1,11,180
829826,1,2,20,7,1,8,139
980912,1,2,20,13,0,13,227
980926,1,2,20,8,0,8,191
980932,1,2,20,9,0,9,170
980936,1,2,20,11,1,12,185
980942,1,2,20,16,1,17,180
980964,1,2,20,18,0,18,185
980982,1,2,20,11,1,12,175
980986,1,2,20,10,3,13,151
980992,1,2,20,15,0,15,244
1082595,1,2,20,7,0,7,157
1082598,1,2,20,14,0,14,148
1082602,1,2,20,10,0,10,142
1082610,1,2,20,17,0,17,213
1082621,1,2,20,4,0,4,134
1082628,1,2,20,5,0,5,162
1082636,1,2,20,21,0,21,158
1082646,1,2,20,14,2,16,161
335990,2,2,20,2,1,3,166
336001,2,2,20,2,1,3,165
336003,2,2,20,19,0,19,181
336028,2,2,20,14,0,14,132
392193,2,2,20,4,0,4,160
392204,2,2,20,13,0,13,143
392223,2,2,20,15,1,16,141
392226,2,2,20,6,1,7,176
392229,2,2,20,7,0,7,132
392244,2,2,20,4,4,8,137
419124,2,2,20,4,0,4,155
419133,2,2,20,13,0,13,166
419141,2,2,20,4,1,5,184
419145,2,2,20,4,0,4,147
419156,2,2,20,2,1,3,138
419162,2,2,20,6,1,7,134
419167,2,2,20,2,1,3,149
501213,2,2,20,3,2,5,142
501216,2,2,20,9,0,9,162
501232,2,2,20,3,0,3,161
501276,2,2,20,14,0,14,147
548320,2,2,20,5,0,5,123
548329,2,2,20,9,0,9,136
548332,2,2,20,24,0,24,186
548336,2,2,20,6,0,6,166
548349,2,2,20,5,0,5,143
548381,2,2,20,3,1,4,117
598022,2,2,20,10,1,11,152
598038,2,2,20,11,1,12,136
729304,2,2,20,6,0,6,148
733982,2,2,20,6,0,6,158
733988,2,2,20,6,1,7,168
733996,2,2,20,16,1,17,166
734018,2,2,20,13,0,13,142
734032,2,2,20,10,0,10,165
829742,2,2,20,9,0,9,191
829750,2,2,20,7,0,7,154
829784,2,2,20,0,0,0,124
980958,2,2,20,6,0,6,179
980974,2,2,20,7,0,7,195
981024,2,2,20,8,1,9,200
1082591,2,2,20,7,0,7,172
1082607,2,2,20,2,1,3,134
1082624,2,2,20,8,0,8,96
335988,1,3,20,25,0,25,240
335994,1,3,20,13,1,14,208
336001,1,3,20,14,0,14,178
336006,1,3,20,11,0,11,169
336012,1,3,20,20,0,20,144
336018,1,3,20,5,0,5,181
336023,1,3,20,10,5,15,156
336045,1,3,20,15,0,15,163
392190,1,3,20,13,1,14,179
392201,1,3,20,5,1,6,165
392207,1,3,20,11,0,11,164
392211,1,3,20,10,0,10,163
392214,1,3,20,12,1,13,178
392229,1,3,20,6,0,6,129
392236,1,3,20,17,2,19,188
392239,1,3,20,3,3,6,116
392243,1,3,20,6,0,6,146
419118,1,3,20,15,1,16,164
419130,1,3,20,6,1,7,180
419142,1,3,20,10,1,11,246
419147,1,3,20,12,1,13,165
419152,1,3,20,4,2,6,138
419160,1,3,20,12,0,12,112
419168,1,3,20,13,1,14,142
419170,1,3,20,6,5,11,168
501203,1,3,20,16,0,16,153
501211,1,3,20,7,0,7,188
501216,1,3,20,7,0,7,183
501231,1,3,20,8,1,9,142
501241,1,3,20,8,0,8,165
501250,1,3,20,7,0,7,114
501254,1,3,20,6,2,8,196
501258,1,3,20,17,0,17,176
501266,1,3,20,10,1,11,152
501271,1,3,20,17,0,17,128
501276,1,3,20,7,0,7,205
548311,1,3,20,3,0,3,112
548316,1,3,20,22,1,23,193
548321,1,3,20,6,1,7,110
548327,1,3,20,8,0,8,155
548335,1,3,20,18,0,18,164
548352,1,3,20,9,1,10,139
548357,1,3,20,13,0,13,160
548360,1,3,20,4,0,4,173
548376,1,3,20,6,1,7,120
548384,1,3,20,18,1,19,187
548385,1,3,20,7,0,7,222
548386,1,3,20,7,1,8,190
598025,1,3,20,7,2,9,169
598039,1,3,20,12,0,12,200
598043,1,3,20,14,0,14,164
598046,1,3,20,12,0,12,186
598056,1,3,20,18,2,20,223
598063,1,3,20,11,0,11,141
598067,1,3,20,8,0,8,168
598075,1,3,20,19,0,19,192
729288,1,3,20,18,0,18,205
729298,1,3,20,14,1,15,177
729302,1,3,20,8,1,9,140
734018,1,3,20,6,1,7,138
734028,1,3,20,11,1,12,154
734034,1,3,20,24,0,24,185
829712,1,3,20,16,0,16,150
829716,1,3,20,15,0,15,209
829728,1,3,20,3,2,5,165
829740,1,3,20,7,0,7,156
829750,1,3,20,3,1,4,181
829758,1,3,20,4,0,4,192
829770,1,3,20,10,0,10,134
829784,1,3,20,3,1,4,148
829794,1,3,20,11,0,11,158
829802,1,3,20,8,0,8,157
829806,1,3,20,5,0,5,119
336014,2,3,20,14,1,15,188
336034,2,3,20,1,0,1,112
336038,2,3,20,3,1,4,201
336042,2,3,20,7,0,7,148
392186,2,3,20,4,1,5,146
392194,2,3,20,5,0,5,180
392207,2,3,20,5,0,5,126
392232,2,3,20,4,2,6,151
419115,2,3,20,12,1,13,159
419121,2,3,20,6,0,6,190
419126,2,3,20,7,2,9,136
419128,2,3,20,11,0,11,135
419134,2,3,20,3,1,4,160
419164,2,3,20,18,0,18,195
501226,2,3,20,16,0,16,156
501233,2,3,20,5,0,5,145
501273,2,3,20,13,0,13,177
548323,2,3,20,16,1,17,208
548337,2,3,20,8,0,8,147
548348,2,3,20,8,1,9,149
548373,2,3,20,10,0,10,160
598007,2,3,20,2,0,2,139
598017,2,3,20,15,1,16,166
598020,2,3,20,11,0,11,135
598027,2,3,20,6,0,6,124
598031,2,3,20,11,0,11,186
598035,2,3,20,14,1,15,160
598078,2,3,20,16,2,18,125
729316,2,3,20,6,0,6,146
733986,2,3,20,13,0,13,181
733992,2,3,20,18,1,19,187
734000,2,3,20,12,1,13,160
734008,2,3,20,12,0,12,149
734052,2,3,20,15,0,15,202
829778,2,3,20,4,2,6,170
829826,2,3,20,5,0,5,140
829828,2,3,20,21,0,21,161
335992,1,4,20,16,1,17,166
335996,1,4,20,12,1,13,182
336008,1,4,20,20,1,21,178
336024,1,4,20,12,1,13,221
336033,1,4,20,16,2,18,189
336040,1,4,20,3,1,4,174
336044,1,4,20,12,2,14,112
392191,1,4,20,14,2,16,158
392200,1,4,20,7,2,9,139
392205,1,4,20,12,0,12,119
392227,1,4,20,3,2,5,119
392234,1,4,20,5,2,7,134
419113,1,4,20,9,1,10,142
419117,1,4,20,18,1,19,203
419126,1,4,20,10,2,12,136
419137,1,4,20,12,1,13,163
419141,1,4,20,16,2,18,181
419148,1,4,20,6,0,6,153
419161,1,4,20,14,0,14,174
419164,1,4,20,16,0,16,192
501207,1,4,20,10,0,10,112
501225,1,4,20,4,1,5,195
501239,1,4,20,9,0,9,119
501253,1,4,20,3,0,3,119
501256,1,4,20,8,0,8,163
501262,1,4,20,12,0,12,166
501265,1,4,20,11,1,12,232
548328,1,4,20,11,0,11,134
548333,1,4,20,10,0,10,124
548336,1,4,20,14,0,14,163
548344,1,4,20,16,0,16,168
548348,1,4,20,7,0,7,156
548364,1,4,20,12,1,13,170
548374,1,4,20,5,0,5,136
548379,1,4,20,15,0,15,141
598012,1,4,20,1,0,1,138
598021,1,4,20,6,1,7,157
598026,1,4,20,6,0,6,123
598033,1,4,20,6,0,6,171
598036,1,4,20,17,1,18,149
598057,1,4,20,7,1,8,145
598071,1,4,20,8,1,9,183
729300,1,4,20,8,0,8,193
729312,1,4,20,4,1,5,132
733978,1,4,20,3,0,3,168
733992,1,4,20,23,0,23,231
733996,1,4,20,9,1,10,198
734002,1,4,20,11,0,11,149
734030,1,4,20,9,0,9,156
734038,1,4,20,3,7,10,179
734052,1,4,20,8,0,8,226
734054,1,4,20,12,0,12,199
829722,1,4,20,11,2,13,177
829730,1,4,20,3,0,3,165
829738,1,4,20,8,1,9,155
829772,1,4,20,10,0,10,118
829796,1,4,20,21,0,21,183
829814,1,4,20,8,0,8,130
980910,1,4,20,6,0,6,161
980918,1,4,20,12,0,12,111
980930,1,4,20,18,0,18,138
980940,1,4,20,6,0,6,143
980960,1,4,20,3,0,3,154
980976,1,4,20,12,1,13,181
980996,1,4,20,11,0,11,179
981010,1,4,20,12,0,12,172
1082601,1,4,20,3,1,4,170
1082612,1,4,20,17,1,18,198
1082616,1,4,20,12,0,12,188
1082633,1,4,20,18,1,19,138
1082637,1,4,20,14,0,14,189
1082639,1,4,20,7,2,9,167
1082641,1,4,20,15,1,16,230
335988,2,4,20,9,0,9,207
336000,2,4,20,4,0,4,162
336018,2,4,20,8,0,8,163
336036,2,4,20,6,1,7,178
392209,2,4,20,4,0,4,137
392212,2,4,20,7,0,7,154
392215,2,4,20,5,0,5,133
392221,2,4,20,8,0,8,169
392231,2,4,20,4,0,4,119
392239,2,4,20,7,0,7,92
419122,2,4,20,12,0,12,164
419129,2,4,20,0,0,0,152
419132,2,4,20,6,1,7,144
419151,2,4,20,6,0,6,158
501211,2,4,20,6,0,6,193
501228,2,4,20,6,1,7,202
501242,2,4,20,4,0,4,136
501249,2,4,20,14,1,15,120
548314,2,4,20,8,0,8,160
548318,2,4,20,13,0,13,144
548339,2,4,20,9,0,9,164
548355,2,4,20,9,0,9,163
548359,2,4,20,7,2,9,134
548371,2,4,20,19,0,19,194
598030,2,4,20,16,0,16,186
598042,2,4,20,10,2,12,170
598046,2,4,20,3,0,3,171
598061,2,4,20,9,0,9,120
734024,2,4,20,9,0,9,165
734048,2,4,20,1,0,1,135
829714,2,4,20,5,0,5,136
829746,2,4,20,13,0,13,191
829758,2,4,20,1,0,1,95
829764,2,4,20,4,0,4,130
829780,2,4,20,9,0,9,149
829804,2,4,20,22,0,22,180
980946,2,4,20,13,0,13,164
980968,2,4,20,4,0,4,157
980982,2,4,20,15,0,15,174
1082605,2,4,20,3,0,3,137
1082609,2,4,20,3,2,5,154
1082623,2,4,20,6,0,6,181
335989,1,5,20,8,0,8,125
336005,1,5,20,6,1,7,196
336028,1,5,20,9,2,11,197
336038,1,5,20,8,0,8,211
336043,1,5,20,4,0,4,192
392195,1,5,20,18,0,18,150
392215,1,5,20,9,0,9,211
392222,1,5,20,13,1,14,140
392230,1,5,20,3,0,3,145
392238,1,5,20,2,0,2,101
419116,1,5,20,12,1,13,141
419120,1,5,20,0,1,1,92
419123,1,5,20,15,2,17,168
419129,1,5,20,13,0,13,183
419134,1,5,20,7,0,7,177
419146,1,5,20,7,0,7,159
419159,1,5,20,15,0,15,130
419163,1,5,20,7,0,7,132
501214,1,5,20,6,6,12,159
501245,1,5,20,7,0,7,147
501257,1,5,20,3,2,5,146
548314,1,5,20,13,0,13,191
548317,1,5,20,8,0,8,164
548325,1,5,20,13,2,15,131
548329,1,5,20,11,0,11,195
548337,1,5,20,4,0,4,146
548354,1,5,20,7,0,7,141
548359,1,5,20,11,0,11,177
548366,1,5,20,10,0,10,126
548370,1,5,20,9,0,9,170
548378,1,5,20,6,0,6,126
548382,1,5,20,11,0,11,162
598006,1,5,20,4,0,4,165
598010,1,5,20,10,2,12,144
598014,1,5,20,14,1,15,145
598024,1,5,20,19,0,19,179
598028,1,5,20,3,0,3,117
598031,1,5,20,10,0,10,185
598048,1,5,20,8,1,9,132
598077,1,5,20,10,8,18,165
729296,1,5,20,8,0,8,191
729320,1,5,20,9,0,9,152
733984,1,5,20,11,0,11,170
734008,1,5,20,7,1,8,148
734016,1,5,20,13,2,15,201
734046,1,5,20,15,1,16,189
829714,1,5,20,4,0,4,162
829746,1,5,20,16,0,16,191
829754,1,5,20,3,0,3,130
829782,1,5,20,15,0,15,189
829816,1,5,20,8,0,8,199
335995,2,5,20,19,0,19,217
336020,2,5,20,4,0,4,159
336024,2,5,20,2,0,2,180
336041,2,5,20,14,1,15,146
336045,2,5,20,6,2,8,164
392200,2,5,20,5,1,6,112
392210,2,5,20,1,1,2,142
392225,2,5,20,3,0,3,113
392235,2,5,20,13,0,13,136
419112,2,5,20,6,1,7,208
419142,2,5,20,11,0,11,223
419155,2,5,20,7,1,8,137
501225,2,5,20,7,0,7,147
501240,2,5,20,5,1,6,144
501254,2,5,20,0,0,0,133
548322,2,5,20,4,0,4,170
548331,2,5,20,11,0,11,197
548341,2,5,20,8,0,8,143
548350,2,5,20,10,0,10,151
598019,2,5,20,6,0,6,126
598041,2,5,20,7,0,7,173
598052,2,5,20,8,0,8,182
598068,2,5,20,7,1,8,152
598070,2,5,20,11,0,11,113
598076,2,5,20,12,0,12,135
729290,2,5,20,9,0,9,135
729302,2,5,20,16,0,16,133
733994,2,5,20,2,0,2,102
734022,2,5,20,8,0,8,153
734038,2,5,20,14,0,14,163
829720,2,5,20,13,0,13,186
829726,2,5,20,1,0,1,165
829732,2,5,20,7,1,8,131
829774,2,5,20,10,1,11,179
829792,2,5,20,10,0,10,194
829802,2,5,20,13,1,14,145
336000,1,6,20,6,0,6,158
336003,1,6,20,7,0,7,191
336014,1,6,20,11,0,11,187
336020,1,6,20,6,1,7,156
336025,1,6,20,14,0,14,194
392194,1,6,20,6,0,6,189
392203,1,6,20,8,0,8,143
392228,1,6,20,18,5,23,173
392231,1,6,20,6,0,6,120
392235,1,6,20,10,0,10,150
392237,1,6,20,12,0,12,134
392242,1,6,20,6,2,8,153
419121,1,6,20,11,1,12,185
419133,1,6,20,12,0,12,183
419136,1,6,20,12,0,12,177
419139,1,6,20,11,0,11,188
419145,1,6,20,7,4,11,184
419154,1,6,20,3,1,4,111
501209,1,6,20,10,2,12,151
501228,1,6,20,17,5,22,231
501232,1,6,20,7,2,9,160
501238,1,6,20,6,4,10,157
501243,1,6,20,5,0,5,140
548347,1,6,20,10,0,10,207
548350,1,6,20,20,0,20,152
548362,1,6,20,7,5,12,153
548369,1,6,20,7,0,7,114
598003,1,6,20,3,0,3,128
598015,1,6,20,13,0,13,114
598022,1,6,20,15,0,15,152
598040,1,6,20,13,0,13,164
598049,1,6,20,0,0,0,80
598054,1,6,20,14,0,14,154
598064,1,6,20,4,1,5,120
729286,1,6,20,17,0,17,145
733980,1,6,20,18,0,18,152
733986,1,6,20,18,0,18,178
733990,1,6,20,12,0,12,160
733998,1,6,20,4,0,4,143
734024,1,6,20,5,0,5,164
829720,1,6,20,16,1,17,184
829736,1,6,20,9,0,9,167
829744,1,6,20,3,0,3,146
829752,1,6,20,10,0,10,190
829788,1,6,20,9,0,9,152
829818,1,6,20,11,0,11,187
980938,1,6,20,15,1,16,164
980956,1,6,20,9,1,10,186
980970,1,6,20,13,0,13,162
981002,1,6,20,22,0,22,121
981016,1,6,20,4,0,4,138
1082599,1,6,20,23,0,23,205
1082605,1,6,20,19,0,19,188
1082608,1,6,20,10,1,11,168
1082622,1,6,20,6,0,6,160
1082642,1,6,20,5,0,5,168
336037,2,6,20,10,0,10,179
392199,2,6,20,3,0,3,150
392211,2,6,20,10,0,10,145
419113,2,6,20,7,0,7,146
419125,2,6,20,3,0,3,161
419149,2,6,20,11,0,11,167
419157,2,6,20,12,0,12,144
419165,2,6,20,3,2,5,134
501218,2,6,20,10,0,10,190
501221,2,6,20,9,0,9,152
501235,2,6,20,6,0,6,131
501251,2,6,20,7,2,9,146
501258,2,6,20,10,0,10,158
501262,2,6,20,13,0,13,141
548315,2,6,20,6,0,6,137
548326,2,6,20,6,0,6,162
548338,2,6,20,5,0,5,172
548377,2,6,20,7,1,8,194
548383,2,6,20,7,0,7,144
598006,2,6,20,3,0,3,160
598011,2,6,20,11,0,11,165
598033,2,6,20,14,0,14,164
598059,2,6,20,14,0,14,179
598067,2,6,20,5,0,5,135
598072,2,6,20,6,0,6,134
729294,2,6,20,6,0,6,167
729306,2,6,20,14,1,15,180
734010,2,6,20,9,0,9,170
734016,2,6,20,12,1,13,139
734036,2,6,20,8,1,9,158
829712,2,6,20,17,0,17,149
829730,2,6,20,6,0,6,169
829766,2,6,20,14,1,15,158
829782,2,6,20,12,3,15,175
829798,2,6,20,9,0,9,157
980926,2,6,20,1,0,1,192
980950,2,6,20,12,0,12,171
980976,2,6,20,15,0,15,172
980998,2,6,20,0,0,0,126
981008,2,6,20,11,2,13,161
1082595,2,6,20,3,0,3,142
1082611,2,6,20,8,0,8,176
1082614,2,6,20,8,2,10,128
1082630,2,6,20,4,0,4,189
1082640,2,6,20,8,2,10,197
1082646,2,6,20,2,0,2,151
335990,1,7,20,7,0,7,165
335999,1,7,20,5,2,7,154
336009,1,7,20,6,0,6,162
336029,1,7,20,7,0,7,178
336037,1,7,20,14,0,14,176
336041,1,7,20,24,1,25,145
392186,1,7,20,8,0,8,165
392202,1,7,20,10,0,10,187
392208,1,7,20,16,0,16,148
392213,1,7,20,15,1,16,149
392220,1,7,20,1,1,2,116
392223,1,7,20,13,1,14,157
392232,1,7,20,11,0,11,147
392240,1,7,20,7,3,10,165
419112,1,7,20,11,1,12,212
419119,1,7,20,12,0,12,218
419124,1,7,20,16,0,16,151
419135,1,7,20,18,2,20,172
419143,1,7,20,14,0,14,178
419151,1,7,20,2,2,4,154
419155,1,7,20,20,0,20,174
419157,1,7,20,25,0,25,182
419162,1,7,20,12,0,12,191
419166,1,7,20,5,2,7,133
419167,1,7,20,15,1,16,184
501215,1,7,20,11,0,11,182
501226,1,7,20,1,3,4,164
501229,1,7,20,23,1,24,172
501236,1,7,20,9,0,9,94
501242,1,7,20,11,0,11,159
501246,1,7,20,3,5,8,160
501251,1,7,20,5,0,5,178
501268,1,7,20,8,0,8,133
548322,1,7,20,13,0,13,197
548330,1,7,20,0,0,0,92
548339,1,7,20,4,4,8,162
548356,1,7,20,4,0,4,120
548365,1,7,20,18,0,18,141
548368,1,7,20,8,0,8,182
598007,1,7,20,15,0,15,148
598011,1,7,20,20,0,20,209
598016,1,7,20,16,0,16,183
598029,1,7,20,12,0,12,157
598038,1,7,20,8,0,8,194
598042,1,7,20,26,1,27,174
598044,1,7,20,15,1,16,129
598051,1,7,20,19,0,19,139
598055,1,7,20,19,6,25,170
598068,1,7,20,4,0,4,166
598078,1,7,20,13,0,13,148
729292,1,7,20,3,1,4,115
729308,1,7,20,13,1,14,141
729314,1,7,20,11,1,12,125
733988,1,7,20,10,1,11,187
734000,1,7,20,17,1,18,157
734014,1,7,20,4,0,4,141
734022,1,7,20,17,0,17,178
734036,1,7,20,1,1,2,173
734050,1,7,20,9,0,9,173
829710,1,7,20,20,0,20,168
829726,1,7,20,13,2,15,164
829734,1,7,20,6,2,8,183
829742,1,7,20,15,1,16,209
829756,1,7,20,7,1,8,157
829774,1,7,20,12,0,12,187
829780,1,7,20,8,1,9,172
829810,1,7,20,12,1,13,171
829822,1,7,20,13,3,16,187
829828,1,7,20,7,4,11,202
980906,1,7,20,17,0,17,121
980922,1,7,20,14,0,14,143
980928,1,7,20,6,0,6,142
980946,1,7,20,4,0,4,189
980990,1,7,20,8,0,8,124
980998,1,7,20,10,2,12,206
981012,1,7,20,6,0,6,172
1082592,1,7,20,28,2,30,184
1082614,1,7,20,10,0,10,142
1082635,1,7,20,21,2,23,212
1082638,1,7,20,3,3,6,138
1082644,1,7,20,3,2,5,173
1082650,1,7,20,12,2,14,129
335994,2,7,20,11,1,12,202
335996,2,7,20,0,0,0,116
336033,2,7,20,15,2,17,188
392197,2,7,20,9,0,9,156
392205,2,7,20,7,1,8,116
392217,2,7,20,5,0,5,126
392230,2,7,20,1,0,1,143
419137,2,7,20,5,1,6,164
419147,2,7,20,8,1,9,141
419170,2,7,20,4,0,4,146
501223,2,7,20,10,0,10,124
501261,2,7,20,13,2,15,125
501272,2,7,20,23,0,23,178
501274,2,7,20,7,0,7,148
501275,2,7,20,13,0,13,142
548313,2,7,20,5,0,5,95
548319,2,7,20,20,1,21,142
548344,2,7,20,6,1,7,171
548347,2,7,20,3,0,3,170
548360,2,7,20,16,0,16,174
548372,2,7,20,14,1,15,173
548375,2,7,20,0,0,0,108
548384,2,7,20,7,0,7,149
598004,2,7,20,6,1,7,154
598034,2,7,20,12,0,12,162
598065,2,7,20,12,0,12,184
598071,2,7,20,0,0,0,133
598077,2,7,20,10,1,11,169
729284,2,7,20,5,0,5,122
729322,2,7,20,1,3,4,157
733978,2,7,20,6,0,6,170
829722,2,7,20,11,0,11,159
829752,2,7,20,5,0,5,153
829788,2,7,20,8,0,8,153
829794,2,7,20,5,0,5,159
829800,2,7,20,14,0,14,196
980914,2,7,20,1,0,1,188
980938,2,7,20,10,0,10,154
1082597,2,7,20,10,2,12,180
1082606,2,7,20,8,0,8,177
1082618,2,7,20,13,0,13,157
1082625,2,7,20,10,0,10,153
1082628,2,7,20,8,1,9,165
1082641,2,7,20,8,0,8,223
1082647,2,7,20,9,0,9,142
335993,1,8,20,12,2,14,142
335995,1,8,20,10,1,11,214
336004,1,8,20,9,1,10,164
336007,1,8,20,1,0,1,165
336016,1,8,20,8,3,11,140
336036,1,8,20,11,0,11,175
336042,1,8,20,6,1,7,147
392193,1,8,20,10,0,10,184
392197,1,8,20,0,5,5,168
392206,1,8,20,7,1,8,148
392210,1,8,20,10,0,10,141
392217,1,8,20,9,0,9,145
392221,1,8,20,8,1,9,168
392225,1,8,20,10,0,10,166
392244,1,8,20,9,0,9,143
419115,1,8,20,20,2,22,190
419122,1,8,20,8,0,8,170
419125,1,8,20,7,0,7,171
419131,1,8,20,2,2,4,148
419156,1,8,20,10,0,10,151
419165,1,8,20,7,0,7,145
501204,1,8,20,7,0,7,137
501213,1,8,20,8,0,8,175
501217,1,8,20,9,0,9,165
501221,1,8,20,10,0,10,168
501234,1,8,20,3,1,4,129
501248,1,8,20,10,0,10,175
501255,1,8,20,11,0,11,136
501261,1,8,20,23,0,23,135
501269,1,8,20,8,0,8,198
548319,1,8,20,7,1,8,138
548326,1,8,20,6,0,6,157
548331,1,8,20,18,0,18,196
548334,1,8,20,9,0,9,187
548340,1,8,20,11,0,11,126
548346,1,8,20,9,0,9,177
548353,1,8,20,6,0,6,186
548361,1,8,20,11,3,14,181
548371,1,8,20,11,0,11,190
548381,1,8,20,5,1,6,132
336019,2,8,20,8,1,9,181
336025,2,8,20,2,0,2,182
336029,2,8,20,4,2,6,153
336039,2,8,20,16,0,16,153
392201,2,8,20,11,0,11,169
392228,2,8,20,1,0,1,161
392233,2,8,20,23,3,26,166
392234,2,8,20,8,1,9,133
392241,2,8,20,13,0,13,158
419111,2,8,20,4,1,5,150
419140,2,8,20,9,0,9,157
419146,2,8,20,2,1,3,157
419150,2,8,20,10,0,10,186
419152,2,8,20,1,1,2,139
419161,2,8,20,4,0,4,178
419168,2,8,20,0,0,0,104
501208,2,8,20,9,1,10,154
501229,2,8,20,6,0,6,135
501241,2,8,20,3,0,3,146
501244,2,8,20,6,1,7,149
501264,2,8,20,5,0,5,138
548357,2,8,20,9,0,9,150
548364,2,8,20,9,0,9,145
501205,1,9,20,7,1,8,161
501212,1,9,20,13,6,19,148
501224,1,9,20,2,2,4,132
501230,1,9,20,2,1,3,109
501247,1,9,20,22,0,22,156
501252,1,9,20,6,0,6,125
501259,1,9,20,7,0,7,178
501266,2,9,20,6,1,7,141
501218,1,10,20,25,1,26,187
501233,1,10,20,15,0,15,141
501240,1,10,20,14,1,15,143
501264,1,10,20,15,0,15,136
501267,1,10,20,6,1,7,118
548313,1,10,20,5,0,5,129
548318,1,10,20,8,0,8,166
548332,1,10,20,7,0,7,182
548338,1,10,20,12,0,12,192
548342,1,10,20,10,4,14,146
548363,1,10,20,3,0,3,125
598008,1,10,20,10,0,10,99
598020,1,10,20,11,1,12,159
598030,1,10,20,5,1,6,185
598052,1,10,20,12,1,13,178
598060,1,10,20,5,0,5,112
598066,1,10,20,16,0,16,170
598072,1,10,20,8,0,8,172
501231,2,10,20,3,1,4,117
501237,2,10,20,16,1,17,155
501246,2,10,20,11,0,11,139
548327,2,10,20,10,0,10,156
548335,2,10,20,5,2,7,151
548346,2,10,20,7,0,7,159
548353,2,10,20,9,0,9,173
548356,2,10,20,9,1,10,119
548358,2,10,20,10,0,10,143
548367,2,10,20,10,0,10,138
548370,2,10,20,9,0,9,125
548380,2,10,20,3,0,3,102
598016,2,10,20,4,0,4,142
598032,2,10,20,5,0,5,133
598040,2,10,20,12,0,12,149
598043,2,10,20,6,0,6,127
598047,2,10,20,5,1,6,170
598058,2,10,20,1,0,1,106
598005,1,11,20,9,0,9,126
598023,1,11,20,13,1,14,119
598035,1,11,20,16,0,16,159
598037,1,11,20,16,1,17,144
598053,1,11,20,6,0,6,161
598061,1,11,20,6,2,8,150
598065,1,11,20,8,1,9,178
598070,1,11,20,6,1,7,136
598076,1,11,20,10,0,10,132
729290,1,11,20,7,1,8,133
729306,1,11,20,10,0,10,184
729316,1,11,20,11,1,12,145
729322,1,11,20,11,0,11,172
733982,1,11,20,5,1,6,155
733994,1,11,20,6,6,12,134
734006,1,11,20,17,1,18,157
734012,1,11,20,10,2,12,205
734020,1,11,20,4,2,6,142
734042,1,11,20,12,1,13,160
829732,1,11,20,11,1,12,127
829748,1,11,20,11,1,12,176
829764,1,11,20,14,0,14,150
829778,1,11,20,7,0,7,192
829792,1,11,20,5,1,6,201
829798,1,11,20,11,0,11,163
829804,1,11,20,15,0,15,185
829820,1,11,20,9,0,9,113
980920,1,11,20,6,1,7,142
980948,1,11,20,13,0,13,118
980958,1,11,20,5,1,6,194
980978,1,11,20,7,0,7,177
980984,1,11,20,8,0,8,137
980988,1,11,20,7,1,8,146
981008,1,11,20,9,0,9,158
981020,1,11,20,13,1,14,162
981024,1,11,20,24,0,24,208
1082591,1,11,20,16,0,16,207
1082600,1,11,20,5,0,5,158
1082609,1,11,20,14,1,15,159
1082611,1,11,20,17,0,17,191
1082615,1,11,20,15,0,15,176
1082623,1,11,20,11,0,11,207
1082627,1,11,20,7,0,7,209
1082630,1,11,20,18,1,19,185
1082648,1,11,20,6,1,7,128
598009,2,11,20,5,1,6,130
598015,2,11,20,6,0,6,115
598018,2,11,20,3,3,6,132
598056,2,11,20,11,1,12,146
729300,2,11,20,1,0,1,121
734026,2,11,20,4,0,4,161
734034,2,11,20,5,0,5,189
829716,2,11,20,14,0,14,164
829736,2,11,20,5,0,5,163
829756,2,11,20,8,1,9,137
829786,2,11,20,1,0,1,132
980912,2,11,20,8,1,9,182
980996,2,11,20,8,1,9,180
981014,2,11,20,5,0,5,149
981022,2,11,20,5,0,5,163
1082604,2,11,20,12,0,12,155
1082634,2,11,20,0,0,0,136
980916,1,12,20,20,0,20,163
980924,1,12,20,3,0,3,152
980944,1,12,20,17,0,17,160
980954,1,12,20,12,0,12,195
980962,1,12,20,10,1,11,159
980974,1,12,20,16,0,16,191
1082594,1,12,20,16,0,16,163
1082603,1,12,20,4,0,4,171
1082607,1,12,20,9,1,10,161
1082618,1,12,20,10,0,10,160
1082620,1,12,20,9,3,12,182
1082624,1,12,20,9,1,10,157
1082634,1,12,20,5,1,6,148
1082647,1,12,20,15,0,15,162
980936,2,12,20,7,0,7,172
980970,2,12,20,5,1,6,166
980984,2,12,20,9,0,9,133
981010,2,12,20,22,1,23,173
1082592,2,12,20,15,0,15,187
1082615,2,12,20,13,0,13,179
1082629,2,12,20,12,1,13,167
1082631,2,12,20,7,0,7,158
1082642,2,12,20,12,5,17,161
1082650,2,12,20,8,1,9,128
980934,1,13,20,6,0,6,135
980950,1,13,20,10,0,10,172
980966,1,13,20,10,1,11,149
980972,1,13,20,12,0,12,126
981018,1,13,20,4,0,4,158
981022,1,13,20,7,1,8,162
1082593,1,13,20,13,1,14,183
1082596,1,13,20,4,1,5,135
1082606,1,13,20,10,0,10,176
1082625,1,13,20,9,0,9,153
1082629,1,13,20,5,1,6,161
1082632,1,13,20,16,1,17,208
1082640,1,13,20,12,0,12,195
1082643,1,13,20,0,0,0,154
980922,2,13,20,14,0,14,147
980942,2,13,20,6,2,8,182
980954,2,13,20,8,1,9,196
980960,2,13,20,6,0,6,131
1082610,2,13,20,4,0,4,192
1082616,2,13,20,9,0,9,162
1082637,2,13,20,8,2,10,192
